Name,Rating,Games,Result,Moves,CPL,MM,Sort Score,Analysis
mipsparc 2008.07.28,1007,1,1,10,78,80,2,A
mipsparc 2008.07.28,1007,1,1,10,65,60,-5,B
lacceroswaldo 2008.07.28,913,1,0,12,213,8,-205,A
lacceroswaldo 2008.07.28,913,1,0,12,240,8,-232,B
bdbailey 2008.07.24,921,1,0,19,302,16,-286,A
bdbailey 2008.07.24,921,1,0,19,291,21,-270,B
TheSexyKid 2008.07.24,1048,1,1,14,380,14,-366,A
TheSexyKid 2008.07.24,1048,1,1,14,296,14,-282,B
Kyobutungi 2008.07.05,1072,1,1,27,116,26,-90,A
Kyobutungi 2008.07.05,1072,1,1,27,116,33,-83,B
tfrio 2008.07.05,836,2,1,40,152,38,-114,A
tfrio 2008.07.05,836,2,1,40,158,38,-120,B
attilanino 2008.07.31,959,1,1,12,74,58,-16,A
attilanino 2008.07.31,959,1,1,12,75,58,-17,B
drstu 2008.07.31,920,1,0,15,251,33,-218,A
drstu 2008.07.31,920,1,0,15,211,33,-178,B
nryan 2008.07.21,977,2,1,30,143,33,-110,A
nryan 2008.07.21,977,2,1,30,124,33,-91,B
NaraShikamaru 2008.07.21,927,1,0,10,293,20,-273,A
NaraShikamaru 2008.07.21,927,1,0,10,270,20,-250,B
lacceroswaldo 2008.06.23,986,11,6,232,169,37,-132,A
lacceroswaldo 2008.06.23,986,11,6,232,166,36,-130,B
mipsparc 2008.06.23,1009,11,5,240,184,33,-151,A
mipsparc 2008.06.23,1009,11,5,240,176,35,-141,B
scygrav 2008.06.15,939,1,1,18,93,33,-60,A
scygrav 2008.06.15,939,1,1,18,94,22,-72,B
sspcleber 2008.06.15,953,1,0,21,116,38,-78,A
sspcleber 2008.06.15,953,1,0,21,119,29,-90,B
DDJ 2008.07.26,978,1,1,6,366,0,-366,A
DDJ 2008.07.26,978,1,1,6,403,0,-403,B
drkris 2008.07.26,991,3,0,37,183,19,-164,A
drkris 2008.07.26,991,3,0,37,182,19,-163,B
Gabimo 2008.07.15,931,1,1,13,152,46,-106,A
Gabimo 2008.07.15,931,1,1,13,141,46,-95,B
mbbane 2008.07.15,949,1,0,11,88,36,-52,A
mbbane 2008.07.15,949,1,0,11,77,36,-41,B
LaurentDelaon 2008.07.09,1087,1,1,9,142,22,-120,A
LaurentDelaon 2008.07.09,1087,1,1,9,130,22,-108,B
Scumm 2008.07.09,894,1,0,9,167,44,-123,A
Scumm 2008.07.09,894,1,0,9,160,33,-127,B
pumpbuster 2008.07.31,1128,1,0.5,40,89,30,-59,A
pumpbuster 2008.07.31,1128,1,0.5,40,87,28,-59,B
isntheaqt 2008.07.31,869,1,0.5,45,209,27,-182,A
isntheaqt 2008.07.31,869,1,0.5,45,212,20,-192,B
NaraShikamaru 2008.07.13,953,2,1.5,28,186,32,-154,A
NaraShikamaru 2008.07.13,953,2,1.5,28,191,25,-166,B
kigger 2008.07.13,938,1,0,7,341,43,-298,A
kigger 2008.07.13,938,1,0,7,336,43,-293,B
mbranimir 2008.07.05,966,1,1,17,91,41,-50,A
mbranimir 2008.07.05,966,1,1,17,107,29,-78,B
sspcleber 2008.07.05,905,1,0,19,190,21,-169,A
sspcleber 2008.07.05,905,1,0,19,198,21,-177,B
VOnegin 2008.06.05,933,1,1,5,118,20,-98,A
VOnegin 2008.06.05,933,1,1,5,79,20,-59,B
KarimNicho 2008.06.05,905,1,0,7,163,14,-149,A
KarimNicho 2008.06.05,905,1,0,7,275,14,-261,B
MalcaReborn 2008.07.25,867,2,0.5,67,134,31,-103,A
MalcaReborn 2008.07.25,867,2,0.5,67,109,34,-75,B
DEDEE 2008.07.25,1111,1,0.5,62,168,29,-139,A
DEDEE 2008.07.25,1111,1,0.5,62,159,29,-130,B
JabZ 2008.07.14,871,1,0,5,439,40,-399,A
JabZ 2008.07.14,871,1,0,5,421,40,-381,B
sspcleber 2008.07.14,952,1,1,4,73,50,-23,A
sspcleber 2008.07.14,952,1,1,4,67,75,8,B
tabbykt 2008.07.05,912,1,0.5,8,578,25,-553,A
tabbykt 2008.07.05,912,1,0.5,8,346,25,-321,B
DEDEE 2008.07.05,1083,1,0.5,4,115,75,-40,A
DEDEE 2008.07.05,1083,1,0.5,4,48,25,-23,B
sspcleber 2008.06.28,916,1,0,28,268,25,-243,A
sspcleber 2008.06.28,916,1,0,28,270,36,-234,B
Simplicus 2008.06.28,1078,1,1,24,127,33,-94,A
Simplicus 2008.06.28,1078,1,1,24,149,33,-116,B
achieve 2008.05.28,1071,1,0,5,360,0,-360,A
achieve 2008.05.28,1071,1,0,5,150,0,-150,B
simmito 2008.05.28,925,1,1,8,341,12,-329,A
simmito 2008.05.28,925,1,1,8,320,12,-308,B
arsalanbaig 2008.07.25,1079,1,1,7,0,100,100,A
arsalanbaig 2008.07.25,1079,1,1,7,0,100,100,B
sspcleber 2008.07.21,988,1,1,19,99,37,-62,A
sspcleber 2008.07.21,988,1,1,19,91,32,-59,B
qpn 2008.07.03,1070,1,0,22,259,27,-232,A
qpn 2008.07.03,1070,1,0,22,252,14,-238,B
JonEG 2008.07.03,844,1,1,21,175,33,-142,A
JonEG 2008.07.03,844,1,1,21,190,33,-157,B
mjwadams 2008.07.26,1001,1,1,4,74,25,-49,A
mjwadams 2008.07.26,1001,1,1,4,52,50,-2,B
laksen 2008.07.26,948,1,0,4,133,25,-108,A
laksen 2008.07.26,948,1,0,4,164,25,-139,B
vetteboy 2008.07.23,901,2,1,22,238,27,-211,A
vetteboy 2008.07.23,901,2,1,22,253,32,-221,B
NaraShikamaru 2008.07.23,898,1,0,20,423,25,-398,A
NaraShikamaru 2008.07.23,898,1,0,20,408,25,-383,B
LaurentDelaon 2008.06.27,1039,1,0,19,222,21,-201,A
LaurentDelaon 2008.06.27,1039,1,0,19,235,21,-214,B
tabbykt 2008.06.27,911,1,1,20,224,35,-189,A
tabbykt 2008.06.27,911,1,1,20,279,35,-244,B
RICHARDEUR 2008.05.30,1063,1,1,15,363,33,-330,A
RICHARDEUR 2008.05.30,1063,1,1,15,327,20,-307,B
bandicot 2008.05.30,928,1,0,19,423,26,-397,A
bandicot 2008.05.30,928,1,0,19,411,26,-385,B
zenmate 2008.07.27,1056,1,0,5,50,20,-30,A
zenmate 2008.07.27,1056,1,0,5,54,40,-14,B
madjoe 2008.07.27,911,1,1,4,70,25,-45,A
madjoe 2008.07.27,911,1,1,4,78,25,-53,B
krishnak 2008.07.22,980,2,1,41,129,39,-90,A
krishnak 2008.07.22,980,2,1,41,146,32,-114,B
pmineiro 2008.07.22,847,1,0,10,279,20,-259,A
pmineiro 2008.07.22,847,1,0,10,264,20,-244,B
LaurentDelaon 2008.06.09,1044,1,1,41,276,32,-244,A
LaurentDelaon 2008.06.09,1044,1,1,41,269,27,-242,B
bandicot 2008.06.09,909,1,0,36,170,31,-139,A
bandicot 2008.06.09,909,1,0,36,177,28,-149,B
bandicot 2008.05.29,904,2,0,20,236,20,-216,A
bandicot 2008.05.29,904,2,0,20,241,20,-221,B
mAsTERpEE 2008.05.29,939,1,1,12,111,33,-78,A
mAsTERpEE 2008.05.29,939,1,1,12,128,33,-95,B
lowball 2008.04.22,853,1,1,6,42,50,8,A
lowball 2008.04.22,853,1,1,6,24,67,43,B
LaurentDelaon 2008.04.22,1099,1,0,6,208,33,-175,A
LaurentDelaon 2008.04.22,1099,1,0,6,202,33,-169,B
DEDEE 2008.04.19,992,2,2,7,63,71,8,A
DEDEE 2008.04.19,992,2,2,7,92,71,-21,B
ChessWurgen 2008.04.19,968,2,0,14,407,43,-364,A
ChessWurgen 2008.04.19,968,2,0,14,427,43,-384,B
themoor 2008.04.22,1103,1,1,6,152,33,-119,A
themoor 2008.04.22,1103,1,1,6,134,33,-101,B
DaveMiddled 2008.04.22,846,1,0,6,246,33,-213,A
DaveMiddled 2008.04.22,846,1,0,6,231,33,-198,B
Belane 2008.04.15,1043,1,1,16,54,50,-4,A
Belane 2008.04.15,1043,1,1,16,45,56,11,B
Philipck 2008.04.15,954,1,0,17,171,41,-130,A
Philipck 2008.04.15,954,1,0,17,163,41,-122,B
SKUMARKOPPALA 2008.04.09,959,1,0,9,319,22,-297,A
SKUMARKOPPALA 2008.04.09,959,1,0,9,304,11,-293,B
karcal 2008.04.09,1019,1,1,5,84,40,-44,A
karcal 2008.04.09,1019,1,1,5,90,40,-50,B
MalcaReborn 2008.07.26,1001,2,2,29,65,62,-3,A
MalcaReborn 2008.07.26,1001,2,2,29,59,59,0,B
MalcaReborn 2008.07.26,1001,2,2,29,61,55,-6,C
tfrio 2008.07.14,915,1,0,6,492,17,-475,A
tfrio 2008.07.14,915,1,0,6,408,17,-391,B
skydvr 2008.07.14,1077,1,1,5,212,40,-172,A
skydvr 2008.07.14,1077,1,1,5,137,40,-97,B
pendaggie 2008.06.29,816,1,1,7,246,43,-203,A
pendaggie 2008.06.29,816,1,1,7,243,29,-214,B
pumpbuster 2008.06.29,1148,1,0,6,317,33,-284,A
pumpbuster 2008.06.29,1148,1,0,6,322,17,-305,B
LaurentDelaon 2008.06.12,1043,2,1,13,363,31,-332,A
LaurentDelaon 2008.06.12,1043,2,1,13,322,31,-291,B
CHESSDONK 2008.06.12,954,2,1,13,309,31,-278,A
CHESSDONK 2008.06.12,954,2,1,13,281,31,-250,B
LaurentDelaon 2008.05.27,1028,2,2,48,244,25,-219,A
LaurentDelaon 2008.05.27,1028,2,2,48,243,23,-220,B
bandicot 2008.05.27,928,2,0,53,304,30,-274,A
bandicot 2008.05.27,928,2,0,53,306,30,-276,B
dtrasatti 2008.05.25,878,1,0,22,192,36,-156,A
dtrasatti 2008.05.25,878,1,0,22,170,36,-134,B
ogbornd 2008.05.25,1115,1,1,19,118,32,-86,A
ogbornd 2008.05.25,1115,1,1,19,125,42,-83,B
HerveRenault 2008.04.29,986,1,1,21,106,52,-54,A
HerveRenault 2008.04.29,986,1,1,21,100,57,-43,B
HerveRenault 2008.04.29,986,1,1,21,100,57,-43,C
DaveMiddled 2008.04.29,846,1,0,21,186,29,-157,A
DaveMiddled 2008.04.29,846,1,0,21,188,29,-159,B
DaveMiddled 2008.04.29,846,1,0,21,185,24,-161,C
jasonmyerss 2008.07.31,885,1,0,27,365,33,-332,A
jasonmyerss 2008.07.31,885,1,0,27,340,26,-314,B
theonejanitor 2008.07.31,1007,1,1,19,212,53,-159,A
theonejanitor 2008.07.31,1007,1,1,19,224,47,-177,B
sspcleber 2008.07.17,989,1,0,11,231,36,-195,A
sspcleber 2008.07.17,989,1,0,11,227,36,-191,B
JabZ 2008.07.17,797,1,1,10,221,30,-191,A
JabZ 2008.07.17,797,1,1,10,242,20,-222,B
tabbykt 2008.07.29,941,1,1,5,39,60,21,A
tabbykt 2008.07.29,941,1,1,5,49,60,11,B
Liisa 2008.07.29,984,1,0,5,255,20,-235,A
Liisa 2008.07.29,984,1,0,5,265,20,-245,B
tabbykt 2008.07.07,924,1,0,10,263,30,-233,A
tabbykt 2008.07.07,924,1,0,10,271,30,-241,B
krishnak 2008.07.07,922,1,1,8,205,12,-193,A
krishnak 2008.07.07,922,1,1,8,202,12,-190,B
lacceroswaldo 2008.07.27,946,1,0,21,183,33,-150,A
lacceroswaldo 2008.07.27,946,1,0,21,208,33,-175,B
lacceroswaldo 2008.07.27,946,1,0,21,219,29,-190,C
tfrio 2008.07.27,902,1,1,20,138,50,-88,A
tfrio 2008.07.27,902,1,1,20,165,50,-115,B
tfrio 2008.07.27,902,1,1,20,155,45,-110,C
mipsparc 2008.06.18,1007,2,0.5,42,193,33,-160,A
mipsparc 2008.06.18,1007,2,0.5,42,154,36,-118,B
lacceroswaldo 2008.06.18,986,2,1.5,41,122,39,-83,A
lacceroswaldo 2008.06.18,986,2,1.5,41,106,46,-60,B
mipsparc 2008.06.15,1027,2,0,33,310,21,-289,A
mipsparc 2008.06.15,1027,2,0,33,249,27,-222,B
lacceroswaldo 2008.06.15,893,2,2,30,231,37,-194,A
lacceroswaldo 2008.06.15,893,2,2,30,223,30,-193,B
vannman 2008.07.18,1104,1,1,13,92,31,-61,A
vannman 2008.07.18,1104,1,1,13,102,31,-71,B
chrisdill 2008.07.18,844,1,0,12,214,33,-181,A
chrisdill 2008.07.18,844,1,0,12,222,33,-189,B
pumpbuster 2008.07.15,1144,1,1,7,52,43,-9,A
pumpbuster 2008.07.15,1144,1,1,7,33,57,24,B
isntheaqt 2008.07.15,854,1,0,7,282,29,-253,A
isntheaqt 2008.07.15,854,1,0,7,285,29,-256,B
AndyKG 2008.07.08,924,1,1,15,45,40,-5,A
AndyKG 2008.07.08,924,1,1,15,52,27,-25,B
sspcleber 2008.07.08,931,1,0,15,136,20,-116,A
sspcleber 2008.07.08,931,1,0,15,130,27,-103,B
paulgrahi 2008.06.25,1035,1,1,14,63,21,-42,A
paulgrahi 2008.06.25,1035,1,1,14,67,29,-38,B
sspcleber 2008.06.25,945,1,0,15,162,33,-129,A
sspcleber 2008.06.25,945,1,0,15,166,40,-126,B
avorenus 2008.07.25,967,1,0,24,229,25,-204,A
avorenus 2008.07.25,967,1,0,24,238,25,-213,B
sspcleber 2008.07.25,1011,1,1,20,122,30,-92,A
sspcleber 2008.07.25,1011,1,1,20,119,30,-89,B
laksen 2008.07.13,961,1,0.5,26,252,35,-217,A
laksen 2008.07.13,961,1,0.5,26,254,27,-227,B
TheMightyOne 2008.07.10,916,2,2,11,45,64,19,A
TheMightyOne 2008.07.10,916,2,2,11,47,73,26,B
tabbykt 2008.07.10,881,2,0,15,271,20,-251,A
tabbykt 2008.07.10,881,2,0,15,296,13,-283,B
bellumnonpax 2008.07.23,1049,1,1,8,84,38,-46,A
bellumnonpax 2008.07.23,1049,1,1,8,106,38,-68,B
Dancinchess 2008.06.20,939,1,0,10,530,0,-530,A
Dancinchess 2008.06.20,939,1,0,10,483,0,-483,B
Atlante 2008.06.20,946,1,1,9,427,0,-427,A
Atlante 2008.06.20,946,1,1,9,380,11,-369,B
KaiserPawn 2008.06.18,866,1,1,5,95,20,-75,A
KaiserPawn 2008.06.18,866,1,1,5,87,20,-67,B
flpcosta 2008.06.18,1133,1,0,5,286,20,-266,A
flpcosta 2008.06.18,1133,1,0,5,270,20,-250,B
bandicot 2008.06.03,883,1,1,9,68,22,-46,A
bandicot 2008.06.03,883,1,1,9,73,33,-40,B
YVN 2008.06.03,1039,1,0,9,100,11,-89,A
YVN 2008.06.03,1039,1,0,9,113,0,-113,B
PBLegion 2008.05.27,919,1,1,7,85,29,-56,A
PBLegion 2008.05.27,919,1,1,7,56,29,-27,B
Androidkenny 2008.05.27,1032,1,0,10,171,30,-141,A
Androidkenny 2008.05.27,1032,1,0,10,152,20,-132,B
tfrio 2008.05.12,869,4,1,48,217,31,-186,A
tfrio 2008.05.12,869,4,1,48,222,31,-191,B
MXseptimus 2008.05.12,1141,1,1,4,244,25,-219,A
MXseptimus 2008.05.12,1141,1,1,4,336,0,-336,B
BrunoPereira 2008.05.09,948,1,1,19,172,32,-140,A
BrunoPereira 2008.05.09,948,1,1,19,165,26,-139,B
cinex 2008.05.09,1048,1,0,20,226,30,-196,A
cinex 2008.05.09,1048,1,0,20,230,25,-205,B
TiredofLosing 2008.07.22,1013,1,1,29,36,52,16,A
TiredofLosing 2008.07.22,1013,1,1,29,33,48,15,B
TiredofLosing 2008.07.22,1013,1,1,29,30,48,18,C
lacceroswaldo 2008.06.16,964,4,2.5,53,233,32,-201,A
lacceroswaldo 2008.06.16,964,4,2.5,53,216,28,-188,B
mipsparc 2008.06.16,1019,4,1.5,53,251,32,-219,A
mipsparc 2008.06.16,1019,4,1.5,53,259,25,-234,B
Lucanus 2008.07.20,1033,1,1,23,158,44,-114,A
Lucanus 2008.07.20,1033,1,1,23,159,44,-115,B
psychotronic 2008.07.20,959,1,0,22,167,36,-131,A
psychotronic 2008.07.20,959,1,0,22,173,32,-141,B
lacceroswaldo 2008.07.04,986,1,0,10,332,0,-332,A
lacceroswaldo 2008.07.04,986,1,0,10,335,0,-335,B
mipsparc 2008.07.04,995,1,1,5,47,40,-7,A
mipsparc 2008.07.04,995,1,1,5,45,40,-5,B
tabbykt 2008.06.30,934,1,0,23,255,26,-229,A
tabbykt 2008.06.30,934,1,0,23,242,26,-216,B
gerassi 2008.06.30,996,1,1,24,286,21,-265,A
gerassi 2008.06.30,996,1,1,24,283,29,-254,B
poos 2008.05.28,927,1,0,17,298,47,-251,A
poos 2008.05.28,927,1,0,17,314,47,-267,B
sspcleber 2008.05.28,1066,1,1,25,568,32,-536,A
sspcleber 2008.05.28,1066,1,1,25,525,32,-493,B
paulfallet 2008.05.03,873,1,0,25,148,28,-120,A
paulfallet 2008.05.03,873,1,0,25,157,28,-129,B
SAVAGEPLAYA 2008.05.03,1109,1,1,27,198,30,-168,A
SAVAGEPLAYA 2008.05.03,1109,1,1,27,205,30,-175,B
isntheaqt 2008.07.17,855,1,1,7,188,29,-159,A
isntheaqt 2008.07.17,855,1,1,7,194,29,-165,B
pumpbuster 2008.07.17,1142,1,0,6,57,67,10,A
pumpbuster 2008.07.17,1142,1,0,6,37,67,30,B
Derbentli 2008.05.30,934,1,1,12,73,50,-23,A
Derbentli 2008.05.30,934,1,1,12,80,50,-30,B
KaiserPawn 2008.05.30,941,1,0,12,136,42,-94,A
KaiserPawn 2008.05.30,941,1,0,12,154,42,-112,B
Leonidovich 2008.07.23,969,1,1,15,103,20,-83,A
Leonidovich 2008.07.23,969,1,1,15,98,27,-71,B
MianMy 2008.07.23,1020,1,0,15,199,20,-179,A
MianMy 2008.07.23,1020,1,0,15,195,20,-175,B
mbranimir 2008.07.03,966,1,0.5,8,38,38,0,A
mbranimir 2008.07.03,966,1,0.5,8,57,38,-19,B
mupdegrove 2008.07.03,1022,1,0.5,10,266,20,-246,A
mupdegrove 2008.07.03,1022,1,0.5,10,247,20,-227,B
DEDEE 2008.05.19,1014,1,1,19,73,42,-31,A
DEDEE 2008.05.19,1014,1,1,19,69,58,-11,B
kreukels 2008.05.19,977,1,0,22,175,32,-143,A
kreukels 2008.05.19,977,1,0,22,175,32,-143,B
chessrazz 2008.07.05,1065,1,0,13,287,23,-264,A
chessrazz 2008.07.05,1065,1,0,13,299,15,-284,B
philsolness 2008.06.23,911,1,0,7,230,43,-187,A
philsolness 2008.06.23,911,1,0,7,253,43,-210,B
DEDEE 2008.06.23,1055,1,1,7,96,57,-39,A
DEDEE 2008.06.23,1055,1,1,7,110,57,-53,B
kreukels 2008.06.16,923,1,0,19,122,16,-106,A
kreukels 2008.06.16,923,1,0,19,118,16,-102,B
redtube 2008.06.16,1073,1,1,18,48,44,-4,A
redtube 2008.06.16,1073,1,1,18,50,28,-22,B
LaurentDelaon 2008.06.13,1058,1,1,3,85,0,-85,A
LaurentDelaon 2008.06.13,1058,1,1,3,56,33,-23,B
Kyujoo 2008.06.13,910,1,0,5,409,20,-389,A
Kyujoo 2008.06.13,910,1,0,5,332,20,-312,B
dukemono 2008.05.29,1075,1,1,7,93,14,-79,A
dukemono 2008.05.29,1075,1,1,7,85,14,-71,B
tfrio 2008.06.15,854,1,0,11,204,27,-177,A
tfrio 2008.06.15,854,1,0,11,193,27,-166,B
FranckFabozi 2008.06.15,1137,1,1,3,216,33,-183,A
FranckFabozi 2008.06.15,1137,1,1,3,68,33,-35,B
pendaggie 2008.06.07,839,1,0,18,256,33,-223,A
pendaggie 2008.06.07,839,1,0,18,258,33,-225,B
MELUCHA 2008.06.07,1131,1,1,19,308,32,-276,A
MELUCHA 2008.06.07,1131,1,1,19,294,32,-262,B
KarimNicho 2008.06.06,873,1,1,39,247,26,-221,A
KarimNicho 2008.06.06,873,1,1,39,250,20,-230,B
mjwadams 2008.06.06,1020,1,0,38,265,18,-247,A
mjwadams 2008.06.06,1020,1,0,38,283,24,-259,B
SkietSkijf 2008.06.14,1056,1,1,11,171,55,-116,A
SkietSkijf 2008.06.14,1056,1,1,11,120,54,-66,B
SviSe 2008.06.14,889,1,0,12,241,33,-208,A
SviSe 2008.06.14,889,1,0,12,240,25,-215,B
santai 2008.06.02,989,2,2,32,97,41,-56,A
santai 2008.06.02,989,2,2,32,90,38,-52,B
bandicot 2008.06.02,901,2,0,34,157,18,-139,A
bandicot 2008.06.02,901,2,0,34,159,21,-138,B
bongocat 2008.05.09,1130,1,0,10,262,30,-232,A
bongocat 2008.05.09,1130,1,0,10,259,30,-229,B
deckedm 2008.05.09,857,1,1,8,71,38,-33,A
deckedm 2008.05.09,857,1,1,8,78,38,-40,B
tomerzarfaty 2008.04.21,1054,1,0,36,224,36,-188,A
tomerzarfaty 2008.04.21,1054,1,0,36,227,39,-188,B
ifalou 2008.04.21,832,1,1,33,161,33,-128,A
ifalou 2008.04.21,832,1,1,33,164,33,-131,B
metallichristian 2008.06.06,848,1,1,6,112,33,-79,A
metallichristian 2008.06.06,848,1,1,6,102,33,-69,B
santai 2008.06.06,1081,1,0,6,216,50,-166,A
santai 2008.06.06,1081,1,0,6,202,50,-152,B
bcoffield 2008.06.18,908,1,1,6,124,50,-74,A
bcoffield 2008.06.18,908,1,1,6,140,50,-90,B
paulgrahi 2008.06.18,1043,1,0,6,347,33,-314,A
paulgrahi 2008.06.18,1043,1,0,6,354,33,-321,B
paperchasdvincent 2008.05.24,1046,1,1,9,192,0,-192,A
paperchasdvincent 2008.05.24,1046,1,1,9,186,0,-186,B
smaiurana 2008.05.24,916,1,0,9,316,0,-316,A
smaiurana 2008.05.24,916,1,0,9,326,0,-326,B
MXseptimus 2008.04.18,882,2,0,30,282,23,-259,A
MXseptimus 2008.04.18,882,2,0,30,285,27,-258,B
bangs 2008.04.18,1098,2,2,24,187,33,-154,A
bangs 2008.04.18,1098,2,2,24,129,42,-87,B
tomerzarfaty 2008.04.08,1056,1,1,21,122,43,-79,A
tomerzarfaty 2008.04.08,1056,1,1,21,107,48,-59,B
lynnyx 2008.04.08,940,1,0,28,158,36,-122,A
lynnyx 2008.04.08,940,1,0,28,153,32,-121,B
FranckFabozi 2008.06.11,1146,1,1,16,71,38,-33,A
FranckFabozi 2008.06.11,1146,1,1,16,89,38,-51,B
jaelaw 2008.06.11,807,1,0,22,252,27,-225,A
jaelaw 2008.06.11,807,1,0,22,265,32,-233,B
KaiserPawn 2008.06.04,890,1,0,40,134,38,-96,A
KaiserPawn 2008.06.04,890,1,0,40,172,30,-142,B
StanGetz 2008.06.04,1074,1,1,37,155,41,-114,A
StanGetz 2008.06.04,1074,1,1,37,155,43,-112,B
KarimNicho 2008.05.31,864,1,0,12,234,17,-217,A
KarimNicho 2008.05.31,864,1,0,12,220,25,-195,B
jywhe 2008.05.31,967,1,1,10,144,30,-114,A
jywhe 2008.05.31,967,1,1,10,127,30,-97,B
simmito 2008.05.21,939,1,0,8,313,12,-301,A
simmito 2008.05.21,939,1,0,8,318,25,-293,B
achieve 2008.05.21,1059,1,1,7,183,29,-154,A
achieve 2008.05.21,1059,1,1,7,189,29,-160,B
Birgie 2008.06.06,1011,1,0,33,215,27,-188,A
Birgie 2008.06.06,1011,1,0,33,206,30,-176,B
tabbykt 2008.06.06,987,1,1,33,233,27,-206,A
tabbykt 2008.06.06,987,1,1,33,240,18,-222,B
poos 2008.06.03,934,1,0,13,314,31,-283,A
poos 2008.06.03,934,1,0,13,284,23,-261,B
LaurentDelaon 2008.06.03,1030,1,1,11,220,27,-193,A
LaurentDelaon 2008.06.03,1030,1,1,11,193,27,-166,B
Philipck 2008.05.26,984,1,1,30,161,33,-128,A
Philipck 2008.05.26,984,1,1,30,146,33,-113,B
bandicot 2008.05.26,942,1,0,31,212,36,-176,A
bandicot 2008.05.26,942,1,0,31,191,42,-149,B
IanRedding 2008.05.13,1141,1,0,22,201,36,-165,A
IanRedding 2008.05.13,1141,1,0,22,193,32,-161,B
Derbentli 2008.05.13,847,1,1,21,153,33,-120,A
Derbentli 2008.05.13,847,1,1,21,148,33,-115,B
wangzhewudi 2008.05.07,1065,1,1,9,65,67,2,A
wangzhewudi 2008.05.07,1065,1,1,9,56,56,0,B
deckedm 2008.05.07,908,1,0,13,293,31,-262,A
deckedm 2008.05.07,908,1,0,13,280,38,-242,B
sneakypawn 2008.04.09,900,1,1,26,134,31,-103,A
sneakypawn 2008.04.09,900,1,1,26,149,27,-122,B
Baro 2008.04.09,1090,1,0,31,258,26,-232,A
Baro 2008.04.09,1090,1,0,31,258,23,-235,B
BrunoPereira 2008.05.12,1006,2,1,30,191,40,-151,A
BrunoPereira 2008.05.12,1006,2,1,30,155,47,-108,B
breachy 2008.05.12,932,1,0,23,152,39,-113,A
breachy 2008.05.12,932,1,0,23,182,39,-143,B
Zhoss 2008.05.07,1083,1,1,12,243,33,-210,A
Zhoss 2008.05.07,1083,1,1,12,246,33,-213,B
ChessWurgen 2008.05.07,902,1,0,13,358,31,-327,A
ChessWurgen 2008.05.07,902,1,0,13,372,23,-349,B
vishavnathan 2008.04.10,1001,1,0,22,217,23,-194,A
vishavnathan 2008.04.10,1001,1,0,22,188,27,-161,B
JSGill 2008.04.10,951,1,1,24,167,21,-146,A
JSGill 2008.04.10,951,1,1,24,163,21,-142,B
achieve 2008.04.01,1064,4,3,61,215,41,-174,A
achieve 2008.04.01,1064,4,3,61,214,33,-181,B
simmito 2008.04.01,895,4,1,65,252,28,-224,A
simmito 2008.04.01,895,4,1,65,286,23,-263,B
zhoujin 2008.05.12,930,1,1,3,54,33,-21,A
zhoujin 2008.05.12,930,1,1,3,17,67,50,B
thestephanea 2008.05.12,1127,2,2,14,112,36,-76,A
thestephanea 2008.05.12,1127,2,2,14,124,43,-81,B
BDJ 2008.04.19,1183,1,0,16,264,12,-252,A
BDJ 2008.04.19,1183,1,0,16,279,12,-267,B
Derbentli 2008.04.19,728,1,1,10,280,20,-260,A
Derbentli 2008.04.19,728,1,1,10,258,10,-248,B
josoma 2008.04.03,1097,1,1,7,119,57,-62,A
josoma 2008.04.03,1097,1,1,7,96,43,-53,B
DaveMiddled 2008.04.03,865,1,0,7,271,0,-271,A
DaveMiddled 2008.04.03,865,1,0,7,231,14,-217,B
ziggylucy 2008.05.12,1043,1,0,31,188,32,-156,A
ziggylucy 2008.05.12,1043,1,0,31,219,32,-187,B
Dwaiosez 2008.05.08,945,1,1,34,181,35,-146,A
Dwaiosez 2008.05.08,945,1,1,34,165,38,-127,B
BrunoPereira 2008.05.08,982,1,0,40,325,25,-300,A
BrunoPereira 2008.05.08,982,1,0,40,333,25,-308,B
DEDEE 2008.04.21,1038,2,0,46,245,33,-212,A
DEDEE 2008.04.21,1038,2,0,46,220,22,-198,B
lynnyx 2008.04.21,923,3,2.5,81,126,43,-83,A
lynnyx 2008.04.21,923,3,2.5,81,122,48,-74,B
lowball 2008.04.18,928,3,1,34,314,24,-290,A
lowball 2008.04.18,928,3,1,34,310,24,-286,B
DEDEE 2008.04.18,979,3,2,32,303,19,-284,A
DEDEE 2008.04.18,979,3,2,32,329,22,-307,B
themoor 2008.04.24,1065,1,1,7,100,43,-57,A
themoor 2008.04.24,1065,1,1,7,97,43,-54,B
DaveMiddled 2008.04.24,834,1,0,7,271,29,-242,A
DaveMiddled 2008.04.24,834,1,0,7,299,29,-270,B
Peroble 2008.04.19,1067,1,0.5,5,222,20,-202,A
Peroble 2008.04.19,1067,1,0.5,5,161,20,-141,B
dcook 2008.04.19,844,1,0.5,11,452,0,-452,A
dcook 2008.04.19,844,1,0.5,11,451,0,-451,B
simmito 2008.05.07,927,1,1,28,199,25,-174,A
simmito 2008.05.07,927,1,1,28,196,21,-175,B
achieve 2008.05.07,1034,1,0,28,257,36,-221,A
achieve 2008.05.07,1034,1,0,28,259,32,-227,B
IsoraGaby 2008.04.26,908,1,1,10,263,10,-253,A
IsoraGaby 2008.04.26,908,1,1,10,264,10,-254,B
alderius 2008.04.26,1051,1,0,5,83,40,-43,A
alderius 2008.04.26,1051,1,0,5,69,40,-29,B
Atlante 2008.04.27,934,1,0,17,154,29,-125,A
Atlante 2008.04.27,934,1,0,17,161,29,-132,B
MXseptimus 2008.04.27,1014,1,1,16,100,0,-100,A
MXseptimus 2008.04.27,1014,1,1,16,97,12,-85,B
lowball 2008.04.19,899,2,0,23,231,22,-209,A
lowball 2008.04.19,899,2,0,23,214,26,-188,B
psychodiez 2008.04.19,1034,1,1,8,42,75,33,A
psychodiez 2008.04.19,1034,1,1,8,60,50,-10,B
TastyTreatForKids 2008.04.25,888,1,1,25,128,48,-80,A
TastyTreatForKids 2008.04.25,888,1,1,25,137,44,-93,B
DEDEE 2008.04.25,1021,1,0,26,207,35,-172,A
DEDEE 2008.04.25,1021,1,0,26,218,35,-183,B
lowball 2008.04.20,863,1,0,8,227,25,-202,A
lowball 2008.04.20,863,1,0,8,220,12,-208,B
sevenohnine 2008.04.20,1073,1,1,7,101,29,-72,A
sevenohnine 2008.04.20,1073,1,1,7,84,29,-55,B
Tribune 2008.04.12,956,1,1,19,119,53,-66,A
Tribune 2008.04.12,956,1,1,19,128,37,-91,B
paato 2008.04.12,931,1,0,22,242,9,-233,A
paato 2008.04.12,931,1,0,22,249,14,-235,B
DaveMiddled 2008.04.16,844,1,0.5,16,248,44,-204,A
DaveMiddled 2008.04.16,844,1,0.5,16,203,38,-165,B
sharpempathy 2008.04.16,1067,1,0.5,19,249,21,-228,A
sharpempathy 2008.04.16,1067,1,0.5,19,271,10,-261,B
MXseptimus 2008.04.21,941,1,0.5,29,84,55,-29,A
MXseptimus 2008.04.21,941,1,0.5,29,87,52,-35,B
MXseptimus 2008.04.21,941,1,0.5,29,80,48,-32,C
azertyman 2008.04.08,1127,1,1,25,135,44,-91,A
azertyman 2008.04.08,1127,1,1,25,130,36,-94,B
jinbu 2008.04.08,858,1,0,25,156,36,-120,A
jinbu 2008.04.08,858,1,0,25,156,28,-128,B
osymo 2008.04.19,1037,1,1,14,258,14,-244,A
osymo 2008.04.19,1037,1,1,14,236,14,-222,B
seanwickham 2008.04.12,827,2,2,15,84,40,-44,A
seanwickham 2008.04.12,827,2,2,15,61,40,-21,B
arcticnegro 2008.04.12,1080,1,0,6,117,67,-50,A
arcticnegro 2008.04.12,1080,1,0,6,97,67,-30,B
aussiebattler 2008.04.12,912,1,1,7,172,43,-129,A
aussiebattler 2008.04.12,912,1,1,7,68,43,-25,B
chessup 2008.04.12,1025,1,0,13,269,15,-254,A
chessup 2008.04.12,1025,1,0,13,385,8,-377,B
johnsacko 2008.04.02,973,1,1,19,90,47,-43,A
johnsacko 2008.04.02,973,1,1,19,90,47,-43,B
Dszudszak 2008.04.02,983,1,0,20,185,35,-150,A
Dszudszak 2008.04.02,983,1,0,20,191,35,-156,B
THEREALVONBLUVENS 2008.04.14,936,1,1,6,184,33,-151,A
THEREALVONBLUVENS 2008.04.14,936,1,1,6,202,33,-169,B
Dreamlight 2008.04.14,1012,1,0,6,355,17,-338,A
Dreamlight 2008.04.14,1012,1,0,6,363,17,-346,B
DEDEE 2008.04.02,1039,1,1,9,231,11,-220,A
DEDEE 2008.04.02,1039,1,1,9,244,11,-233,B
lynnyx 2008.04.02,939,1,0,10,362,40,-322,A
lynnyx 2008.04.02,939,1,0,10,367,40,-327,B
vetteboy 2008.03.21,918,1,0,5,447,0,-447,A
vetteboy 2008.03.21,918,1,0,5,464,0,-464,B
josoma 2008.03.21,1048,1,1,3,51,67,16,A
josoma 2008.03.21,1048,1,1,3,56,67,11,B
ddurden 2008.04.13,1149,1,1,8,73,50,-23,A
ddurden 2008.04.13,1149,1,1,8,123,50,-73,B
DaveMiddled 2008.04.13,849,1,0,10,375,0,-375,A
DaveMiddled 2008.04.13,849,1,0,10,373,0,-373,B
vishavnathan 2008.04.04,1092,1,0,17,260,24,-236,A
vishavnathan 2008.04.04,1092,1,0,17,262,29,-233,B
tfrio 2008.04.04,871,1,1,17,401,29,-372,A
tfrio 2008.04.04,871,1,1,17,334,29,-305,B
chessup 2008.03.29,1082,1,1,8,140,0,-140,A
chessup 2008.03.29,1082,1,1,8,167,12,-155,B
vetteboy 2008.03.29,907,1,0,10,250,0,-250,A
vetteboy 2008.03.29,907,1,0,10,274,0,-274,B
JPUng 2008.04.05,986,2,1,21,232,33,-199,A
JPUng 2008.04.05,986,2,1,21,231,33,-198,B
princy 2008.04.05,975,1,0,12,259,17,-242,A
princy 2008.04.05,975,1,0,12,264,25,-239,B
johnsacko 2008.03.17,943,2,1,34,237,24,-213,A
johnsacko 2008.03.17,943,2,1,34,258,24,-234,B
jhnd 2008.03.17,879,1,0,14,319,14,-305,A
jhnd 2008.03.17,879,1,0,14,314,14,-300,B
ScottieD 2008.02.06,983,1,1,5,160,40,-120,A
ScottieD 2008.02.06,983,1,1,5,175,40,-135,B
Whipsnapper 2008.02.06,949,1,0,5,499,0,-499,A
Whipsnapper 2008.02.06,949,1,0,5,493,0,-493,B
vetteboy 2008.04.13,930,1,0,24,199,29,-170,A
vetteboy 2008.04.13,930,1,0,24,219,21,-198,B
paato 2008.04.13,910,2,2,55,159,36,-123,A
paato 2008.04.13,910,2,2,55,150,35,-115,B
Krikke 2008.04.13,1083,1,0,34,221,56,-165,A
Krikke 2008.04.13,1083,1,0,34,220,44,-176,B
savis 2008.04.12,1067,1,0,10,274,10,-264,A
savis 2008.04.12,1067,1,0,10,240,10,-230,B
achieve 2008.04.08,1048,2,0,32,356,25,-331,A
achieve 2008.04.08,1048,2,0,32,359,28,-331,B
simmito 2008.04.08,888,2,2,32,343,31,-312,A
simmito 2008.04.08,888,2,2,32,339,31,-308,B
Daimonion 2008.04.05,998,1,1,12,202,42,-160,A
Daimonion 2008.04.05,998,1,1,12,206,25,-181,B
TheTrooper 2008.04.12,888,1,0.5,51,106,35,-71,A
TheTrooper 2008.04.12,888,1,0.5,51,104,37,-67,B
bangs 2008.04.12,1103,1,0.5,48,95,46,-49,A
bangs 2008.04.12,1103,1,0.5,48,77,42,-35,B
JPUng 2008.04.06,1076,1,0,12,311,8,-303,A
JPUng 2008.04.06,1076,1,0,12,294,17,-277,B
amenophis 2008.04.06,882,1,1,11,190,18,-172,A
amenophis 2008.04.06,882,1,1,11,163,18,-145,B
ChrisAtkinson 2008.04.12,940,1,1,17,151,29,-122,A
ChrisAtkinson 2008.04.12,940,1,1,17,151,29,-122,B
badbadman 2008.04.12,1025,1,0,19,244,16,-228,A
badbadman 2008.04.12,1025,1,0,19,241,21,-220,B
Temppeliaukio 2008.03.30,941,4,1,51,137,26,-111,A
Temppeliaukio 2008.03.30,941,4,1,51,133,26,-107,B
lynnyx 2008.03.30,928,1,1,5,82,40,-42,A
lynnyx 2008.03.30,928,1,1,5,53,40,-13,B
Temppeliaukio 2008.03.26,957,1,0,16,143,50,-93,A
Temppeliaukio 2008.03.26,957,1,0,16,140,38,-102,B
gnavarro 2008.03.26,1005,1,1,17,379,6,-373,A
gnavarro 2008.03.26,1005,1,1,17,365,6,-359,B
aitmedallal 2008.03.15,1013,1,0,7,105,0,-105,A
aitmedallal 2008.03.15,1013,1,0,7,212,29,-183,B
heychee 2008.03.15,960,1,1,3,72,33,-39,A
heychee 2008.03.15,960,1,1,3,36,33,-3,B
Temppeliaukio 2008.03.14,1086,1,1,23,163,35,-128,A
Temppeliaukio 2008.03.14,1086,1,1,23,152,30,-122,B
DaveMiddled 2008.03.14,913,1,0,35,199,31,-168,A
DaveMiddled 2008.03.14,913,1,0,35,210,37,-173,B
simmito 2008.03.11,990,3,1,77,217,30,-187,A
simmito 2008.03.11,990,3,1,77,197,29,-168,B
achieve 2008.03.11,1008,3,2,74,194,31,-163,A
achieve 2008.03.11,1008,3,2,74,181,31,-150,B
seanwickham 2008.04.06,859,1,0,9,179,44,-135,A
seanwickham 2008.04.06,859,1,0,9,157,44,-113,B
achieve 2008.04.06,1050,1,1,9,256,22,-234,A
achieve 2008.04.06,1050,1,1,9,254,22,-232,B
Temppeliaukio 2008.03.28,972,2,0,37,177,22,-155,A
Temppeliaukio 2008.03.28,972,2,0,37,184,22,-162,B
lazysusan 2008.03.28,999,1,1,31,123,39,-84,A
lazysusan 2008.03.28,999,1,1,31,122,42,-80,B
princy 2008.03.12,947,1,1,3,226,67,-159,A
princy 2008.03.12,947,1,1,3,218,33,-185,B
DaveMiddled 2008.03.12,933,1,0,5,708,20,-688,A
DaveMiddled 2008.03.12,933,1,0,5,703,20,-683,B
princy 2008.03.16,931,1,1,11,62,46,-16,A
princy 2008.03.16,931,1,1,11,70,36,-34,B
kodra 2008.03.16,1010,1,0,13,247,23,-224,A
kodra 2008.03.16,1010,1,0,13,200,23,-177,B
seanwickham 2008.03.09,881,1,0,18,194,22,-172,A
seanwickham 2008.03.09,881,1,0,18,202,28,-174,B
markssixtyfour 2008.03.09,1099,1,1,15,48,47,-1,A
markssixtyfour 2008.03.09,1099,1,1,15,53,47,-6,B
vetteboy 2008.03.30,897,1,1,6,200,0,-200,A
vetteboy 2008.03.30,897,1,1,6,208,17,-191,B
jasperpalmer 2008.03.28,1001,1,1,4,146,25,-121,A
jasperpalmer 2008.03.28,1001,1,1,4,106,50,-56,B
achieve 2008.02.26,978,1,1,7,140,0,-140,A
achieve 2008.02.26,978,1,1,7,152,0,-152,B
simmito 2008.02.26,983,1,0,7,236,29,-207,A
simmito 2008.02.26,983,1,0,7,238,29,-209,B
RandyMc 2008.02.20,861,1,0,18,234,11,-223,A
RandyMc 2008.02.20,861,1,0,18,234,28,-206,B
JohnWinthrop 2008.02.20,976,2,1,20,223,50,-173,A
JohnWinthrop 2008.02.20,976,2,1,20,220,40,-180,B
DINOCO 2008.02.15,896,1,1,7,66,29,-37,A
DINOCO 2008.02.15,896,1,1,7,47,43,-4,B
Artmachine 2008.02.15,1019,1,0,7,266,14,-252,A
Artmachine 2008.02.15,1019,1,0,7,253,14,-239,B
Nielow 2008.03.31,1102,1,1,16,164,50,-114,A
Nielow 2008.03.31,1102,1,1,16,178,50,-128,B
tfrio 2008.03.31,895,2,0,39,242,28,-214,A
tfrio 2008.03.31,895,2,0,39,224,33,-191,B
Scumm 2008.03.21,929,1,0,10,196,30,-166,A
Scumm 2008.03.21,929,1,0,10,196,40,-156,B
Krikke 2008.03.21,1065,1,1,7,70,43,-27,A
Krikke 2008.03.21,1065,1,1,7,60,57,-3,B
gfransp 2008.03.14,835,1,0,16,250,13,-237,A
gfransp 2008.03.14,835,1,0,16,251,6,-245,B
henrikx 2008.03.14,1027,1,1,12,156,33,-123,A
henrikx 2008.03.14,1027,1,1,12,150,33,-117,B
xxxyyyxxx 2008.04.06,947,1,1,9,177,11,-166,A
xxxyyyxxx 2008.04.06,947,1,1,9,166,11,-155,B
HerveRenault 2008.04.06,1025,1,0,8,225,12,-213,A
HerveRenault 2008.04.06,1025,1,0,8,218,12,-206,B
Krikke 2008.03.25,1031,2,2,24,136,25,-111,A
Krikke 2008.03.25,1031,2,2,24,127,33,-94,B
DaveMiddled 2008.03.25,881,1,0,9,167,44,-123,A
DaveMiddled 2008.03.25,881,1,0,9,164,33,-131,B
fattylumpkin 2008.04.01,1083,1,1,21,225,38,-187,A
fattylumpkin 2008.04.01,1083,1,1,21,231,33,-198,B
tfrio 2008.04.01,880,1,0,21,258,24,-234,A
tfrio 2008.04.01,880,1,0,21,274,29,-245,B
Temppeliaukio 2008.03.10,1031,1,1,17,89,47,-42,A
Temppeliaukio 2008.03.10,1031,1,1,17,78,47,-31,B
Marcellov 2008.03.10,948,1,0,18,158,22,-136,A
Marcellov 2008.03.10,948,1,0,18,150,22,-128,B
saturnine 2008.03.13,864,2,0,19,240,16,-224,A
saturnine 2008.03.13,864,2,0,19,249,21,-228,B
thestephanea 2008.03.13,1096,1,1,13,166,8,-158,A
thestephanea 2008.03.13,1096,1,1,13,162,15,-147,B
DHamm 2008.03.04,996,1,0.5,11,80,54,-26,A
DHamm 2008.03.04,996,1,0.5,11,85,54,-31,B
WhiteSide 2008.03.04,977,1,0.5,11,170,18,-152,A
WhiteSide 2008.03.04,977,1,0.5,11,166,18,-148,B
ydankner 2008.02.21,1092,1,1,31,198,39,-159,A
ydankner 2008.02.21,1092,1,1,31,209,42,-167,B
johnsacko 2008.02.21,904,2,0,53,193,34,-159,A
johnsacko 2008.02.21,904,2,0,53,195,36,-159,B
Rules 2008.03.30,1066,1,1,10,35,50,15,A
Rules 2008.03.30,1066,1,1,10,31,50,19,B
chessup 2008.03.25,1077,1,0,24,239,33,-206,A
chessup 2008.03.25,1077,1,0,24,213,33,-180,B
bongocat 2008.03.25,886,1,1,24,224,42,-182,A
bongocat 2008.03.25,886,1,1,24,228,29,-199,B
johnsacko 2008.03.24,971,4,2,59,209,20,-189,A
johnsacko 2008.03.24,971,4,2,59,188,15,-173,B
uberkind 2008.03.24,977,3,3,53,146,28,-118,A
uberkind 2008.03.24,977,3,3,53,136,28,-108,B
MrPresto 2008.03.30,1021,1,0,28,120,50,-70,A
MrPresto 2008.03.30,1021,1,0,28,120,54,-66,B
MrPresto 2008.03.30,1021,1,0,28,111,46,-65,C
aussiebattler 2008.03.25,951,1,0,18,337,33,-304,A
aussiebattler 2008.03.25,951,1,0,18,351,33,-318,B
Dszudszak 2008.03.24,915,1,1,18,142,33,-109,A
Dszudszak 2008.03.24,915,1,1,18,154,33,-121,B
JScottDaBoss 2008.03.31,1077,1,1,24,102,46,-56,A
JScottDaBoss 2008.03.31,1077,1,1,24,99,38,-61,B
tfrio 2008.03.24,959,2,0,21,279,24,-255,A
tfrio 2008.03.24,959,2,0,21,242,24,-218,B
direita 2008.04.04,1044,1,1,19,108,37,-71,A
direita 2008.04.04,1044,1,1,19,118,26,-92,B
bongocat 2008.04.04,1030,1,0,22,239,36,-203,A
bongocat 2008.04.04,1030,1,0,22,215,36,-179,B
achieve 2008.03.25,1054,1,1,17,58,24,-34,A
achieve 2008.03.25,1054,1,1,17,61,41,-20,B
simmito 2008.03.25,910,1,0,19,222,32,-190,A
simmito 2008.03.25,910,1,0,19,239,26,-213,B
salius 2008.03.25,1020,1,0,20,287,20,-267,A
salius 2008.03.25,1020,1,0,20,270,20,-250,B
lynnyx 2008.03.25,966,1,1,18,223,22,-201,A
lynnyx 2008.03.25,966,1,1,18,213,22,-191,B
Temppeliaukio 2008.03.27,950,1,1,4,295,0,-295,A
Temppeliaukio 2008.03.27,950,1,1,4,232,0,-232,B
JScottDaBoss 2008.03.27,1036,1,0,6,627,17,-610,A
JScottDaBoss 2008.03.27,1036,1,0,6,450,0,-450,B
lynnyx 2008.03.24,1006,2,0,33,150,45,-105,A
lynnyx 2008.03.24,1006,2,0,33,124,39,-85,B
JohnWinthrop 2008.03.02,953,1,0,24,83,42,-41,A
JohnWinthrop 2008.03.02,953,1,0,24,85,42,-43,B
DHamm 2008.03.02,997,1,1,23,60,35,-25,A
DHamm 2008.03.02,997,1,1,23,61,30,-31,B
lynnyx 2008.03.20,903,1,0,27,208,18,-190,A
lynnyx 2008.03.20,903,1,0,27,207,11,-196,B
DEDEE 2008.03.20,1075,1,1,26,177,19,-158,A
DEDEE 2008.03.20,1075,1,1,26,172,23,-149,B
phenin 2008.03.15,919,1,0.5,44,199,23,-176,A
phenin 2008.03.15,919,1,0.5,44,195,27,-168,B
DaveMiddled 2008.03.15,895,1,0.5,44,190,32,-158,A
DaveMiddled 2008.03.15,895,1,0.5,44,170,36,-134,B
jinbu 2008.03.15,884,1,0,8,207,50,-157,A
jinbu 2008.03.15,884,1,0,8,135,25,-110,B
Bodegroes 2008.03.15,941,1,1,4,11,75,64,A
Bodegroes 2008.03.15,941,1,1,4,0,100,100,B
nerdzrool 2008.03.06,870,1,0,7,151,14,-137,A
nerdzrool 2008.03.06,870,1,0,7,137,14,-123,B
DHamm 2008.03.06,1012,1,1,4,94,50,-44,A
DHamm 2008.03.06,1012,1,1,4,65,25,-40,B
PlainsDrifter 2008.03.04,969,1,1,10,120,20,-100,A
PlainsDrifter 2008.03.04,969,1,1,10,139,20,-119,B
NobleBlade 2008.03.04,947,1,0,10,140,20,-120,A
NobleBlade 2008.03.04,947,1,0,10,133,30,-103,B
subramanyamn 2008.03.01,928,1,1,5,113,20,-93,A
subramanyamn 2008.03.01,928,1,1,5,112,20,-92,B
yackal 2008.03.01,1051,1,0,5,317,20,-297,A
yackal 2008.03.01,1051,1,0,5,331,0,-331,B
Artmachine 2008.03.21,1064,1,1,20,110,30,-80,A
Artmachine 2008.03.21,1064,1,1,20,117,30,-87,B
Lucidity 2008.03.21,869,1,0,20,171,25,-146,A
Lucidity 2008.03.21,869,1,0,20,162,35,-127,B
Dreamlight 2008.03.20,999,1,0,13,244,8,-236,A
Dreamlight 2008.03.20,999,1,0,13,244,0,-244,B
colonelcam 2008.03.20,986,1,1,12,220,25,-195,A
colonelcam 2008.03.20,986,1,1,12,212,33,-179,B
dewie 2008.03.19,925,1,0,6,212,50,-162,A
dewie 2008.03.19,925,1,0,6,230,50,-180,B
hebrewbrain 2008.03.19,833,1,1,7,441,14,-427,A
hebrewbrain 2008.03.19,833,1,1,7,452,14,-438,B
DEDEE 2008.03.21,1074,2,2,50,152,34,-118,A
DEDEE 2008.03.21,1074,2,2,50,154,36,-118,B
jhnd 2008.03.21,769,2,0,51,211,31,-180,A
jhnd 2008.03.21,769,2,0,51,196,29,-167,B
stabinandmoley 2008.03.18,1006,1,1,15,104,33,-71,A
stabinandmoley 2008.03.18,1006,1,1,15,75,40,-35,B
Dszudszak 2008.03.18,970,1,0,19,188,5,-183,A
Dszudszak 2008.03.18,970,1,0,19,167,10,-157,B
bigdawgdude 2008.03.06,1043,1,1,7,141,29,-112,A
bigdawgdude 2008.03.06,1043,1,1,7,178,29,-149,B
princy 2008.03.06,952,1,0,7,267,29,-238,A
princy 2008.03.06,952,1,0,7,312,29,-283,B
DHamm 2008.03.13,1088,1,1,4,0,100,100,A
DHamm 2008.03.13,1088,1,1,4,0,100,100,B
colonelcam 2008.03.05,1039,1,0,5,246,0,-246,A
colonelcam 2008.03.05,1039,1,0,5,271,0,-271,B
theridge 2008.03.05,932,1,1,4,64,50,-14,A
theridge 2008.03.05,932,1,1,4,30,75,45,B
cameronbra 2008.03.17,1052,1,1,19,188,26,-162,A
cameronbra 2008.03.17,1052,1,1,19,200,21,-179,B
achieve 2008.02.16,994,1,1,22,161,27,-134,A
achieve 2008.02.16,994,1,1,22,161,27,-134,B
whitestarrnyc 2008.02.16,959,1,0,22,207,23,-184,A
whitestarrnyc 2008.02.16,959,1,0,22,200,36,-164,B
JohnWinthrop 2008.03.14,1026,1,1,16,203,19,-184,A
JohnWinthrop 2008.03.14,1026,1,1,16,223,19,-204,B
zhouzhou 2008.03.14,944,1,0,15,278,13,-265,A
zhouzhou 2008.03.14,944,1,0,15,277,13,-264,B
gfransp 2008.03.10,928,1,0,13,260,15,-245,A
gfransp 2008.03.10,928,1,0,13,261,31,-230,B
stabinandmoley 2008.03.10,965,1,1,12,174,42,-132,A
stabinandmoley 2008.03.10,965,1,1,12,181,42,-139,B
simmito 2008.03.18,968,2,0,32,243,31,-212,A
simmito 2008.03.18,968,2,0,32,203,31,-172,B
achieve 2008.03.18,1018,2,2,27,85,37,-48,A
achieve 2008.03.18,1018,2,2,27,80,37,-43,B
yackal 2008.03.03,1106,2,1,23,229,17,-212,A
yackal 2008.03.03,1106,2,1,23,222,17,-205,B
moibeatle 2008.03.03,864,2,1,21,251,10,-241,A
moibeatle 2008.03.03,864,2,1,21,210,10,-200,B
vetteboy 2008.03.17,938,1,0,19,223,32,-191,A
vetteboy 2008.03.17,938,1,0,19,225,26,-199,B
mikelee 2008.03.17,1057,1,1,21,270,38,-232,A
mikelee 2008.03.17,1057,1,1,21,265,29,-236,B
lynnyx 2008.03.18,830,1,1,6,114,50,-64,A
lynnyx 2008.03.18,830,1,1,6,108,67,-41,B
sdormeus 2008.03.18,1011,1,0,11,357,27,-330,A
sdormeus 2008.03.18,1011,1,0,11,366,27,-339,B
seanwickham 2008.03.13,819,1,1,18,76,33,-43,A
seanwickham 2008.03.13,819,1,1,18,73,39,-34,B
Temppeliaukio 2008.03.13,1114,1,0,18,138,17,-121,A
Temppeliaukio 2008.03.13,1114,1,0,18,142,11,-131,B
nerdzrool 2008.03.10,847,1,0,14,266,14,-252,A
nerdzrool 2008.03.10,847,1,0,14,274,14,-260,B
waxmatiwaxmati 2008.03.10,979,1,1,8,225,12,-213,A
waxmatiwaxmati 2008.03.10,979,1,1,8,194,12,-182,B
frankpid 2008.03.06,831,1,0,17,229,47,-182,A
frankpid 2008.03.06,831,1,0,17,237,41,-196,B
Caduceus 2008.03.06,1121,1,1,22,349,36,-313,A
Caduceus 2008.03.06,1121,1,1,22,318,36,-282,B
maravich 2008.02.25,996,1,0,13,285,23,-262,A
maravich 2008.02.25,996,1,0,13,272,23,-249,B
WhiteSide 2008.02.25,973,1,1,11,154,36,-118,A
WhiteSide 2008.02.25,973,1,1,11,143,36,-107,B
FollyFrog 2008.02.24,875,1,1,11,140,27,-113,A
FollyFrog 2008.02.24,875,1,1,11,162,27,-135,B
yackal 2008.02.24,1057,1,0,11,268,27,-241,A
yackal 2008.02.24,1057,1,0,11,306,0,-306,B
lesterjack 2008.03.10,932,1,0,10,241,20,-221,A
lesterjack 2008.03.10,932,1,0,10,241,40,-201,B
Krikke 2008.03.10,1030,1,1,9,87,44,-43,A
Krikke 2008.03.10,1030,1,1,9,138,33,-105,B
louiswei 2008.03.03,999,1,0,33,98,27,-71,A
louiswei 2008.03.03,999,1,0,33,91,30,-61,B
Shatranzi 2008.03.03,988,1,1,36,124,39,-85,A
Shatranzi 2008.03.03,988,1,1,36,125,33,-92,B
drunkenmonkey 2008.02.15,1004,1,1,19,173,37,-136,A
drunkenmonkey 2008.02.15,1004,1,1,19,225,37,-188,B
WhiteSide 2008.02.15,958,2,1,33,172,33,-139,A
WhiteSide 2008.02.15,958,2,1,33,200,42,-158,B
DEDEE 2008.02.11,974,1,1,21,232,33,-199,A
DEDEE 2008.02.11,974,1,1,21,257,29,-228,B
SanderDee 2008.02.11,1000,1,0,20,254,25,-229,A
SanderDee 2008.02.11,1000,1,0,20,229,30,-199,B
viaaurea 2008.03.03,915,1,1,27,84,41,-43,A
viaaurea 2008.03.03,915,1,1,27,94,37,-57,B
Chrisasdf 2008.03.03,1066,1,0,28,187,29,-158,A
Chrisasdf 2008.03.03,1066,1,0,28,190,25,-165,B
moibeatle 2008.03.05,976,2,1,25,138,20,-118,A
moibeatle 2008.03.05,976,2,1,25,133,28,-105,B
waxmatiwaxmati 2008.03.05,996,1,0,4,292,0,-292,A
waxmatiwaxmati 2008.03.05,996,1,0,4,324,0,-324,B
louiswei 2008.03.05,980,1,1,20,102,50,-52,A
louiswei 2008.03.05,980,1,1,20,91,55,-36,B
louiswei 2008.03.05,980,1,1,20,98,55,-43,C
johnsacko 2008.03.02,952,1,0,18,342,6,-336,A
johnsacko 2008.03.02,952,1,0,18,369,6,-363,B
vetteboy 2008.03.02,944,1,1,17,284,12,-272,A
vetteboy 2008.03.02,944,1,1,17,308,18,-290,B
nelb 2008.02.19,959,2,2,60,110,27,-83,A
nelb 2008.02.19,959,2,2,60,106,28,-78,B
DHamm 2008.02.19,1012,2,0,61,180,26,-154,A
DHamm 2008.02.19,1012,2,0,61,167,26,-141,B
Krikke 2008.02.29,1030,1,0,7,214,29,-185,A
Krikke 2008.02.29,1030,1,0,7,236,29,-207,B
kyleelhs 2008.02.29,946,1,1,3,87,0,-87,A
kyleelhs 2008.02.29,946,1,1,3,100,0,-100,B
lpalossy 2008.02.21,955,1,1,24,192,29,-163,A
lpalossy 2008.02.21,955,1,1,24,178,38,-140,B
nelb 2008.03.04,972,1,0,16,174,25,-149,A
nelb 2008.03.04,972,1,0,16,167,19,-148,B
Temppeliaukio 2008.03.04,1019,1,1,15,96,27,-69,A
Temppeliaukio 2008.03.04,1019,1,1,15,95,33,-62,B
johnsacko 2008.02.17,894,4,1,39,264,26,-238,A
johnsacko 2008.02.17,894,4,1,39,236,26,-210,B
Bottledwater 2008.02.17,1046,1,1,5,32,40,8,A
Bottledwater 2008.02.17,1046,1,1,5,43,40,-3,B
WhiteSide 2008.02.08,908,1,0,6,352,33,-319,A
WhiteSide 2008.02.08,908,1,0,6,347,33,-314,B
mattbarber 2008.02.08,1054,1,1,3,74,33,-41,A
mattbarber 2008.02.08,1054,1,1,3,81,33,-48,B
thebrickwall 2008.01.09,978,4,2,48,217,31,-186,A
thebrickwall 2008.01.09,978,4,2,48,219,29,-190,B
louiswei 2008.01.09,1008,2,0,52,144,35,-109,A
louiswei 2008.01.09,1008,2,0,52,149,31,-118,B
SanderDee 2008.02.29,919,1,0,19,300,21,-279,A
SanderDee 2008.02.29,919,1,0,19,309,26,-283,B
Aeroplanes 2008.02.29,1036,1,1,17,247,41,-206,A
Aeroplanes 2008.02.29,1036,1,1,17,217,29,-188,B
moibeatle 2008.03.04,928,1,1,28,163,36,-127,A
moibeatle 2008.03.04,928,1,1,28,178,39,-139,B
stabinandmoley 2008.03.04,989,1,0,33,263,15,-248,A
stabinandmoley 2008.03.04,989,1,0,33,272,18,-254,B
paperchasdvincent 2008.01.01,964,2,1.5,52,229,29,-200,A
paperchasdvincent 2008.01.01,964,2,1.5,52,227,31,-196,B
Artmachine 2008.01.01,1003,1,0,21,186,29,-157,A
Artmachine 2008.01.01,1003,1,0,21,184,43,-141,B
pendaggie 2008.02.15,1024,1,0,14,238,21,-217,A
pendaggie 2008.02.15,1024,1,0,14,236,29,-207,B
stabinandmoley 2008.02.15,942,1,1,12,141,33,-108,A
stabinandmoley 2008.02.15,942,1,1,12,96,33,-63,B
FollyFrog 2008.02.23,865,2,0.5,49,213,25,-188,A
FollyFrog 2008.02.23,865,2,0.5,49,230,20,-210,B
mray 2008.02.23,1033,1,1,11,64,36,-28,A
mray 2008.02.23,1033,1,1,11,63,36,-27,B
DHamm 2008.02.23,983,1,0,18,165,33,-132,A
DHamm 2008.02.23,983,1,0,18,198,22,-176,B
Krikke 2008.02.23,1015,1,1,18,122,33,-89,A
Krikke 2008.02.23,1015,1,1,18,107,39,-68,B
markssixtyfour 2008.02.25,1105,1,1,11,57,54,-3,A
markssixtyfour 2008.02.25,1105,1,1,11,46,64,18,B
johnsacko 2008.02.25,882,1,0,11,187,18,-169,A
johnsacko 2008.02.25,882,1,0,11,179,18,-161,B
FollyFrog 2008.02.22,892,1,0,23,294,17,-277,A
FollyFrog 2008.02.22,892,1,0,23,266,17,-249,B
yackal 2008.02.22,1036,1,1,8,112,37,-75,A
yackal 2008.02.22,1036,1,1,8,106,25,-81,B
zhouzhou 2008.02.25,915,1,1,8,178,13,-165,A
zhouzhou 2008.02.25,915,1,1,8,197,12,-185,B
paperchasdvincent 2008.02.25,1052,1,0,9,281,33,-248,A
paperchasdvincent 2008.02.25,1052,1,0,9,273,22,-251,B
achieve 2008.02.22,942,1,0,21,223,38,-185,A
achieve 2008.02.22,942,1,0,21,198,33,-165,B
mray 2008.02.22,1032,1,1,20,213,40,-173,A
mray 2008.02.22,1032,1,1,20,183,45,-138,B
johnsacko 2008.02.15,995,1,0,18,220,17,-203,A
johnsacko 2008.02.15,995,1,0,18,207,17,-190,B
KINGRICH 2008.02.20,977,1,1,6,271,33,-238,A
KINGRICH 2008.02.20,977,1,1,6,288,50,-238,B
Chuckccac 2008.02.19,1095,1,1,29,214,28,-186,A
Chuckccac 2008.02.19,1095,1,1,29,214,21,-193,B
RandyMc 2008.02.19,875,1,0,27,278,18,-260,A
RandyMc 2008.02.19,875,1,0,27,290,18,-272,B
vascobimbo 2008.01.24,950,1,1,6,240,50,-190,A
vascobimbo 2008.01.24,950,1,1,6,249,50,-199,B
HammandClov 2008.01.24,978,2,1,17,342,18,-324,A
HammandClov 2008.01.24,978,2,1,17,333,29,-304,B
LaurentDelaon 2008.02.18,1061,1,1,11,208,18,-190,A
LaurentDelaon 2008.02.18,1061,1,1,11,169,27,-142,B
johnsacko 2008.02.18,887,1,0,13,344,31,-313,A
johnsacko 2008.02.18,887,1,0,13,328,31,-297,B
WhiteSide 2008.02.17,962,1,1,17,256,12,-244,A
WhiteSide 2008.02.17,962,1,1,17,256,6,-250,B
louiswei 2008.02.07,1003,1,0,18,234,22,-212,A
louiswei 2008.02.07,1003,1,0,18,214,17,-197,B
Krikke 2008.02.07,995,1,1,14,93,43,-50,A
Krikke 2008.02.07,995,1,1,14,72,43,-29,B
colinman 2008.02.07,989,1,0,7,373,14,-359,A
colinman 2008.02.07,989,1,0,7,381,14,-367,B
Whipsnapper 2008.02.07,960,2,2,14,314,36,-278,A
Whipsnapper 2008.02.07,960,2,2,14,320,36,-284,B
Aydo 2008.02.17,1081,2,1,11,171,27,-144,A
Aydo 2008.02.17,1081,2,1,11,131,18,-113,B
johnsacko 2008.02.23,870,1,0.5,37,176,32,-144,A
johnsacko 2008.02.23,870,1,0.5,37,208,27,-181,B
bangs 2008.03.01,1035,1,1,29,149,28,-121,A
bangs 2008.03.01,1035,1,1,29,151,31,-120,B
PlainsDrifter 2008.03.01,961,1,0,25,105,40,-65,A
PlainsDrifter 2008.03.01,961,1,0,25,111,36,-75,B
JohnWinthrop 2008.02.19,960,2,1.5,21,348,14,-334,A
JohnWinthrop 2008.02.19,960,2,1.5,21,336,24,-312,B
achieve 2008.02.19,970,1,0.5,16,203,44,-159,A
achieve 2008.02.19,970,1,0.5,16,218,38,-180,B
FollyFrog 2008.02.20,894,1,0,12,321,25,-296,A
FollyFrog 2008.02.20,894,1,0,12,308,25,-283,B
mray 2008.02.20,1052,1,1,7,21,71,50,A
mray 2008.02.20,1052,1,1,7,18,57,39,B
sdormeus 2008.02.16,1065,1,0,19,370,26,-344,A
sdormeus 2008.02.16,1065,1,0,19,388,26,-362,B
SanderDee 2008.02.16,900,1,1,17,295,41,-254,A
SanderDee 2008.02.16,900,1,1,17,274,35,-239,B
LarryLido 2008.02.19,1023,1,0,4,14,50,36,A
LarryLido 2008.02.19,1023,1,0,4,39,50,11,B
dewie 2008.02.16,943,1,0.5,50,104,32,-72,A
dewie 2008.02.16,943,1,0.5,50,106,34,-72,B
heychee 2008.02.16,961,1,0.5,46,116,37,-79,A
heychee 2008.02.16,961,1,0.5,46,107,39,-68,B
Caduceus 2008.01.22,1061,1,1,9,331,11,-320,A
Caduceus 2008.01.22,1061,1,1,9,256,22,-234,B
frankpid 2008.01.22,812,1,0,12,502,17,-485,A
frankpid 2008.01.22,812,1,0,12,481,17,-464,B
emorej 2008.02.04,995,2,2,36,79,42,-37,A
emorej 2008.02.04,995,2,2,36,56,42,-14,B
JBChessPontchat 2008.02.04,936,2,0,41,189,37,-152,A
JBChessPontchat 2008.02.04,936,2,0,41,183,32,-151,B
rockyspirit 2008.02.14,878,1,0,19,396,21,-375,A
rockyspirit 2008.02.14,878,1,0,19,237,26,-211,B
NPAV 2008.02.14,1103,1,1,20,263,30,-233,A
NPAV 2008.02.14,1103,1,1,20,241,30,-211,B
DHamm 2008.02.20,974,1,1,20,115,30,-85,A
DHamm 2008.02.20,974,1,1,20,88,25,-63,B
johnsacko 2008.02.20,896,1,0,27,267,18,-249,A
johnsacko 2008.02.20,896,1,0,27,272,18,-254,B
HammandClov 2008.02.01,1102,2,2,17,278,29,-249,A
HammandClov 2008.02.01,1102,2,2,17,290,24,-266,B
stabinandmoley 2008.02.01,905,3,0,47,217,28,-189,A
stabinandmoley 2008.02.01,905,3,0,47,211,26,-185,B
shoving 2008.01.24,906,1,0,12,253,17,-236,A
shoving 2008.01.24,906,1,0,12,234,17,-217,B
RandyMc 2008.02.13,911,1,0,11,271,27,-244,A
RandyMc 2008.02.13,911,1,0,11,238,18,-220,B
stabinandmoley 2008.02.13,812,1,1,9,193,33,-160,A
stabinandmoley 2008.02.13,812,1,1,9,117,22,-95,B
Staindone 2008.02.08,1026,1,1,9,172,22,-150,A
Staindone 2008.02.08,1026,1,1,9,110,22,-88,B
Klewein 2008.02.08,925,1,0,11,293,18,-275,A
Klewein 2008.02.08,925,1,0,11,328,18,-310,B
shoving 2008.01.22,932,1,0,16,152,19,-133,A
shoving 2008.01.22,932,1,0,16,144,12,-132,B
louiswei 2008.01.22,998,1,1,15,103,20,-83,A
louiswei 2008.01.22,998,1,1,15,78,20,-58,B
Turbotank 2008.01.09,937,1,1,33,117,33,-84,A
Turbotank 2008.01.09,937,1,1,33,121,33,-88,B
onetwothreebob 2008.02.07,1004,1,0,6,226,50,-176,A
onetwothreebob 2008.02.07,1004,1,0,6,227,50,-177,B
achieve 2008.01.19,973,2,1,10,223,30,-193,A
achieve 2008.01.19,973,2,1,10,236,30,-206,B
DHamm 2008.01.19,1051,1,0,6,249,33,-216,A
DHamm 2008.01.19,1051,1,0,6,254,33,-221,B
kugatz 2008.01.10,998,1,1,8,209,25,-184,A
kugatz 2008.01.10,998,1,1,8,206,38,-168,B
thebrickwall 2008.01.10,956,1,0,8,344,38,-306,A
thebrickwall 2008.01.10,956,1,0,8,324,38,-286,B
nirt 2008.02.12,1144,1,0,13,156,31,-125,A
nirt 2008.02.12,1144,1,0,13,141,31,-110,B
jdlibbey 2008.02.12,836,1,1,12,64,42,-22,A
jdlibbey 2008.02.12,836,1,1,12,68,42,-26,B
arifabesha 2008.01.24,1039,1,0,21,207,19,-188,A
arifabesha 2008.01.24,1039,1,0,21,187,29,-158,B
DINOCO 2008.01.24,853,1,1,19,126,21,-105,A
DINOCO 2008.01.24,853,1,1,19,112,21,-91,B
ephraimhanks 2008.01.09,1008,1,1,4,93,50,-43,A
ephraimhanks 2008.01.09,1008,1,1,4,107,50,-57,B
DINOCO 2008.01.12,871,1,0,11,213,18,-195,A
DINOCO 2008.01.12,871,1,0,11,128,27,-101,B
BurtForFun 2008.01.12,1122,1,1,9,99,33,-66,A
BurtForFun 2008.01.12,1122,1,1,9,91,33,-58,B
thebrickwall 2008.01.02,970,2,2,97,107,51,-56,A
thebrickwall 2008.01.02,970,2,2,97,107,52,-55,B
thebrickwall 2008.01.02,970,2,2,97,102,52,-50,C
paperchasdvincent 2008.01.02,1027,1,0,35,109,29,-80,A
paperchasdvincent 2008.01.02,1027,1,0,35,118,34,-84,B
paperchasdvincent 2008.01.02,1027,1,0,35,110,37,-73,C
TJPOT 2008.01.28,1149,1,1,3,359,0,-359,A
TJPOT 2008.01.28,1149,1,1,3,324,0,-324,B
aresquibel 2008.01.28,844,1,0,6,808,0,-808,A
aresquibel 2008.01.28,844,1,0,6,782,0,-782,B
Kayode 2008.02.01,943,1,1,19,109,47,-62,A
Kayode 2008.02.01,943,1,1,19,122,53,-69,B
ckchessmaster 2008.02.07,1107,1,0,31,281,26,-255,A
ckchessmaster 2008.02.07,1107,1,0,31,252,19,-233,B
WhiteSide 2008.02.07,807,1,1,29,226,24,-202,A
WhiteSide 2008.02.07,807,1,1,29,196,24,-172,B
arcarsenal 2008.02.01,1153,1,1,15,169,27,-142,A
arcarsenal 2008.02.01,1153,1,1,15,157,40,-117,B
aresquibel 2008.02.01,794,1,0,15,215,20,-195,A
aresquibel 2008.02.01,794,1,0,15,209,7,-202,B
JBChessPontchat 2008.01.29,1006,1,1,50,128,30,-98,A
JBChessPontchat 2008.01.29,1006,1,1,50,124,30,-94,B
Caledonian 2008.01.29,853,1,0,51,162,14,-148,A
Caledonian 2008.01.29,853,1,0,51,155,20,-135,B
kfrumDABAY 2008.01.08,939,1,0,9,96,56,-40,A
kfrumDABAY 2008.01.08,939,1,0,9,101,56,-45,B
thebrickwall 2008.01.08,969,1,1,10,236,40,-196,A
thebrickwall 2008.01.08,969,1,1,10,234,30,-204,B
HammandClov 2008.01.31,1087,1,1,24,57,54,-3,A
HammandClov 2008.01.31,1087,1,1,24,54,38,-16,B
rockyspirit 2008.01.31,898,1,0,28,169,29,-140,A
rockyspirit 2008.01.31,898,1,0,28,152,32,-120,B
badsilva 2008.01.28,1010,1,1,18,141,28,-113,A
badsilva 2008.01.28,1010,1,1,18,143,28,-115,B
zhouzhou 2008.01.28,934,1,0,19,207,37,-170,A
zhouzhou 2008.01.28,934,1,0,19,233,21,-212,B
paperchasdvincent 2008.01.12,1008,1,1,10,112,10,-102,A
paperchasdvincent 2008.01.12,1008,1,1,10,105,30,-75,B
thebrickwall 2008.01.12,950,4,3,40,197,23,-174,A
thebrickwall 2008.01.12,950,4,3,40,199,22,-177,B
jdlibbey 2008.02.08,901,1,0,11,283,18,-265,A
jdlibbey 2008.02.08,901,1,0,11,305,18,-287,B
Artmachine 2008.02.08,1003,1,1,13,466,15,-451,A
Artmachine 2008.02.08,1003,1,1,13,464,15,-449,B
chadmhall 2008.01.12,990,2,0,20,320,20,-300,A
chadmhall 2008.01.12,990,2,0,20,303,15,-288,B
prodigiousbusines 2008.01.26,1032,1,1,13,336,23,-313,A
prodigiousbusines 2008.01.26,1032,1,1,13,332,23,-309,B
Whipsnapper 2008.01.26,961,1,0,13,450,15,-435,A
Whipsnapper 2008.01.26,961,1,0,13,415,8,-407,B
frankpid 2008.01.09,856,1,0,10,382,10,-372,A
frankpid 2008.01.09,856,1,0,10,406,10,-396,B
wackum 2008.01.05,986,1,1,14,207,0,-207,A
wackum 2008.01.05,986,1,1,14,215,7,-208,B
ippat 2008.01.05,1013,1,0,15,312,20,-292,A
ippat 2008.01.05,1013,1,0,15,316,33,-283,B
Bottledwater 2008.02.11,1132,1,0.5,42,55,36,-19,A
Bottledwater 2008.02.11,1132,1,0.5,42,46,36,-10,B
DINOCO 2008.02.11,845,1,0.5,41,120,34,-86,A
DINOCO 2008.02.11,845,1,0.5,41,88,34,-54,B
ippat 2008.01.19,1000,1,1,4,315,0,-315,A
ippat 2008.01.19,1000,1,1,4,371,0,-371,B
Raicore 2008.01.30,987,1,1,29,129,45,-84,A
Raicore 2008.01.30,987,1,1,29,138,38,-100,B
Raicore 2008.01.30,987,1,1,29,144,41,-103,C
luoyun 2008.01.30,886,1,0,26,167,54,-113,A
luoyun 2008.01.30,886,1,0,26,126,54,-72,B
luoyun 2008.01.30,886,1,0,26,133,54,-79,C
kfrumDABAY 2008.01.09,915,1,1,16,191,12,-179,A
kfrumDABAY 2008.01.09,915,1,1,16,181,25,-156,B
jinbu 2008.01.24,867,1,0,39,126,23,-103,A
jinbu 2008.01.24,867,1,0,39,119,26,-93,B
aleksthegreat 2008.01.24,1112,1,1,39,134,26,-108,A
aleksthegreat 2008.01.24,1112,1,1,39,124,26,-98,B
luoyun 2008.01.14,940,1,0,17,322,12,-310,A
luoyun 2008.01.14,940,1,0,17,317,12,-305,B
paperchasdvincent 2008.01.14,1020,1,1,12,100,50,-50,A
paperchasdvincent 2008.01.14,1020,1,1,12,58,58,0,B
prodigiousbusines 2008.01.12,1039,1,0,15,174,40,-134,A
prodigiousbusines 2008.01.12,1039,1,0,15,198,40,-158,B
grsshppr 2008.01.27,854,1,1,31,79,48,-31,A
grsshppr 2008.01.27,854,1,1,31,74,42,-32,B
grsshppr 2008.01.27,854,1,1,31,86,39,-47,C
skix 2008.01.27,1125,1,0,32,150,63,-87,A
skix 2008.01.27,1125,1,0,32,124,53,-71,B
skix 2008.01.27,1125,1,0,32,131,44,-87,C
jokersplay 2008.01.02,1058,1,0,10,183,70,-113,A
jokersplay 2008.01.02,1058,1,0,10,166,70,-96,B
TimoK 2008.01.02,900,1,1,16,484,38,-446,A
TimoK 2008.01.02,900,1,1,16,528,25,-503,B
DINOCO 2008.01.07,890,1,0,21,386,10,-376,A
DINOCO 2008.01.07,890,1,0,21,372,10,-362,B
sevenohnine 2008.01.07,1069,1,1,16,247,25,-222,A
sevenohnine 2008.01.07,1069,1,1,16,224,25,-199,B
frankpid 2008.01.02,912,1,0,35,398,20,-378,A
frankpid 2008.01.02,912,1,0,35,395,14,-381,B
frankpid 2008.01.02,912,1,0,35,395,14,-381,C
DINOCO 2008.01.10,882,1,0,22,199,14,-185,A
DINOCO 2008.01.10,882,1,0,22,245,18,-227,B
sevenohnine 2008.01.10,1066,1,1,20,120,40,-80,A
sevenohnine 2008.01.10,1066,1,1,20,157,35,-122,B
thebrickwall 2008.01.01,1004,1,0.5,28,157,39,-118,A
thebrickwall 2008.01.01,1004,1,0.5,28,146,39,-107,B
buddhajuke 2008.01.02,1030,1,1,15,106,40,-66,A
buddhajuke 2008.01.02,1030,1,1,15,125,33,-92,B
Doragon 2008.01.02,967,1,0,17,286,18,-268,A
Doragon 2008.01.02,967,1,0,17,299,18,-281,B
Artmachine 2008.01.05,983,1,1,10,120,30,-90,A
Artmachine 2008.01.05,983,1,1,10,111,20,-91,B
PinkClimax 2008.01.05,977,1,0,11,187,46,-141,A
PinkClimax 2008.01.05,977,1,0,11,190,46,-144,B
pmineiro 2008.09.07,804,1,0,15,316,20,-296,A
pmineiro 2008.09.07,804,1,0,15,299,20,-279,B
achieve 2008.09.07,1072,1,1,13,133,23,-110,A
achieve 2008.09.07,1072,1,1,13,202,23,-179,B
mipsparc 2008.08.24,1044,4,3,73,197,33,-164,A
mipsparc 2008.08.24,1044,4,3,73,178,33,-145,B
lacceroswaldo 2008.08.24,941,4,1,75,199,29,-170,A
lacceroswaldo 2008.08.24,941,4,1,75,188,29,-159,B
lacceroswaldo 2008.08.20,951,3,1,43,298,23,-275,A
lacceroswaldo 2008.08.20,951,3,1,43,280,26,-254,B
mipsparc 2008.08.20,1036,3,2,43,279,28,-251,A
mipsparc 2008.08.20,1036,3,2,43,264,28,-236,B
lacceroswaldo 2008.08.14,969,2,1,13,219,31,-188,A
lacceroswaldo 2008.08.14,969,2,1,13,212,31,-181,B
mipsparc 2008.08.14,1028,2,1,14,348,7,-341,A
mipsparc 2008.08.14,1028,2,1,14,333,14,-319,B
mipsparc 2008.09.02,1014,5,3,61,209,21,-188,A
mipsparc 2008.09.02,1014,5,3,61,207,20,-187,B
lacceroswaldo 2008.09.02,983,5,2,63,201,30,-171,A
lacceroswaldo 2008.09.02,983,5,2,63,185,30,-155,B
pendaggie 2008.08.23,847,1,0,9,285,22,-263,A
pendaggie 2008.08.23,847,1,0,9,293,22,-271,B
Erlanson 2008.08.23,1086,1,1,8,182,38,-144,A
Erlanson 2008.08.23,1086,1,1,8,190,25,-165,B
mipsparc 2008.09.03,1017,4,2.5,71,185,38,-147,A
mipsparc 2008.09.03,1017,4,2.5,71,183,32,-151,B
lacceroswaldo 2008.09.03,980,4,1.5,67,160,36,-124,A
lacceroswaldo 2008.09.03,980,4,1.5,67,132,37,-95,B
lacceroswaldo 2008.08.12,973,2,0,43,250,23,-227,A
lacceroswaldo 2008.08.12,973,2,0,43,229,23,-206,B
mipsparc 2008.08.12,1023,2,2,37,127,41,-86,A
mipsparc 2008.08.12,1023,2,2,37,139,43,-96,B
ozslap 2008.09.04,951,1,0,5,176,20,-156,A
ozslap 2008.09.04,951,1,0,5,188,0,-188,B
mbbane 2008.09.04,1008,1,1,4,79,50,-29,A
mbbane 2008.09.04,1008,1,1,4,72,50,-22,B
marearoja 2008.09.03,941,1,0,14,246,43,-203,A
marearoja 2008.09.03,941,1,0,14,202,29,-173,B
Mladenovic 2008.09.03,977,1,1,13,151,38,-113,A
Mladenovic 2008.09.03,977,1,1,13,146,38,-108,B
SGTMAJUSMC 2008.08.24,838,1,0,8,292,37,-255,A
SGTMAJUSMC 2008.08.24,838,1,0,8,198,25,-173,B
TheRedHood 2008.08.24,1141,1,1,7,39,43,4,A
TheRedHood 2008.08.24,1141,1,1,7,51,43,-8,B
JooBoo 2008.08.20,1019,1,0,10,250,30,-220,A
JooBoo 2008.08.20,1019,1,0,10,135,30,-105,B
marearoja 2008.08.20,901,1,1,13,154,54,-100,A
marearoja 2008.08.20,901,1,1,13,156,54,-102,B
mipsparc 2008.08.11,1006,5,3.5,113,145,35,-110,A
mipsparc 2008.08.11,1006,5,3.5,113,141,29,-112,B
lacceroswaldo 2008.08.11,985,5,1.5,115,184,30,-154,A
lacceroswaldo 2008.08.11,985,5,1.5,115,179,29,-150,B
dockson 2008.08.23,862,1,0,31,191,26,-165,A
dockson 2008.08.23,862,1,0,31,189,26,-163,B
oldchessbook 2008.08.23,1135,1,1,27,132,30,-102,A
oldchessbook 2008.08.23,1135,1,1,27,130,30,-100,B
lacceroswaldo 2008.08.18,972,3,0,51,334,26,-308,A
lacceroswaldo 2008.08.18,972,3,0,51,282,25,-257,B
mipsparc 2008.08.18,1016,3,3,43,151,42,-109,A
mipsparc 2008.08.18,1016,3,3,43,141,44,-97,B
lacceroswaldo 2008.08.15,972,1,1,13,125,46,-79,A
lacceroswaldo 2008.08.15,972,1,1,13,124,31,-93,B
mipsparc 2008.08.15,1025,1,0,13,211,23,-188,A
mipsparc 2008.08.15,1025,1,0,13,190,23,-167,B
Skribble 2008.08.18,869,1,1,15,291,27,-264,A
Skribble 2008.08.18,869,1,1,15,294,27,-267,B
MianMy 2008.08.18,1031,1,0,17,385,24,-361,A
MianMy 2008.08.18,1031,1,0,17,392,24,-368,B
sambang 2008.08.08,1041,1,1,6,65,33,-32,A
sambang 2008.08.08,1041,1,1,6,72,17,-55,B
bhAmco 2008.08.08,890,1,0,5,114,20,-94,A
bhAmco 2008.08.08,890,1,0,5,108,20,-88,B
Silias 2008.12.29,977,1,0,13,238,23,-215,A
Silias 2008.12.29,977,1,0,13,262,23,-239,B
nicksun 2008.12.29,944,1,1,9,51,33,-18,A
nicksun 2008.12.29,944,1,1,9,97,22,-75,B
JabZ 2008.08.17,894,1,0,5,125,40,-85,A
JabZ 2008.08.17,894,1,0,5,111,40,-71,B
zqnzt 2008.08.17,874,2,1,17,153,18,-135,A
zqnzt 2008.08.17,874,2,1,17,154,18,-136,B
lacceroswaldo 2008.08.10,983,3,1,46,221,22,-199,A
lacceroswaldo 2008.08.10,983,3,1,46,186,26,-160,B
mipsparc 2008.08.10,1010,3,2,40,152,42,-110,A
mipsparc 2008.08.10,1010,3,2,40,138,47,-91,B
zqnzt 2008.08.24,870,1,0.5,36,329,19,-310,A
zqnzt 2008.08.24,870,1,0.5,36,334,31,-303,B
Oriontwelve 2008.08.24,1033,1,0.5,25,190,32,-158,A
Oriontwelve 2008.08.24,1033,1,0.5,25,195,28,-167,B
zqnzt 2008.08.20,898,1,0,18,184,33,-151,A
zqnzt 2008.08.20,898,1,0,18,174,33,-141,B
JabZ 2008.08.20,846,1,1,17,94,41,-53,A
JabZ 2008.08.20,846,1,1,17,108,35,-73,B
madjoe 2008.08.08,985,1,0,19,389,16,-373,A
madjoe 2008.08.08,985,1,0,19,365,16,-349,B
theonejanitor 2008.08.08,956,2,1,16,226,6,-220,A
theonejanitor 2008.08.08,956,2,1,16,214,6,-208,B
marearoja 2008.08.19,896,1,0,16,432,25,-407,A
marearoja 2008.08.19,896,1,0,16,393,25,-368,B
JabZ 2008.08.19,827,1,1,13,182,23,-159,A
JabZ 2008.08.19,827,1,1,13,146,23,-123,B
drinkwater 2008.08.01,1013,1,1,4,0,100,100,A
drinkwater 2008.08.01,1013,1,1,4,0,100,100,B
zqnzt 2008.08.01,888,2,0,44,202,34,-168,A
zqnzt 2008.08.01,888,2,0,44,206,32,-174,B
SGTMAJUSMC 2008.08.30,1035,1,0,6,274,17,-257,A
SGTMAJUSMC 2008.08.30,1035,1,0,6,256,17,-239,B
MianMy 2008.08.30,986,1,1,5,142,40,-102,A
MianMy 2008.08.30,986,1,1,5,103,40,-63,B
SGTMAJUSMC 2008.08.23,877,1,0,5,435,0,-435,A
SGTMAJUSMC 2008.08.23,877,1,0,5,427,0,-427,B
darkkknight 2008.08.23,1080,1,1,4,98,75,-23,A
darkkknight 2008.08.23,1080,1,1,4,90,75,-15,B
kanderson 2008.08.07,943,1,0,7,402,0,-402,A
kanderson 2008.08.07,943,1,0,7,329,14,-315,B
viqous 2008.08.07,1024,1,1,6,248,33,-215,A
viqous 2008.08.07,1024,1,1,6,178,33,-145,B
Skribble 2008.08.23,969,1,1,10,226,10,-216,A
Skribble 2008.08.23,969,1,1,10,216,10,-206,B
NaraShikamaru 2008.08.23,912,1,0,11,305,27,-278,A
NaraShikamaru 2008.08.23,912,1,0,11,349,27,-322,B
lacceroswaldo 2008.08.06,966,2,1,42,198,29,-169,A
lacceroswaldo 2008.08.06,966,2,1,42,192,33,-159,B
mipsparc 2008.08.06,1018,2,1,46,172,35,-137,A
mipsparc 2008.08.06,1018,2,1,46,191,33,-158,B
Ghirlando 2008.08.14,934,1,0,10,116,40,-76,A
Ghirlando 2008.08.14,934,1,0,10,129,50,-79,B
oldchessbook 2008.08.14,1006,1,1,12,341,25,-316,A
oldchessbook 2008.08.14,1006,1,1,12,356,25,-331,B
NaraShikamaru 2008.08.11,898,1,0,34,261,26,-235,A
NaraShikamaru 2008.08.11,898,1,0,34,248,26,-222,B
Lucanus 2008.08.11,1083,1,1,32,190,22,-168,A
Lucanus 2008.08.11,1083,1,1,32,180,28,-152,B
takatsugu 2008.08.08,824,1,1,20,209,30,-179,A
takatsugu 2008.08.08,824,1,1,20,194,30,-164,B
Sinickas 2008.08.08,953,2,1,24,232,38,-194,A
Sinickas 2008.08.08,953,2,1,24,170,38,-132,B
Nicdog 2008.08.01,1108,1,1,34,120,47,-73,A
Nicdog 2008.08.01,1108,1,1,34,117,41,-76,B
fishmasters 2008.12.26,808,1,0,23,318,22,-296,A
fishmasters 2008.12.26,808,1,0,23,336,17,-319,B
MohanGH 2008.12.26,1043,1,1,27,408,22,-386,A
MohanGH 2008.12.26,1043,1,1,27,412,22,-390,B
Scrios 2008.08.17,1021,1,1,10,83,30,-53,A
Scrios 2008.08.17,1021,1,1,10,98,30,-68,B
Shagmaster 2008.12.23,1032,1,0,7,271,14,-257,A
Shagmaster 2008.12.23,1032,1,0,7,256,0,-256,B
calexander 2008.12.23,780,5,3,81,166,26,-140,A
calexander 2008.12.23,780,5,3,81,159,25,-134,B
sanavabitch 2008.08.17,1049,1,1,25,121,32,-89,A
sanavabitch 2008.08.17,1049,1,1,25,120,32,-88,B
madjoe 2008.08.17,942,1,0,26,186,15,-171,A
madjoe 2008.08.17,942,1,0,26,181,19,-162,B
Skribble 2008.08.15,841,1,1,10,98,20,-78,A
Skribble 2008.08.15,841,1,1,10,109,20,-89,B
KimN 2008.08.15,1154,1,0,10,109,40,-69,A
KimN 2008.08.15,1154,1,0,10,114,50,-64,B
zqnzt 2008.08.09,863,1,1,8,150,25,-125,A
zqnzt 2008.08.09,863,1,1,8,118,38,-80,B
shaaaft 2008.08.09,953,1,0,8,154,38,-116,A
shaaaft 2008.08.09,953,1,0,8,146,25,-121,B
MianMy 2008.08.08,1039,1,1,5,188,40,-148,A
MianMy 2008.08.08,1039,1,1,5,223,40,-183,B
viqous 2008.08.08,1009,2,1,18,227,22,-205,A
viqous 2008.08.08,1009,2,1,18,196,28,-168,B
pumpbuster 2008.08.05,1119,2,2,21,83,48,-35,A
pumpbuster 2008.08.05,1119,2,2,21,79,52,-27,B
pumpbuster 2008.08.05,1119,2,2,21,71,48,-23,C
isntheaqt 2008.08.05,866,2,0,22,211,23,-188,A
isntheaqt 2008.08.05,866,2,0,22,198,23,-175,B
isntheaqt 2008.08.05,866,2,0,22,198,18,-180,C
Sebbel 2008.08.08,839,2,1,16,161,56,-105,A
Sebbel 2008.08.08,839,2,1,16,74,69,-5,B
plumbo 2008.08.08,964,1,0,7,187,29,-158,A
plumbo 2008.08.08,964,1,0,7,202,29,-173,B
PABOY 2008.12.25,836,1,0.5,29,227,41,-186,A
PABOY 2008.12.25,836,1,0.5,29,225,38,-187,B
nottwoday 2008.12.25,1131,1,0.5,34,320,21,-299,A
nottwoday 2008.12.25,1131,1,0.5,34,334,26,-308,B
JabZ 2008.12.17,953,1,0,10,148,20,-128,A
JabZ 2008.12.17,953,1,0,10,210,20,-190,B
richess 2008.12.17,863,1,1,10,210,40,-170,A
richess 2008.12.17,863,1,1,10,220,50,-170,B
PauloZanol 2008.12.05,984,1,0,10,300,30,-270,A
PauloZanol 2008.12.05,984,1,0,10,215,30,-185,B
PauloZanol 2008.12.05,984,1,0,10,222,20,-202,C
sakarauka 2008.12.05,951,2,2,26,97,62,-35,A
sakarauka 2008.12.05,951,2,2,26,115,54,-61,B
sakarauka 2008.12.05,951,2,2,26,123,50,-73,C
isntheaqt 2008.08.08,843,1,1,23,123,39,-84,A
isntheaqt 2008.08.08,843,1,1,23,118,48,-70,B
pumpbuster 2008.08.08,1142,1,0,24,255,33,-222,A
pumpbuster 2008.08.08,1142,1,0,24,207,33,-174,B
viqous 2008.08.09,1009,1,0,7,249,29,-220,A
viqous 2008.08.09,1009,1,0,7,292,29,-263,B
pmineiro 2008.08.09,791,1,1,5,130,20,-110,A
pmineiro 2008.08.09,791,1,1,5,174,0,-174,B
mipsparc 2008.08.07,1014,2,1,32,263,25,-238,A
mipsparc 2008.08.07,1014,2,1,32,254,22,-232,B
lacceroswaldo 2008.08.07,966,2,1,23,198,22,-176,A
lacceroswaldo 2008.08.07,966,2,1,23,170,26,-144,B
dylanfanatic 2008.07.31,1066,1,1,10,78,40,-38,A
dylanfanatic 2008.07.31,1066,1,1,10,66,30,-36,B
DDJ 2008.07.31,878,1,0,10,257,0,-257,A
DDJ 2008.07.31,878,1,0,10,258,0,-258,B
jasonmyerss 2008.08.02,831,2,1,35,182,37,-145,A
jasonmyerss 2008.08.02,831,2,1,35,170,37,-133,B
haraldr 2008.08.02,1154,1,1,8,112,63,-49,A
haraldr 2008.08.02,1154,1,1,8,120,62,-58,B
lacceroswaldo 2008.12.22,966,3,1,73,193,45,-148,A
lacceroswaldo 2008.12.22,966,3,1,73,184,38,-146,B
mipsparc 2008.12.22,1031,3,2,71,147,31,-116,A
mipsparc 2008.12.22,1031,3,2,71,141,32,-109,B
karilo 2008.08.06,1124,1,1,44,138,34,-104,A
karilo 2008.08.06,1124,1,1,44,131,36,-95,B
vetteboy 2008.08.06,872,1,0,44,176,34,-142,A
vetteboy 2008.08.06,872,1,0,44,157,30,-127,B
mflood 2008.08.07,967,1,1,32,168,44,-124,A
mflood 2008.08.07,967,1,1,32,162,44,-118,B
drinkwater 2008.08.07,1018,1,0,30,160,30,-130,A
drinkwater 2008.08.07,1018,1,0,30,158,33,-125,B
gforced 2008.12.23,876,2,1,30,277,17,-260,A
gforced 2008.12.23,876,2,1,30,268,20,-248,B
ilovepie 2008.12.19,838,2,1,36,225,31,-194,A
ilovepie 2008.12.19,838,2,1,36,223,33,-190,B
madPhysicist 2008.12.19,1150,1,1,10,108,20,-88,A
madPhysicist 2008.12.19,1150,1,1,10,141,10,-131,B
thebrickwall 2007.12.12,984,1,0,10,122,50,-72,A
thebrickwall 2007.12.12,984,1,0,10,123,50,-73,B
Oscoap 2007.12.12,979,1,1,9,70,33,-37,A
Oscoap 2007.12.12,979,1,1,9,59,44,-15,B
nicksun 2008.12.21,945,1,0,8,190,38,-152,A
nicksun 2008.12.21,945,1,0,8,193,25,-168,B
oldchessbook 2008.12.21,1033,1,1,8,188,50,-138,A
oldchessbook 2008.12.21,1033,1,1,8,167,38,-129,B
gaiberner 2008.12.18,1123,1,1,17,263,18,-245,A
gaiberner 2008.12.18,1123,1,1,17,190,29,-161,B
PABOY 2008.12.18,851,2,0,25,244,40,-204,A
PABOY 2008.12.18,851,2,0,25,240,44,-196,B
musick 2008.12.18,842,1,1,5,117,20,-97,A
musick 2008.12.18,842,1,1,5,109,20,-89,B
darumsdad 2008.08.02,1159,1,0,25,223,36,-187,A
darumsdad 2008.08.02,1159,1,0,25,214,36,-178,B
isntheaqt 2008.08.04,875,1,0,17,224,29,-195,A
isntheaqt 2008.08.04,875,1,0,17,238,18,-220,B
pumpbuster 2008.08.04,1122,1,1,16,190,44,-146,A
pumpbuster 2008.08.04,1122,1,1,16,187,25,-162,B
HELENEMARIE 2008.12.29,1186,1,1,15,187,27,-160,A
HELENEMARIE 2008.12.29,1186,1,1,15,179,27,-152,B
Crashinator 2008.12.29,783,2,1,19,257,32,-225,A
Crashinator 2008.12.29,783,2,1,19,256,37,-219,B
licolo 2008.12.23,1096,1,0,15,365,27,-338,A
licolo 2008.12.23,1096,1,0,15,334,27,-307,B
melmothX 2008.12.23,1033,1,1,17,120,18,-102,A
melmothX 2008.12.23,1033,1,1,17,118,12,-106,B
craigzooka 2008.12.16,1073,1,1,9,100,11,-89,A
craigzooka 2008.12.16,1073,1,1,9,83,11,-72,B
Damppu 2008.12.16,987,1,0,10,222,20,-202,A
Damppu 2008.12.16,987,1,0,10,220,20,-200,B
zqnzt 2008.08.04,896,1,0,4,83,50,-33,A
zqnzt 2008.08.04,896,1,0,4,43,50,7,B
LordJesus 2008.08.04,1007,1,1,5,343,0,-343,A
LordJesus 2008.08.04,1007,1,1,5,377,0,-377,B
wontonguy 2008.08.05,1112,1,1,64,269,19,-250,A
wontonguy 2008.08.05,1112,1,1,64,262,20,-242,B
lbwest 2008.08.05,865,1,0,62,229,29,-200,A
lbwest 2008.08.05,865,1,0,62,231,24,-207,B
alexmaxflo 2008.12.14,950,1,1,5,388,0,-388,A
alexmaxflo 2008.12.14,950,1,1,5,420,0,-420,B
mariosaga 2008.12.14,860,1,0,5,497,20,-477,A
mariosaga 2008.12.14,860,1,0,5,532,20,-512,B
Crashinator 2008.12.11,801,1,0,7,334,29,-305,A
Crashinator 2008.12.11,801,1,0,7,337,29,-308,B
jkkcole 2008.12.11,1040,1,1,4,54,75,21,A
jkkcole 2008.12.11,1040,1,1,4,50,50,0,B
Lucanus 2008.08.07,1110,1,0,19,152,42,-110,A
Lucanus 2008.08.07,1110,1,0,19,159,42,-117,B
vetteboy 2008.08.07,863,1,1,25,220,24,-196,A
vetteboy 2008.08.07,863,1,1,25,192,28,-164,B
isntheaqt 2008.08.07,850,1,0,26,233,27,-206,A
isntheaqt 2008.08.07,850,1,0,26,265,27,-238,B
pumpbuster 2008.08.07,1131,1,1,23,171,30,-141,A
pumpbuster 2008.08.07,1131,1,1,23,181,30,-151,B
jkkcole 2008.12.20,981,1,0,22,117,41,-76,A
jkkcole 2008.12.20,981,1,0,22,127,41,-86,B
calexander 2008.12.20,820,2,1,78,111,41,-70,A
calexander 2008.12.20,820,2,1,78,120,38,-82,B
noncsi 2008.12.25,1004,1,1,8,84,50,-34,A
noncsi 2008.12.25,1004,1,1,8,61,50,-11,B
LDopa 2008.12.25,991,1,0,10,223,20,-203,A
LDopa 2008.12.25,991,1,0,10,203,10,-193,B
simmito 2008.12.20,959,3,1,47,170,26,-144,A
simmito 2008.12.20,959,3,1,47,152,26,-126,B
achieve 2008.12.20,1030,3,2,47,120,30,-90,A
achieve 2008.12.20,1030,3,2,47,125,28,-97,B
PABOY 2008.12.30,866,1,0,17,281,29,-252,A
PABOY 2008.12.30,866,1,0,17,266,24,-242,B
markssixtyfour 2008.12.30,1048,1,1,13,161,38,-123,A
markssixtyfour 2008.12.30,1048,1,1,13,126,38,-88,B
noncsi 2008.12.14,943,1,0,14,121,43,-78,A
noncsi 2008.12.14,943,1,0,14,122,43,-79,B
preux 2008.12.14,935,1,1,13,37,54,17,A
preux 2008.12.14,935,1,1,13,39,54,15,B
gforced 2008.10.05,907,1,0,11,338,9,-329,A
gforced 2008.10.05,907,1,0,11,314,9,-305,B
huzar 2008.10.05,1014,1,1,9,196,11,-185,A
huzar 2008.10.05,1014,1,1,9,158,11,-147,B
DHamm 2008.12.22,1079,1,0,20,83,35,-48,A
DHamm 2008.12.22,1079,1,0,20,100,30,-70,B
mariosaga 2008.12.22,840,1,1,21,180,19,-161,A
mariosaga 2008.12.22,840,1,1,21,201,24,-177,B
svenolof 2008.12.23,1074,1,0,26,242,23,-219,A
svenolof 2008.12.23,1074,1,0,26,207,23,-184,B
fishmasters 2008.12.23,917,1,0,18,98,17,-81,A
fishmasters 2008.12.23,917,1,0,18,96,22,-74,B
JabZ 2008.12.23,909,1,1,5,21,60,39,A
JabZ 2008.12.23,909,1,1,5,13,80,67,B
noncsi 2008.12.27,1008,1,0.5,51,47,29,-18,A
noncsi 2008.12.27,1008,1,0.5,51,40,31,-9,B
noncsi 2008.12.27,1008,1,0.5,51,47,33,-14,C
noncsi 2008.12.27,1008,1,0.5,51,44,33,-11,D
zaruda 2008.12.27,976,1,0.5,50,22,14,-8,A
zaruda 2008.12.27,976,1,0.5,50,19,14,-5,B
zaruda 2008.12.27,976,1,0.5,50,21,16,-5,C
zaruda 2008.12.27,976,1,0.5,50,18,16,-2,D
JForce 2008.12.28,987,1,0,9,179,0,-179,A
JForce 2008.12.28,987,1,0,9,178,0,-178,B
Birgie 2008.12.28,924,1,1,9,242,0,-242,A
Birgie 2008.12.28,924,1,1,9,231,0,-231,B
calexander 2008.12.26,979,2,1,23,220,35,-185,A
calexander 2008.12.26,979,2,1,23,213,35,-178,B
JForce 2008.12.26,1009,1,0,11,185,36,-149,A
JForce 2008.12.26,1009,1,0,11,186,46,-140,B
nicksun 2008.12.18,958,1,1,22,139,32,-107,A
nicksun 2008.12.18,958,1,1,22,128,36,-92,B
ilovepie 2008.12.18,865,1,0,25,281,20,-261,A
ilovepie 2008.12.18,865,1,0,25,241,20,-221,B
vetteboy 2008.12.15,931,1,1,39,189,28,-161,A
vetteboy 2008.12.15,931,1,1,39,191,26,-165,B
Jayrec 2008.12.15,981,1,0,42,341,19,-322,A
Jayrec 2008.12.15,981,1,0,42,277,21,-256,B
kampycss 2008.12.28,978,1,1,12,139,25,-114,A
kampycss 2008.12.28,978,1,1,12,111,33,-78,B
kanghyun 2008.12.28,1008,1,0,12,278,8,-270,A
kanghyun 2008.12.28,1008,1,0,12,254,8,-246,B
ValerianSimon 2008.12.27,1155,1,1,10,71,50,-21,A
ValerianSimon 2008.12.27,1155,1,1,10,59,60,1,B
Crashinator 2008.12.27,790,1,0,11,216,27,-189,A
Crashinator 2008.12.27,790,1,0,11,200,27,-173,B
LaurentDelaon 2008.12.26,1050,1,1,13,244,23,-221,A
LaurentDelaon 2008.12.26,1050,1,1,13,225,23,-202,B
Sebbel 2008.12.23,897,1,1,19,67,47,-20,A
Sebbel 2008.12.23,897,1,1,19,49,47,-2,B
LaurentDelaon 2008.12.29,1119,1,0,5,553,20,-533,A
LaurentDelaon 2008.12.29,1119,1,0,5,566,20,-546,B
skillzrfornewbs 2008.12.21,991,1,1,5,0,80,80,A
skillzrfornewbs 2008.12.21,991,1,1,5,0,80,80,B
jacobsthedog 2008.12.21,997,1,0,6,309,17,-292,A
jacobsthedog 2008.12.21,997,1,0,6,332,17,-315,B
DHamm 2008.12.21,1075,1,1,6,72,67,-5,A
DHamm 2008.12.21,1075,1,1,6,40,67,27,B
calexander 2008.12.21,853,4,0,95,198,26,-172,A
calexander 2008.12.21,853,4,0,95,200,27,-173,B
noncsi 2008.12.21,927,1,1,37,120,32,-88,A
noncsi 2008.12.21,927,1,1,37,118,38,-80,B
melmothX 2008.12.21,989,1,1,23,126,35,-91,A
melmothX 2008.12.21,989,1,1,23,138,39,-99,B
Crashinator 2008.12.12,804,1,0,13,166,31,-135,A
Crashinator 2008.12.12,804,1,0,13,184,31,-153,B
Kurkospede 2008.12.12,1144,1,1,8,111,62,-49,A
Kurkospede 2008.12.12,1144,1,1,8,108,50,-58,B
sarabande 2008.12.19,1147,1,0,22,287,36,-251,A
sarabande 2008.12.19,1147,1,0,22,240,27,-213,B
Sebbel 2008.12.21,873,1,1,25,75,72,-3,A
Sebbel 2008.12.21,873,1,1,25,72,60,-12,B
Sebbel 2008.12.21,873,1,1,25,72,60,-12,C
oldchessbook 2008.12.20,1088,1,1,59,112,46,-66,A
oldchessbook 2008.12.20,1088,1,1,59,123,46,-77,B
vetteboy 2008.12.11,907,1,0,14,240,7,-233,A
vetteboy 2008.12.11,907,1,0,14,231,7,-224,B
lesane 2008.12.11,1068,1,1,13,123,31,-92,A
lesane 2008.12.11,1068,1,1,13,124,38,-86,B
gforced 2008.11.22,878,1,0.5,23,201,26,-175,A
gforced 2008.11.22,878,1,0.5,23,203,30,-173,B
shahidul 2008.11.22,1096,1,0.5,22,259,18,-241,A
shahidul 2008.11.22,1096,1,0.5,22,244,14,-230,B
Afjaks 2008.11.02,993,1,1,7,114,29,-85,A
Afjaks 2008.11.02,993,1,1,7,114,14,-100,B
Devdan 2008.11.02,966,1,0,7,310,0,-310,A
Devdan 2008.11.02,966,1,0,7,299,0,-299,B
nicksun 2008.11.24,839,2,2,24,144,46,-98,A
nicksun 2008.11.24,839,2,2,24,160,46,-114,B
ralexander 2008.11.24,912,1,0,17,205,35,-170,A
ralexander 2008.11.24,912,1,0,17,217,29,-188,B
pedrosc 2008.10.23,991,2,2,49,75,35,-40,A
pedrosc 2008.10.23,991,2,2,49,75,35,-40,B
Birgie 2008.10.23,917,2,0,52,141,31,-110,A
Birgie 2008.10.23,917,2,0,52,143,37,-106,B
lapppi 2008.10.16,1090,1,1,8,76,38,-38,A
lapppi 2008.10.16,1090,1,1,8,38,38,0,B
nicksun 2008.10.16,850,1,0,9,316,22,-294,A
nicksun 2008.10.16,850,1,0,9,286,22,-264,B
calexander 2008.12.17,841,1,0,11,256,9,-247,A
calexander 2008.12.17,841,1,0,11,250,18,-232,B
SunRaphi 2008.12.17,984,1,1,9,118,22,-96,A
SunRaphi 2008.12.17,984,1,1,9,115,33,-82,B
mariosaga 2008.12.15,851,1,0,6,295,17,-278,A
mariosaga 2008.12.15,851,1,0,6,281,17,-264,B
calexander 2008.12.15,797,1,1,5,140,20,-120,A
calexander 2008.12.15,797,1,1,5,120,40,-80,B
MementoMoriAB 2008.12.16,983,1,1,37,350,22,-328,A
MementoMoriAB 2008.12.16,983,1,1,37,343,24,-319,B
musick 2008.12.16,868,1,0,29,238,31,-207,A
musick 2008.12.16,868,1,0,29,222,31,-191,B
Crashinator 2008.12.04,796,1,1,18,260,22,-238,A
Crashinator 2008.12.04,796,1,1,18,258,22,-236,B
FishyRats 2008.12.04,1109,1,0,19,362,10,-352,A
FishyRats 2008.12.04,1109,1,0,19,354,16,-338,B
SvartTorn 2008.12.07,1142,1,0,22,275,27,-248,A
SvartTorn 2008.12.07,1142,1,0,22,264,32,-232,B
SvartTorn 2008.12.07,1142,1,0,22,269,32,-237,C
saturnine 2008.12.07,773,1,1,19,177,47,-130,A
saturnine 2008.12.07,773,1,1,19,177,53,-124,B
saturnine 2008.12.07,773,1,1,19,142,53,-89,C
noncsi 2008.12.05,956,1,0,23,324,22,-302,A
noncsi 2008.12.05,956,1,0,23,321,26,-295,B
Hurricaine 2008.12.05,1037,1,1,20,179,25,-154,A
Hurricaine 2008.12.05,1037,1,1,20,233,25,-208,B
nibbio 2008.12.16,1036,1,1,8,77,62,-15,A
nibbio 2008.12.16,1036,1,1,8,65,62,-3,B
salius 2008.12.16,878,1,0,10,344,30,-314,A
salius 2008.12.16,878,1,0,10,342,20,-322,B
Hurricaine 2008.12.04,985,6,3,133,260,25,-235,A
Hurricaine 2008.12.04,985,6,3,133,250,22,-228,B
brainllama 2008.12.04,987,1,0,8,370,12,-358,A
brainllama 2008.12.04,987,1,0,8,303,12,-291,B
Noller 2008.11.30,1126,1,0,12,150,25,-125,A
Noller 2008.11.30,1126,1,0,12,188,8,-180,B
ralexander 2008.11.30,772,3,2,41,131,34,-97,A
ralexander 2008.11.30,772,3,2,41,150,39,-111,B
nicksun 2008.11.28,881,2,2,37,222,14,-208,A
nicksun 2008.11.28,881,2,2,37,226,11,-215,B
kiwa 2008.11.28,1006,2,0,41,222,20,-202,A
kiwa 2008.11.28,1006,2,0,41,226,22,-204,B
ZDIP 2008.11.12,872,1,0,15,129,27,-102,A
ZDIP 2008.11.12,872,1,0,15,125,20,-105,B
pedrosc 2008.11.12,1112,1,1,11,91,27,-64,A
pedrosc 2008.11.12,1112,1,1,11,82,27,-55,B
LDopa 2008.12.12,990,2,1,25,225,32,-193,A
LDopa 2008.12.12,990,2,1,25,216,28,-188,B
calexander 2008.12.12,768,3,1,40,225,25,-200,A
calexander 2008.12.12,768,3,1,40,230,23,-207,B
Crashinator 2008.12.10,781,2,0,23,247,17,-230,A
Crashinator 2008.12.10,781,2,0,23,246,13,-233,B
Checkonetwo 2008.12.10,1189,1,1,8,122,38,-84,A
Checkonetwo 2008.12.10,1189,1,1,8,160,25,-135,B
luizaquino 2008.12.03,1012,1,1,5,153,20,-133,A
luizaquino 2008.12.03,1012,1,1,5,123,20,-103,B
richess 2008.12.03,900,1,0,6,325,0,-325,A
richess 2008.12.03,900,1,0,6,354,33,-321,B
nicksun 2008.12.03,955,1,1,21,130,38,-92,A
nicksun 2008.12.03,955,1,1,21,135,38,-97,B
gforced 2008.12.03,894,1,0,22,221,27,-194,A
gforced 2008.12.03,894,1,0,22,235,32,-203,B
lacceroswaldo 2008.12.03,933,2,2,28,104,57,-47,A
lacceroswaldo 2008.12.03,933,2,2,28,115,50,-65,B
lacceroswaldo 2008.12.03,933,2,2,28,126,39,-87,C
brainllama 2008.12.03,1016,2,0,33,286,24,-262,A
brainllama 2008.12.03,1016,2,0,33,271,24,-247,B
brainllama 2008.12.03,1016,2,0,33,275,21,-254,C
BranimirM 2008.11.26,1072,1,1,10,90,50,-40,A
BranimirM 2008.11.26,1072,1,1,10,95,50,-45,B
salius 2008.11.26,918,1,0,10,272,30,-242,A
salius 2008.11.26,918,1,0,10,275,30,-245,B
PauloZanol 2008.12.02,952,1,0,14,344,14,-330,A
PauloZanol 2008.12.02,952,1,0,14,348,14,-334,B
gforced 2008.12.02,855,1,1,10,191,40,-151,A
gforced 2008.12.02,855,1,1,10,207,20,-187,B
ScottJoplin 2008.12.10,1150,1,1,14,157,29,-128,A
ScottJoplin 2008.12.10,1150,1,1,14,171,29,-142,B
Checkonetwo 2008.11.20,1094,1,1,5,32,60,28,A
Checkonetwo 2008.11.20,1094,1,1,5,22,60,38,B
Crashinator 2008.11.20,843,1,0,4,114,50,-64,A
Crashinator 2008.11.20,843,1,0,4,93,50,-43,B
calexander 2008.12.01,899,2,0,32,231,28,-203,A
calexander 2008.12.01,899,2,0,32,221,25,-196,B
richess 2008.12.01,925,2,1,19,216,32,-184,A
richess 2008.12.01,925,2,1,19,224,32,-192,B
calexander 2008.11.30,1065,1,0,9,145,56,-89,A
calexander 2008.11.30,1065,1,0,9,133,44,-89,B
richess 2008.11.30,922,2,1,19,288,21,-267,A
richess 2008.11.30,922,2,1,19,304,16,-288,B
ralexander 2008.12.12,1030,1,1,18,178,22,-156,A
ralexander 2008.12.12,1030,1,1,18,172,22,-150,B
PauloZanol 2008.12.04,870,5,3,126,257,31,-226,A
PauloZanol 2008.12.04,870,5,3,126,228,29,-199,B
LDopa 2008.12.01,961,1,1,6,105,33,-72,A
LDopa 2008.12.01,961,1,1,6,141,33,-108,B
ScottJoplin 2008.12.06,1113,1,1,28,65,39,-26,A
ScottJoplin 2008.12.06,1113,1,1,28,67,39,-28,B
richess 2008.12.06,876,1,0,29,124,48,-76,A
richess 2008.12.06,876,1,0,29,142,45,-97,B
richess 2008.12.04,874,1,0.5,8,278,12,-266,A
richess 2008.12.04,874,1,0.5,8,243,12,-231,B
Livvy 2008.12.04,1077,1,0.5,6,129,33,-96,A
Livvy 2008.12.04,1077,1,0.5,6,111,33,-78,B
oldchessbook 2008.11.30,1073,1,1,6,25,83,58,A
oldchessbook 2008.11.30,1073,1,1,6,21,83,62,B
Jacknottheripper 2008.11.18,1087,1,1,13,37,46,9,A
Jacknottheripper 2008.11.18,1087,1,1,13,43,46,3,B
nicksun 2008.11.18,832,1,0,12,107,50,-57,A
nicksun 2008.11.18,832,1,0,12,108,50,-58,B
mariosaga 2008.12.03,870,1,0,29,185,34,-151,A
mariosaga 2008.12.03,870,1,0,29,181,41,-140,B
booxey 2008.12.03,1116,1,1,23,141,35,-106,A
booxey 2008.12.03,1116,1,1,23,147,35,-112,B
Crashinator 2008.11.14,825,2,1,14,211,43,-168,A
Crashinator 2008.11.14,825,2,1,14,191,36,-155,B
dahuigou 2008.11.14,1207,1,0,8,420,0,-420,A
dahuigou 2008.11.14,1207,1,0,8,263,12,-251,B
wolfmoon 2008.10.16,988,1,1,27,336,15,-321,A
wolfmoon 2008.10.16,988,1,1,27,387,11,-376,B
WhiteWarrior 2008.10.16,893,1,0,21,357,5,-352,A
WhiteWarrior 2008.10.16,893,1,0,21,383,5,-378,B
adamfg 2008.11.27,861,1,1,12,111,8,-103,A
adamfg 2008.11.27,861,1,1,12,90,17,-73,B
ddleale 2008.11.27,1094,1,0,13,222,8,-214,A
ddleale 2008.11.27,1094,1,0,13,224,15,-209,B
lacceroswaldo 2008.11.06,982,3,0,40,337,30,-307,A
lacceroswaldo 2008.11.06,982,3,0,40,340,25,-315,B
lacceroswaldo 2008.11.06,982,3,0,40,327,25,-302,C
mipsparc 2008.11.06,1013,3,3,29,97,45,-52,A
mipsparc 2008.11.06,1013,3,3,29,100,52,-48,B
mipsparc 2008.11.06,1013,3,3,29,103,48,-55,C
mipsparc 2008.10.28,1047,3,0,53,221,42,-179,A
mipsparc 2008.10.28,1047,3,0,53,197,42,-155,B
lacceroswaldo 2008.10.28,932,3,3,49,212,37,-175,A
lacceroswaldo 2008.10.28,932,3,3,49,211,35,-176,B
nicksun 2008.11.23,851,1,0,11,292,27,-265,A
nicksun 2008.11.23,851,1,0,11,346,18,-328,B
josephkain 2008.11.23,1026,1,1,6,40,33,-7,A
josephkain 2008.11.23,1026,1,1,6,32,33,1,B
sakarauka 2008.11.06,1072,1,1,4,74,50,-24,A
sakarauka 2008.11.06,1072,1,1,4,67,50,-17,B
bkpbkpbkpbkp 2008.11.06,923,1,0,4,338,0,-338,A
bkpbkpbkpbkp 2008.11.06,923,1,0,4,308,0,-308,B
sakarauka 2008.12.02,993,2,0,9,374,11,-363,A
sakarauka 2008.12.02,993,2,0,9,354,11,-343,B
brainllama 2008.12.02,952,2,2,8,89,50,-39,A
brainllama 2008.12.02,952,2,2,8,84,50,-34,B
Tribune 2008.12.02,951,1,1,11,199,27,-172,A
Tribune 2008.12.02,951,1,1,11,237,18,-219,B
louieshao 2008.12.02,1040,1,0,10,53,60,7,A
louieshao 2008.12.02,1040,1,0,10,40,50,10,B
calexander 2008.12.05,800,1,0,17,101,35,-66,A
calexander 2008.12.05,800,1,0,17,64,41,-23,B
calexander 2008.12.05,800,1,0,17,85,53,-32,C
nicksun 2008.11.30,930,1,0,23,260,17,-243,A
nicksun 2008.11.30,930,1,0,23,284,17,-267,B
gforced 2008.11.30,972,1,0,6,338,17,-321,A
gforced 2008.11.30,972,1,0,6,304,17,-287,B
wumblebumble 2008.11.30,1015,1,1,5,112,60,-52,A
wumblebumble 2008.11.30,1015,1,1,5,66,60,-6,B
noncsi 2008.12.01,950,1,1,17,211,24,-187,A
noncsi 2008.12.01,950,1,1,17,207,24,-183,B
nnoah 2008.11.28,1029,3,2.5,58,129,33,-96,A
nnoah 2008.11.28,1029,3,2.5,58,155,33,-122,B
jasonsonly 2008.11.28,947,3,0.5,65,268,29,-239,A
jasonsonly 2008.11.28,947,3,0.5,65,256,29,-227,B
gforced 2008.12.01,890,1,0,9,212,0,-212,A
gforced 2008.12.01,890,1,0,9,163,0,-163,B
brainllama 2008.12.01,922,2,1,13,179,31,-148,A
brainllama 2008.12.01,922,2,1,13,173,31,-142,B
nicksun 2008.11.16,853,2,0,57,291,32,-259,A
nicksun 2008.11.16,853,2,0,57,260,30,-230,B
hmmy 2008.11.16,1097,1,1,19,137,37,-100,A
hmmy 2008.11.16,1097,1,1,19,142,32,-110,B
krugarius 2008.11.30,892,1,1,8,65,50,-15,A
krugarius 2008.11.30,892,1,1,8,70,50,-20,B
jasonsonly 2008.11.25,869,2,0.5,62,155,34,-121,A
jasonsonly 2008.11.25,869,2,0.5,62,150,31,-119,B
tabbykt 2008.11.25,1036,2,1.5,64,125,28,-97,A
tabbykt 2008.11.25,1036,2,1.5,64,127,28,-99,B
vaportrail 2008.11.29,1131,1,0,15,148,33,-115,A
vaportrail 2008.11.29,1131,1,0,15,157,27,-130,B
PABOY 2008.11.29,823,1,1,16,248,12,-236,A
PABOY 2008.11.29,823,1,1,16,246,6,-240,B
jasonsonly 2008.11.20,881,2,0.5,45,280,18,-262,A
jasonsonly 2008.11.20,881,2,0.5,45,264,18,-246,B
tabbykt 2008.11.20,1033,2,1.5,33,161,21,-140,A
tabbykt 2008.11.20,1033,2,1.5,33,142,27,-115,B
DoctorTommy 2008.12.01,960,1,1,5,170,40,-130,A
DoctorTommy 2008.12.01,960,1,1,5,149,40,-109,B
LibertasProVita 2008.11.30,1034,1,0,17,347,18,-329,A
LibertasProVita 2008.11.30,1034,1,0,17,326,18,-308,B
noncsi 2008.11.30,919,1,1,14,131,50,-81,A
noncsi 2008.11.30,919,1,1,14,189,50,-139,B
Simplicus 2008.10.26,1102,2,2,15,164,27,-137,A
Simplicus 2008.10.26,1102,2,2,15,169,27,-142,B
SchwarzeKatze 2008.10.26,835,2,0,13,249,23,-226,A
SchwarzeKatze 2008.10.26,835,2,0,13,247,31,-216,B
JabZ 2008.10.14,889,1,1,12,47,50,3,A
JabZ 2008.10.14,889,1,1,12,47,50,3,B
WhiteWarrior 2008.10.14,929,1,0,13,161,8,-153,A
WhiteWarrior 2008.10.14,929,1,0,13,154,8,-146,B
jasonsonly 2008.11.27,863,1,1,8,157,38,-119,A
jasonsonly 2008.11.27,863,1,1,8,103,50,-53,B
LKD 2008.11.27,1100,1,0,7,232,29,-203,A
LKD 2008.11.27,1100,1,0,7,171,29,-142,B
Kitanopp 2008.11.24,955,1,0,10,323,10,-313,A
Kitanopp 2008.11.24,955,1,0,10,369,10,-359,B
lucasdawn 2008.11.22,1055,1,0,7,431,14,-417,A
lucasdawn 2008.11.22,1055,1,0,7,434,14,-420,B
nicksun 2008.11.22,823,1,1,3,172,33,-139,A
nicksun 2008.11.22,823,1,1,3,136,33,-103,B
AnotherPawn 2008.11.14,1170,1,1,7,147,14,-133,A
AnotherPawn 2008.11.14,1170,1,1,7,85,43,-42,B
owzat 2008.10.12,740,1,0,23,199,26,-173,A
owzat 2008.10.12,740,1,0,23,206,26,-180,B
hamstartype 2008.10.12,1212,1,1,17,111,47,-64,A
hamstartype 2008.10.12,1212,1,1,17,109,47,-62,B
EndlessWC 2008.10.12,1007,2,2,69,201,26,-175,A
EndlessWC 2008.10.12,1007,2,2,69,200,26,-174,B
vetteboy 2008.10.12,871,1,0,53,138,26,-112,A
vetteboy 2008.10.12,871,1,0,53,136,30,-106,B
Intactive 2008.10.03,971,1,0,15,253,40,-213,A
Intactive 2008.10.03,971,1,0,15,250,27,-223,B
jacquesmoll 2008.10.03,991,1,1,19,374,26,-348,A
jacquesmoll 2008.10.03,991,1,1,19,352,21,-331,B
chrisreeh 2008.11.16,1050,1,1,31,274,26,-248,A
chrisreeh 2008.11.16,1050,1,1,31,249,23,-226,B
billington 2008.11.04,1009,1,1,11,253,36,-217,A
billington 2008.11.04,1009,1,1,11,258,36,-222,B
mariosaga 2008.11.04,876,1,0,10,393,10,-383,A
mariosaga 2008.11.04,876,1,0,10,405,10,-395,B
lacceroswaldo 2008.09.28,969,2,0,21,361,29,-332,A
lacceroswaldo 2008.09.28,969,2,0,21,237,29,-208,B
mipsparc 2008.09.28,1025,2,2,22,221,50,-171,A
mipsparc 2008.09.28,1025,2,2,22,218,45,-173,B
ArtexHarimau 2008.10.04,1032,1,1,18,134,44,-90,A
ArtexHarimau 2008.10.04,1032,1,1,18,93,44,-49,B
BayDragoy 2008.10.04,910,1,0,20,190,50,-140,A
BayDragoy 2008.10.04,910,1,0,20,181,35,-146,B
vulturemort 2008.11.21,964,1,1,18,236,33,-203,A
vulturemort 2008.11.21,964,1,1,18,242,33,-209,B
PABOY 2008.11.21,856,1,0,19,265,16,-249,A
PABOY 2008.11.21,856,1,0,19,290,16,-274,B
vannman 2008.11.24,1109,1,1,22,204,45,-159,A
vannman 2008.11.24,1109,1,1,22,171,46,-125,B
PABOY 2008.11.24,830,1,0,24,282,21,-261,A
PABOY 2008.11.24,830,1,0,24,284,17,-267,B
sobecripa 2008.11.04,896,1,0,11,239,36,-203,A
sobecripa 2008.11.04,896,1,0,11,207,36,-171,B
kwe 2008.11.04,1012,1,1,10,242,50,-192,A
kwe 2008.11.04,1012,1,1,10,232,40,-192,B
WhiteWarrior 2008.10.21,818,1,0.5,12,232,33,-199,A
WhiteWarrior 2008.10.21,818,1,0.5,12,220,33,-187,B
PABOY 2008.10.21,921,1,0.5,9,106,33,-73,A
PABOY 2008.10.21,921,1,0.5,9,103,22,-81,B
salius 2008.11.18,958,1,0,9,313,11,-302,A
salius 2008.11.18,958,1,0,9,299,11,-288,B
ticetice 2008.11.18,985,1,1,7,78,29,-49,A
ticetice 2008.11.18,985,1,1,7,73,43,-30,B
Girdot 2008.11.10,993,1,1,16,56,25,-31,A
Girdot 2008.11.10,993,1,1,16,43,25,-18,B
LDopa 2008.11.10,991,1,0,17,128,18,-110,A
LDopa 2008.11.10,991,1,0,17,130,12,-118,B
LDopa 2008.11.20,971,1,0,17,162,12,-150,A
LDopa 2008.11.20,971,1,0,17,157,18,-139,B
CaptainWooly 2008.11.20,966,1,1,16,148,25,-123,A
CaptainWooly 2008.11.20,966,1,1,16,140,25,-115,B
WildHogSM 2008.10.12,868,2,1,14,403,21,-382,A
WildHogSM 2008.10.12,868,2,1,14,301,29,-272,B
SGTMAJUSMC 2008.10.12,1020,1,0,7,225,14,-211,A
SGTMAJUSMC 2008.10.12,1020,1,0,7,168,14,-154,B
vetteboy 2008.09.18,868,1,1,15,144,33,-111,A
vetteboy 2008.09.18,868,1,1,15,129,33,-96,B
Yokain 2008.09.18,990,1,0,15,230,13,-217,A
Yokain 2008.09.18,990,1,0,15,212,13,-199,B
SkyBrain 2008.11.18,970,1,1,27,192,37,-155,A
SkyBrain 2008.11.18,970,1,1,27,197,37,-160,B
GauiSig 2008.11.18,1023,1,0,23,148,30,-118,A
GauiSig 2008.11.18,1023,1,0,23,123,44,-79,B
nicksun 2008.11.15,814,1,1,8,58,38,-20,A
nicksun 2008.11.15,814,1,1,8,53,50,-3,B
golmman 2008.11.15,1077,1,0,8,217,37,-180,A
golmman 2008.11.15,1077,1,0,8,183,38,-145,B
Uncrowned 2008.11.11,992,1,0,18,129,44,-85,A
Uncrowned 2008.11.11,992,1,0,18,137,28,-109,B
madcardinal 2008.11.11,873,1,1,17,92,29,-63,A
madcardinal 2008.11.11,873,1,1,17,88,35,-53,B
headroad 2008.10.31,1089,1,1,22,215,27,-188,A
headroad 2008.10.31,1089,1,1,22,248,27,-221,B
mariosaga 2008.10.31,838,1,0,29,410,17,-393,A
mariosaga 2008.10.31,838,1,0,29,410,17,-393,B
Ephphatha 2008.01.29,979,1,1,13,259,15,-244,A
Ephphatha 2008.01.29,979,1,1,13,261,15,-246,B
louiswei 2008.01.29,1007,1,0,12,171,42,-129,A
louiswei 2008.01.29,1007,1,0,12,179,42,-137,B
greghyde 2008.09.21,805,2,0,10,631,20,-611,A
greghyde 2008.09.21,805,2,0,10,634,20,-614,B
tamusachess 2008.09.21,1190,2,2,6,202,33,-169,A
tamusachess 2008.09.21,1190,2,2,6,214,33,-181,B
Imbolt 2008.11.16,1153,1,1,33,82,46,-36,A
Imbolt 2008.11.16,1153,1,1,33,88,39,-49,B
JohntheChristian 2008.11.16,846,1,0,34,201,24,-177,A
JohntheChristian 2008.11.16,846,1,0,34,155,26,-129,B
sakarauka 2008.11.11,1011,1,1,18,73,33,-40,A
sakarauka 2008.11.11,1011,1,1,18,98,39,-59,B
rayizmi 2008.11.11,867,1,0,19,190,26,-164,A
rayizmi 2008.11.11,867,1,0,19,196,32,-164,B
CharlesCornner 2008.11.09,1072,1,1,9,40,44,4,A
CharlesCornner 2008.11.09,1072,1,1,9,44,44,0,B
nicksun 2008.11.09,835,1,0,13,213,31,-182,A
nicksun 2008.11.09,835,1,0,13,261,23,-238,B
pmineiro 2008.11.05,880,1,0,17,382,12,-370,A
pmineiro 2008.11.05,880,1,0,17,315,6,-309,B
nnoah 2008.11.05,1053,1,1,14,153,21,-132,A
nnoah 2008.11.05,1053,1,1,14,172,21,-151,B
SchwarzeKatze 2008.10.27,835,2,1,62,285,27,-258,A
SchwarzeKatze 2008.10.27,835,2,1,62,275,27,-248,B
Simplicus 2008.10.27,1102,2,1,52,199,33,-166,A
Simplicus 2008.10.27,1102,2,1,52,192,35,-157,B
karpovasparov 2008.10.07,934,2,2,40,145,25,-120,A
karpovasparov 2008.10.07,934,2,2,40,153,22,-131,B
JabZ 2008.10.07,920,1,0,15,50,40,-10,A
JabZ 2008.10.07,920,1,0,15,43,53,10,B
lacceroswaldo 2008.10.07,942,3,0.5,53,279,40,-239,A
lacceroswaldo 2008.10.07,942,3,0.5,53,283,36,-247,B
mipsparc 2008.10.07,1052,3,2.5,51,275,31,-244,A
mipsparc 2008.10.07,1052,3,2.5,51,262,37,-225,B
huzar 2008.11.10,1072,1,1,4,85,25,-60,A
huzar 2008.11.10,1072,1,1,4,129,25,-104,B
PABOY 2008.11.10,882,1,0,5,465,20,-445,A
PABOY 2008.11.10,882,1,0,5,507,20,-487,B
kiper 2008.11.10,974,1,1,17,153,35,-118,A
kiper 2008.11.10,974,1,1,17,155,35,-120,B
bkpbkpbkpbkp 2008.11.10,1011,1,0,17,184,35,-149,A
bkpbkpbkpbkp 2008.11.10,1011,1,0,17,195,47,-148,B
mariosaga 2008.11.01,823,1,0,7,155,14,-141,A
mariosaga 2008.11.01,823,1,0,7,230,14,-216,B
deermaster 2008.11.01,1159,1,1,5,124,20,-104,A
deermaster 2008.11.01,1159,1,1,5,105,0,-105,B
cazzimeo 2008.10.25,968,1,0,32,136,41,-95,A
cazzimeo 2008.10.25,968,1,0,32,135,44,-91,B
jacquesmoll 2008.10.25,1003,1,1,29,96,48,-48,A
jacquesmoll 2008.10.25,1003,1,1,29,71,48,-23,B
PABOY 2008.10.09,825,1,1,8,120,38,-82,A
PABOY 2008.10.09,825,1,1,8,116,50,-66,B
mateone 2008.10.09,1013,1,0,8,258,12,-246,A
mateone 2008.10.09,1013,1,0,8,250,12,-238,B
LDopa 2008.11.04,990,1,0,13,383,15,-368,A
LDopa 2008.11.04,990,1,0,13,294,23,-271,B
pmineiro 2008.11.04,835,1,1,11,198,45,-153,A
pmineiro 2008.11.04,835,1,1,11,215,46,-169,B
pmineiro 2008.11.02,832,1,0.5,22,200,14,-186,A
pmineiro 2008.11.02,832,1,0.5,22,198,14,-184,B
mariosaga 2008.11.02,854,1,0.5,26,286,23,-263,A
mariosaga 2008.11.02,854,1,0.5,26,324,27,-297,B
thebrickwall 2008.10.30,1092,1,1,10,154,10,-144,A
thebrickwall 2008.10.30,1092,1,1,10,162,10,-152,B
louieshao 2008.10.30,906,1,0,10,213,40,-173,A
louieshao 2008.10.30,906,1,0,10,223,30,-193,B
kwe 2008.11.05,1031,1,1,16,148,44,-104,A
kwe 2008.11.05,1031,1,1,16,141,44,-97,B
leobrazer 2008.11.05,963,1,0,17,203,24,-179,A
leobrazer 2008.11.05,963,1,0,17,249,29,-220,B
milehicheckmater 2008.10.30,994,1,1,9,107,22,-85,A
milehicheckmater 2008.10.30,994,1,1,9,99,22,-77,B
jacquesmoll 2008.10.30,986,1,0,11,196,9,-187,A
jacquesmoll 2008.10.30,986,1,0,11,195,18,-177,B
nicksun 2008.10.25,838,1,0,14,131,29,-102,A
nicksun 2008.10.25,838,1,0,14,141,29,-112,B
SumitNarayan 2008.10.25,996,1,1,9,54,67,13,A
SumitNarayan 2008.10.25,996,1,1,9,40,67,27,B
nicksun 2008.10.26,822,1,0.5,8,221,25,-196,A
nicksun 2008.10.26,822,1,0.5,8,226,12,-214,B
SumitNarayan 2008.10.26,1016,1,0.5,7,110,43,-67,A
SumitNarayan 2008.10.26,1016,1,0.5,7,87,43,-44,B
AJLee 2008.10.22,990,1,1,9,530,11,-519,A
AJLee 2008.10.22,990,1,1,9,422,11,-411,B
WhiteWarrior 2008.10.22,825,1,0,11,544,9,-535,A
WhiteWarrior 2008.10.22,825,1,0,11,491,9,-482,B
LaurentDelaon 2008.10.13,1076,1,1,28,184,32,-152,A
LaurentDelaon 2008.10.13,1076,1,1,28,178,36,-142,B
nicksun 2008.10.13,884,1,0,28,233,36,-197,A
nicksun 2008.10.13,884,1,0,28,223,39,-184,B
Intactive 2008.09.16,943,1,1,18,27,67,40,A
Intactive 2008.09.16,943,1,1,18,24,56,32,B
thewingedweasel 2008.09.16,1010,1,0,17,92,41,-51,A
thewingedweasel 2008.09.16,1010,1,0,17,92,35,-57,B
mariosaga 2008.10.30,917,2,0,19,244,26,-218,A
mariosaga 2008.10.30,917,2,0,19,242,26,-216,B
JooBoo 2008.10.30,923,2,2,17,87,24,-63,A
JooBoo 2008.10.30,923,2,2,17,92,29,-63,B
LDopa 2008.10.28,987,1,0.5,15,240,7,-233,A
LDopa 2008.10.28,987,1,0.5,15,221,13,-208,B
PABOY 2008.10.28,938,1,0.5,14,198,21,-177,A
PABOY 2008.10.28,938,1,0.5,14,186,14,-172,B
smittyohtwohund 2008.10.31,891,1,0.5,41,106,46,-60,A
smittyohtwohund 2008.10.31,891,1,0.5,41,101,44,-57,B
privateschultz 2008.10.31,1096,1,0.5,43,79,49,-30,A
privateschultz 2008.10.31,1096,1,0.5,43,76,44,-32,B
WhiteWarrior 2008.10.19,870,2,0,43,184,19,-165,A
WhiteWarrior 2008.10.19,870,2,0,43,171,21,-150,B
SumitNarayan 2008.10.19,946,1,1,29,146,41,-105,A
SumitNarayan 2008.10.19,946,1,1,29,132,38,-94,B
lacceroswaldo 2008.09.21,957,3,2.0,88,171,31,-140,A
lacceroswaldo 2008.09.21,957,3,2.0,88,157,26,-131,B
mipsparc 2008.09.21,1037,3,1.0,102,185,41,-144,A
mipsparc 2008.09.21,1037,3,1.0,102,193,35,-158,B
PABOY 2008.10.16,880,1,1,17,266,12,-254,A
PABOY 2008.10.16,880,1,1,17,306,12,-294,B
nottwoday 2008.10.16,1066,1,0,23,474,17,-457,A
nottwoday 2008.10.16,1066,1,0,23,454,13,-441,B
mipsparc 2008.10.04,1044,4,3,65,201,34,-167,A
mipsparc 2008.10.04,1044,4,3,65,207,35,-172,B
lacceroswaldo 2008.10.04,950,4,1,64,251,27,-224,A
lacceroswaldo 2008.10.04,950,4,1,64,251,25,-226,B
nicksun 2008.10.12,904,1,0,9,237,33,-204,A
nicksun 2008.10.12,904,1,0,9,137,33,-104,B
Simplicus 2008.10.11,1087,1,1,12,96,42,-54,A
Simplicus 2008.10.11,1087,1,1,12,106,33,-73,B
SchwarzeKatze 2008.10.11,856,1,0,13,195,23,-172,A
SchwarzeKatze 2008.10.11,856,1,0,13,194,31,-163,B
BlindOsaridSaris 2008.10.07,1023,1,0,23,92,26,-66,A
BlindOsaridSaris 2008.10.07,1023,1,0,23,75,26,-49,B
pmineiro 2008.10.19,792,1,1,14,126,21,-105,A
pmineiro 2008.10.19,792,1,1,14,113,21,-92,B
owzat 2008.10.11,836,1,0,41,107,27,-80,A
owzat 2008.10.11,836,1,0,41,112,34,-78,B
plumbo 2008.10.11,821,1,1,40,79,48,-31,A
plumbo 2008.10.11,821,1,1,40,84,45,-39,B
vetteboy 2008.10.17,881,1,0,22,250,14,-236,A
vetteboy 2008.10.17,881,1,0,22,261,18,-243,B
Society 2008.10.17,1056,1,1,15,114,40,-74,A
Society 2008.10.17,1056,1,1,15,106,40,-66,B
Ekwalyzer 2008.10.11,1076,1,0,9,152,56,-96,A
Ekwalyzer 2008.10.11,1076,1,0,9,91,44,-47,B
vetteboy 2008.10.11,856,1,1,9,263,22,-241,A
vetteboy 2008.10.11,856,1,1,9,195,11,-184,B
vetteboy 2008.10.15,881,2,1,78,205,28,-177,A
vetteboy 2008.10.15,881,2,1,78,217,32,-185,B
MohanGH 2008.10.15,1069,2,1,79,155,33,-122,A
MohanGH 2008.10.15,1069,2,1,79,169,32,-137,B
cyrdro 2008.09.12,948,1,1,17,118,29,-89,A
cyrdro 2008.09.12,948,1,1,17,117,29,-88,B
mjcsjo 2008.09.12,1043,1,0,17,154,41,-113,A
mjcsjo 2008.09.12,1043,1,0,17,165,29,-136,B
Zleeper 2008.10.12,1097,1,1,8,86,12,-74,A
Zleeper 2008.10.12,1097,1,1,8,70,25,-45,B
MCalkins 2008.10.10,991,3,2,117,105,44,-61,A
MCalkins 2008.10.10,991,3,2,117,111,43,-68,B
huzar 2008.10.10,954,3,1,117,106,37,-69,A
huzar 2008.10.10,954,3,1,117,103,39,-64,B
lacceroswaldo 2008.10.08,933,1,1,61,114,39,-75,A
lacceroswaldo 2008.10.08,933,1,1,61,110,34,-76,B
huzar 2008.10.08,985,2,1,74,105,35,-70,A
huzar 2008.10.08,985,2,1,74,112,38,-74,B
HawkX 2008.09.17,1030,1,0,10,302,20,-282,A
HawkX 2008.09.17,1030,1,0,10,306,10,-296,B
ChrisBeginner 2008.09.17,954,1,1,7,103,43,-60,A
ChrisBeginner 2008.09.17,954,1,1,7,82,43,-39,B
mbranimir 2008.10.08,990,1,0,15,199,13,-186,A
mbranimir 2008.10.08,990,1,0,15,191,13,-178,B
vetteboy 2008.10.05,847,1,0,11,300,9,-291,A
vetteboy 2008.10.05,847,1,0,11,314,9,-305,B
Leonidovich 2008.10.05,935,1,1,11,267,36,-231,A
Leonidovich 2008.10.05,935,1,1,11,278,36,-242,B
SchwarzeKatze 2008.09.20,878,1,0,11,224,18,-206,A
SchwarzeKatze 2008.09.20,878,1,0,11,176,27,-149,B
Simplicus 2008.09.20,1099,1,1,13,302,31,-271,A
Simplicus 2008.09.20,1099,1,1,13,252,38,-214,B
lacceroswaldo 2008.10.02,956,1,0,25,269,32,-237,A
lacceroswaldo 2008.10.02,956,1,0,25,266,40,-226,B
mipsparc 2008.10.02,1038,1,1,25,255,24,-231,A
mipsparc 2008.10.02,1038,1,1,25,258,20,-238,B
vetteboy 2008.09.28,874,1,0,21,305,10,-295,A
vetteboy 2008.09.28,874,1,0,21,269,14,-255,B
lauraT 2008.09.28,1087,1,1,22,251,27,-224,A
lauraT 2008.09.28,1087,1,1,22,245,23,-222,B
JooBoo 2008.09.15,981,1,0,16,206,19,-187,A
JooBoo 2008.09.15,981,1,0,16,194,31,-163,B
ChrisBeginner 2008.09.15,830,3,1.5,95,137,41,-96,A
ChrisBeginner 2008.09.15,830,3,1.5,95,156,40,-116,B
Intactive 2008.09.23,998,2,0,35,201,29,-172,A
Intactive 2008.09.23,998,2,0,35,196,29,-167,B
aleksthegreat 2008.09.23,955,2,2,37,267,19,-248,A
aleksthegreat 2008.09.23,955,2,2,37,257,19,-238,B
civiliansoldier 2008.09.20,902,1,1,18,177,33,-144,A
civiliansoldier 2008.09.20,902,1,1,18,182,28,-154,B
Intactive 2008.09.20,1005,1,0,16,157,25,-132,A
Intactive 2008.09.20,1005,1,0,16,137,25,-112,B
ChrisBeginner 2008.09.18,932,1,0,18,119,28,-91,A
ChrisBeginner 2008.09.18,932,1,0,18,121,28,-93,B
dickdale 2008.09.18,982,1,1,18,77,33,-44,A
dickdale 2008.09.18,982,1,1,18,86,33,-53,B
mikemandrake 2008.09.15,951,1,1,10,236,30,-206,A
mikemandrake 2008.09.15,951,1,1,10,314,40,-274,B
giospoto 2008.09.15,1036,1,0,7,139,43,-96,A
giospoto 2008.09.15,1036,1,0,7,153,57,-96,B
PABOY 2008.10.01,850,1,0,8,225,25,-200,A
PABOY 2008.10.01,850,1,0,8,308,25,-283,B
Tremeoc 2008.10.01,1121,1,1,6,62,67,5,A
Tremeoc 2008.10.01,1121,1,1,6,71,67,-4,B
laksen 2008.09.21,973,1,0,9,151,22,-129,A
laksen 2008.09.21,973,1,0,9,147,22,-125,B
EverythingIsTaken 2008.09.21,1001,1,1,8,58,62,4,A
EverythingIsTaken 2008.09.21,1001,1,1,8,62,62,0,B
ChrisBeginner 2008.09.20,909,2,1,65,137,45,-92,A
ChrisBeginner 2008.09.20,909,2,1,65,133,45,-88,B
Jackiw 2008.09.20,1090,2,1,68,143,38,-105,A
Jackiw 2008.09.20,1090,2,1,68,145,34,-111,B
nottwoday 2008.09.16,1095,1,1,25,365,24,-341,A
nottwoday 2008.09.16,1095,1,1,25,384,24,-360,B
marearoja 2008.09.16,894,1,0,24,454,25,-429,A
marearoja 2008.09.16,894,1,0,24,461,25,-436,B
mjcsjo 2008.09.15,1139,2,1.5,75,96,35,-61,A
mjcsjo 2008.09.15,1139,2,1.5,75,92,36,-56,B
ChrisBeginner 2008.09.13,906,1,0,4,151,25,-126,A
ChrisBeginner 2008.09.13,906,1,0,4,438,25,-413,B
mateone 2008.09.13,988,1,1,9,427,22,-405,A
mateone 2008.09.13,988,1,1,9,409,22,-387,B
