Name,Rating,Games,Moves,CPL,MM,Sort Score,Analysis
DumbRedNeck 2009.07.30,731,2,25,280,20,-260,A
DumbRedNeck 2009.07.30,731,2,25,288,24,-264,B
Loran 2009.07.30,767,2,22,239,32,-207,A
Loran 2009.07.30,767,2,22,245,32,-213,B
LeyZ 2009.08.04,826,1,16,234,19,-215,A
LeyZ 2009.08.04,826,1,16,211,31,-180,B
nathy 2009.08.04,752,1,18,360,22,-338,A
nathy 2009.08.04,752,1,18,355,22,-333,B
dahuigou 2008.11.21,685,2,51,268,33,-235,A
dahuigou 2008.11.21,685,2,50,270,36,-234,B
Crashinator 2008.11.21,843,2,58,365,40,-325,A
Crashinator 2008.11.21,843,2,57,371,39,-332,B
DINOCO 2007.10.23,781,1,20,243,5,-238,A
DINOCO 2007.10.23,781,1,19,260,0,-260,B
louiswei 2007.10.23,800,1,21,300,10,-290,A
louiswei 2007.10.23,800,1,21,303,10,-293,B
HogODeath 2007.04.23,1047,1,19,353,21,-332,A
HogODeath 2007.04.23,1047,1,19,363,16,-347,B
greenqueenbrasil 2007.04.23,816,1,22,429,4,-425,A
greenqueenbrasil 2007.04.23,816,1,21,399,5,-394,B
nathy 2009.08.06,733,1,11,312,18,-294,A
nathy 2009.08.06,733,1,11,319,9,-310,B
ktinfl 2009.08.06,866,1,10,165,20,-145,A
ktinfl 2009.08.06,866,1,10,148,20,-128,B
fjjvh 2009.04.04,666,1,21,331,10,-321,A
fjjvh 2009.04.04,666,1,20,310,10,-300,B
zhouzhaowu 2009.04.04,821,1,17,218,0,-218,A
zhouzhaowu 2009.04.04,821,1,17,169,12,-157,B
Birgie 2008.12.27,822,1,10,103,30,-73,A
Birgie 2008.12.27,822,1,10,118,30,-88,B
Shagmaster 2008.12.27,712,1,11,192,46,-146,A
Shagmaster 2008.12.27,712,1,11,195,46,-149,B
fjjvh 2009.03.29,672,1,34,262,24,-238,A
fjjvh 2009.03.29,672,1,34,262,18,-244,B
chmpf 2009.03.29,926,1,34,249,24,-225,A
chmpf 2009.03.29,926,1,33,258,24,-234,B
Knighter 2000.01.15,899,2,72,244,15,-229,A
Knighter 2000.01.15,899,2,71,263,14,-249,B
mrfriday 2000.01.15,672,1,25,174,24,-150,A
mrfriday 2000.01.15,672,1,24,182,25,-157,B
Crashinator 2008.11.28,789,2,38,302,24,-278,A
Crashinator 2008.11.28,789,2,39,301,21,-280,B
dahuigou 2008.11.28,794,2,38,314,26,-288,A
dahuigou 2008.11.28,794,2,38,326,21,-305,B
Crashinator 2008.12.05,808,1,12,95,17,-78,A
Crashinator 2008.12.05,808,1,10,81,20,-61,B
dahuigou 2008.12.05,706,1,14,234,21,-213,A
dahuigou 2008.12.05,706,1,14,222,21,-201,B
bigouden 2006.12.07,1022,1,14,239,21,-218,A
bigouden 2006.12.07,1022,1,14,220,43,-177,B
SamuelJunior 2006.12.07,946,1,13,164,23,-141,A
SamuelJunior 2006.12.07,946,1,13,167,8,-159,B
hotwheela 2006.12.22,810,1,38,334,18,-316,A
hotwheela 2006.12.22,810,1,38,352,16,-336,B
jpiscool 2006.12.22,1141,1,38,307,24,-283,A
jpiscool 2006.12.22,1141,1,38,318,24,-294,B
jshumaker 2006.12.30,845,1,21,213,33,-180,A
jshumaker 2006.12.30,845,1,21,194,29,-165,B
Superdonut 2006.12.30,1065,1,31,324,23,-301,A
Superdonut 2006.12.30,1065,1,31,332,32,-300,B
Sevenkings 2006.12.28,1012,1,21,221,29,-192,A
Sevenkings 2006.12.28,1012,1,21,196,24,-172,B
ItIsLife 2006.12.28,943,1,19,138,21,-117,A
ItIsLife 2006.12.28,943,1,20,107,30,-77,B
faldur 2004.03.13,1102,1,24,106,38,-68,A
faldur 2004.03.13,1102,1,23,102,44,-58,B
GolfBob 2004.03.13,847,1,25,154,24,-130,A
GolfBob 2004.03.13,847,1,25,153,28,-125,B
zephrys 2006.11.12,932,1,9,232,56,-176,A
zephrys 2006.11.12,932,1,9,343,44,-299,B
feelm 2006.11.12,998,2,27,370,33,-337,A
feelm 2006.11.12,998,2,26,391,31,-360,B
Malca 2006.10.26,976,1,41,166,32,-134,A
Malca 2006.10.26,976,1,41,163,32,-131,B
SamuelJunior 2006.10.26,982,1,40,199,15,-184,A
SamuelJunior 2006.10.26,982,1,40,198,18,-180,B
Funditor 2006.09.27,947,1,23,46,44,-2,A
Funditor 2006.09.27,947,1,22,49,46,-3,B
Malca 2006.09.27,1046,1,23,68,30,-38,A
Malca 2006.09.27,1046,1,23,77,30,-47,B
Halfman 2005.12.21,939,1,31,180,29,-151,A
Halfman 2005.12.21,939,1,32,194,31,-163,B
ChessRio 2005.12.21,949,1,32,195,25,-170,A
ChessRio 2005.12.21,949,1,32,205,22,-183,B
dopeyone 2004.03.15,827,1,21,259,19,-240,A
dopeyone 2004.03.15,827,1,21,290,14,-276,B
fuss 2004.03.15,992,1,17,121,29,-92,A
fuss 2004.03.15,992,1,18,143,33,-110,B
JohnstonDJ 2006.12.08,942,1,25,209,24,-185,A
JohnstonDJ 2006.12.08,942,1,24,219,29,-190,B
oubobcat 2006.12.08,841,3,61,135,30,-105,A
oubobcat 2006.12.08,841,3,59,128,29,-99,B
racinebaby 2006.11.29,1125,1,12,94,25,-69,A
racinebaby 2006.11.29,1125,1,12,91,33,-58,B
harrypotar 2006.11.29,820,1,12,162,33,-129,A
harrypotar 2006.11.29,820,1,12,169,33,-136,B
dockson 2004.01.15,869,1,21,98,52,-46,A
dockson 2004.01.15,869,1,21,94,52,-42,B
dockson 2004.01.15,869,1,21,91,57,-34,C
PravinMamania 2004.01.15,1041,1,22,166,18,-148,A
PravinMamania 2004.01.15,1041,1,22,165,18,-147,B
PravinMamania 2004.01.15,1041,1,21,153,19,-134,C
shechem 2004.03.03,1020,1,27,136,30,-106,A
shechem 2004.03.03,1020,1,26,127,31,-96,B
GolfBob 2004.03.03,966,1,28,201,21,-180,A
GolfBob 2004.03.03,966,1,28,194,21,-173,B
GlennaSarous 2003.10.29,933,1,18,208,28,-180,A
GlennaSarous 2003.10.29,933,1,18,229,33,-196,B
SavoySlim 2003.10.29,1049,1,18,310,11,-299,A
SavoySlim 2003.10.29,1049,1,18,348,6,-342,B
ASABOTO 2004.03.12,1092,1,29,114,45,-69,A
ASABOTO 2004.03.12,1092,1,28,114,46,-68,B
GolfBob 2004.03.12,865,1,32,195,22,-173,A
GolfBob 2004.03.12,865,1,31,219,23,-196,B
HGBoone 2006.11.14,1124,1,12,76,50,-26,A
HGBoone 2006.11.14,1124,1,12,62,58,-4,B
sneakypawn 2006.11.14,865,1,14,211,14,-197,A
sneakypawn 2006.11.14,865,1,14,209,14,-195,B
sneakypawn 2006.10.27,867,1,12,286,8,-278,A
sneakypawn 2006.10.27,867,1,12,224,17,-207,B
walnutwally 2006.10.27,1112,1,10,56,50,-6,A
walnutwally 2006.10.27,1112,1,10,54,40,-14,B
stickyfinger 2003.12.01,1022,1,10,434,30,-404,A
stickyfinger 2003.12.01,1022,1,9,448,22,-426,B
radicalrichierich 2003.12.01,945,1,7,399,14,-385,A
radicalrichierich 2003.12.01,945,1,7,418,14,-404,B
rbb 2005.11.29,837,1,7,92,57,-35,A
rbb 2005.11.29,837,1,7,64,43,-21,B
forkboy 2005.11.29,1068,1,10,334,40,-294,A
forkboy 2005.11.29,1068,1,9,382,33,-349,B
augustuscaesar 2006.07.25,917,1,17,213,18,-195,A
augustuscaesar 2006.07.25,917,1,17,212,12,-200,B
TheCardinal 2006.07.25,1052,1,15,162,27,-135,A
TheCardinal 2006.07.25,1052,1,15,160,20,-140,B
selectorSimit 2006.12.06,914,1,11,67,54,-13,A
selectorSimit 2006.12.06,914,1,11,59,46,-13,B
hotwheelb 2006.12.06,899,1,12,282,17,-265,A
hotwheelb 2006.12.06,899,1,12,270,8,-262,B
GolfBob 2004.03.09,935,1,23,273,22,-251,A
GolfBob 2004.03.09,935,1,23,302,13,-289,B
shechem 2004.03.09,1006,1,23,291,30,-261,A
shechem 2004.03.09,1006,1,23,311,30,-281,B
DazedDj 2003.12.16,946,5,121,217,27,-190,A
DazedDj 2003.12.16,946,5,115,203,30,-173,B
BoardBoy 2003.12.16,1039,5,105,141,37,-104,A
BoardBoy 2003.12.16,1039,5,100,137,36,-101,B
BRubble 2003.07.05,1044,1,10,40,70,30,A
BRubble 2003.07.05,1044,1,10,42,70,28,B
dumpyshubby 2003.07.05,920,1,12,227,0,-227,A
dumpyshubby 2003.07.05,920,1,12,233,0,-233,B
Triplea 2003.03.29,909,2,42,222,24,-198,A
Triplea 2003.03.29,909,2,42,196,24,-172,B
pendragonz 2003.03.29,1031,1,28,172,39,-133,A
pendragonz 2003.03.29,1031,1,28,151,39,-112,B
supriyasodhi 2006.06.12,922,3,44,276,23,-253,A
supriyasodhi 2006.06.12,922,3,42,276,17,-259,B
hungerartist 2006.06.12,1076,3,41,256,19,-237,A
hungerartist 2006.06.12,1076,3,40,264,17,-247,B
iascrazyorioles 2006.12.18,921,1,37,60,30,-30,A
iascrazyorioles 2006.12.18,921,1,33,65,30,-35,B
hotwheela 2006.12.18,911,1,43,143,26,-117,A
hotwheela 2006.12.18,911,1,44,195,23,-172,B
dockson 2004.02.11,874,1,28,151,25,-126,A
dockson 2004.02.11,874,1,28,145,29,-116,B
shechem 2004.02.11,1056,1,30,246,27,-219,A
shechem 2004.02.11,1056,1,30,247,20,-227,B
chelletijn 2004.02.16,958,2,25,289,40,-249,A
chelletijn 2004.02.16,958,2,23,299,39,-260,B
Melko 2004.02.16,990,1,9,93,67,-26,A
Melko 2004.02.16,990,1,8,146,75,-71,B
jpiscool 2006.12.23,1147,1,11,211,18,-193,A
jpiscool 2006.12.23,1147,1,10,232,20,-212,B
hotwheela 2006.12.23,784,1,9,164,22,-142,A
hotwheela 2006.12.23,784,1,9,164,22,-142,B
DunnMark 2004.01.13,1167,1,9,54,56,2,A
DunnMark 2004.01.13,1167,1,10,43,50,7,B
CashCow 2004.01.13,831,1,9,155,11,-144,A
CashCow 2004.01.13,831,1,10,150,10,-140,B
yanto 2004.02.10,995,1,23,120,26,-94,A
yanto 2004.02.10,995,1,23,113,26,-87,B
yanto 2004.02.10,995,1,23,115,26,-89,C
dockson 2004.02.10,874,1,25,155,56,-99,A
dockson 2004.02.10,874,1,25,155,52,-103,B
dockson 2004.02.10,874,1,25,151,44,-107,C
sibil 2004.03.02,1095,1,13,116,31,-85,A
sibil 2004.03.02,1095,1,13,106,38,-68,B
WhiteSide 2004.03.02,848,2,33,208,27,-181,A
WhiteSide 2004.03.02,848,2,33,197,39,-158,B
lksharma 2006.12.09,1256,1,14,86,14,-72,A
lksharma 2006.12.09,1256,1,14,89,14,-75,B
RandyRoo 2006.12.09,753,1,15,226,33,-193,A
RandyRoo 2006.12.09,753,1,15,233,20,-213,B
Sevenkings 2006.10.26,1101,1,13,241,23,-218,A
Sevenkings 2006.10.26,1101,1,13,228,31,-197,B
sneakypawn 2006.10.26,894,1,14,367,7,-360,A
sneakypawn 2006.10.26,894,1,14,405,0,-405,B
Bryceman 2003.04.13,1165,1,88,94,43,-51,A
Bryceman 2003.04.13,1165,1,88,99,40,-59,B
Fitzakarle 2003.04.13,742,1,86,78,26,-52,A
Fitzakarle 2003.04.13,742,1,86,76,30,-46,B
Fitzakarle 2003.04.10,907,1,15,162,20,-142,A
Fitzakarle 2003.04.10,907,1,15,149,27,-122,B
pendragonz 2003.04.10,1070,1,13,65,38,-27,A
pendragonz 2003.04.10,1070,1,13,54,38,-16,B
metallicguy 2006.10.05,885,1,8,118,62,-56,A
metallicguy 2006.10.05,885,1,8,147,62,-85,B
Funditor 2006.10.05,876,1,11,280,46,-234,A
Funditor 2006.10.05,876,1,10,342,10,-332,B
flinn 2003.05.02,1029,1,15,157,40,-117,A
flinn 2003.05.02,1029,1,14,141,43,-98,B
abeme 2003.05.02,855,1,11,90,27,-63,A
abeme 2003.05.02,855,1,11,60,54,-6,B
tujhbq 2006.10.02,933,1,11,6,82,76,A
tujhbq 2006.10.02,933,1,11,14,82,68,B
Elrocks 2006.10.02,764,1,11,153,18,-135,A
Elrocks 2006.10.02,764,1,11,157,27,-130,B
jmvbxx 2006.09.06,1004,1,12,93,58,-35,A
jmvbxx 2006.09.06,1004,1,12,98,58,-40,B
KnightLightning 2006.09.06,956,2,54,153,30,-123,A
KnightLightning 2006.09.06,956,2,52,140,33,-107,B
Folinsbee 2004.03.02,934,1,18,173,28,-145,A
Folinsbee 2004.03.02,934,1,18,158,28,-130,B
bigouden 2006.12.09,1013,1,41,107,42,-65,A
bigouden 2006.12.09,1013,1,40,103,45,-58,B
uvrays 2006.12.09,952,1,38,82,37,-45,A
uvrays 2006.12.09,952,1,36,83,36,-47,B
onewords 2004.02.18,977,1,11,149,9,-140,A
onewords 2004.02.18,977,1,11,134,18,-116,B
chelletijn 2004.02.18,958,1,10,19,60,41,A
chelletijn 2004.02.18,958,1,10,15,60,45,B
zukerro 2004.02.16,932,1,12,139,42,-97,A
zukerro 2004.02.16,932,1,12,148,33,-115,B
encairo 2004.02.26,1034,1,15,232,13,-219,A
encairo 2004.02.26,1034,1,15,254,13,-241,B
Folinsbee 2004.02.26,941,1,11,87,46,-41,A
Folinsbee 2004.02.26,941,1,11,86,46,-40,B
hotwheelb 2006.12.02,854,1,17,156,24,-132,A
hotwheelb 2006.12.02,854,1,17,152,29,-123,B
FEDt 2006.12.02,1054,1,15,66,33,-33,A
FEDt 2006.12.02,1054,1,15,56,33,-23,B
nuthegoob 2006.10.18,933,1,20,215,25,-190,A
nuthegoob 2006.10.18,933,1,18,210,22,-188,B
pbanx 2006.10.18,1023,1,24,232,33,-199,A
pbanx 2006.10.18,1023,1,23,251,35,-216,B
rossx 2006.09.05,974,1,21,236,19,-217,A
rossx 2006.09.05,974,1,19,225,21,-204,B
Nackler 2006.09.05,1010,1,20,212,20,-192,A
Nackler 2006.09.05,1010,1,19,203,10,-193,B
LaVigne 2005.12.14,931,1,12,263,25,-238,A
LaVigne 2005.12.14,931,1,11,163,27,-136,B
pollbellini 2005.12.14,952,1,11,142,18,-124,A
pollbellini 2005.12.14,952,1,11,85,18,-67,B
NRking 2006.12.08,1138,2,38,131,39,-92,A
NRking 2006.12.08,1138,2,38,127,37,-90,B
voetbalfan 2004.02.15,968,1,18,148,33,-115,A
voetbalfan 2004.02.15,968,1,18,136,28,-108,B
chelletijn 2004.02.15,998,1,18,149,44,-105,A
chelletijn 2004.02.15,998,1,18,150,44,-106,B
Truelan 2006.10.28,1004,2,56,187,27,-160,A
Truelan 2006.10.28,1004,2,55,194,33,-161,B
SamuelJunior 2006.10.28,960,2,54,140,33,-107,A
SamuelJunior 2006.10.28,960,2,54,147,31,-116,B
subwoofer 2006.11.25,1092,1,9,139,44,-95,A
subwoofer 2006.11.25,1092,1,9,118,33,-85,B
hotwheelb 2006.11.25,881,1,9,310,0,-310,A
hotwheelb 2006.11.25,881,1,9,290,0,-290,B
GlennaSarous 2003.11.22,956,1,20,222,30,-192,A
GlennaSarous 2003.11.22,956,1,20,222,30,-192,B
gough 2003.11.22,971,1,19,207,32,-175,A
gough 2003.11.22,971,1,19,202,32,-170,B
wwdotti 2005.12.04,970,1,11,52,27,-25,A
wwdotti 2005.12.04,970,1,11,75,18,-57,B
FarooqBaloch 2005.12.04,997,1,12,221,25,-196,A
FarooqBaloch 2005.12.04,997,1,12,250,17,-233,B
HEARTLESSWIZARD 2005.11.05,940,1,14,292,14,-278,A
HEARTLESSWIZARD 2005.11.05,940,1,14,264,14,-250,B
KJett 2005.11.05,1046,1,13,191,23,-168,A
KJett 2005.11.05,1046,1,13,175,23,-152,B
loccsta 2004.02.08,915,1,26,44,15,-29,A
loccsta 2004.02.08,915,1,23,44,13,-31,B
loccsta 2004.02.08,915,1,23,62,13,-49,C
PravinMamania 2004.02.08,982,1,26,18,42,24,A
PravinMamania 2004.02.08,982,1,23,17,39,22,B
PravinMamania 2004.02.08,982,1,22,18,41,23,C
feelm 2006.10.25,918,1,23,130,39,-91,A
feelm 2006.10.25,918,1,22,128,41,-87,B
hatrik 2006.10.25,1032,1,30,266,30,-236,A
hatrik 2006.10.25,1032,1,28,288,29,-259,B
feelm 2006.11.18,985,1,24,162,42,-120,A
feelm 2006.11.18,985,1,24,155,42,-113,B
VasTech 2006.11.18,946,1,24,253,25,-228,A
VasTech 2006.11.18,946,1,24,237,25,-212,B
BoardBoy 2004.01.04,1079,1,18,265,11,-254,A
BoardBoy 2004.01.04,1079,1,18,232,11,-221,B
DazedDj 2004.01.04,809,1,17,176,24,-152,A
DazedDj 2004.01.04,809,1,17,148,29,-119,B
tunacem 2006.11.12,920,1,13,101,46,-55,A
tunacem 2006.11.12,920,1,13,113,46,-67,B
DazedDj 2004.01.02,840,1,15,202,27,-175,A
DazedDj 2004.01.02,840,1,15,212,27,-185,B
BoardBoy 2004.01.02,1071,1,12,117,50,-67,A
BoardBoy 2004.01.02,1071,1,12,112,58,-54,B
AceDiamond 2003.12.16,990,1,21,93,29,-64,A
AceDiamond 2003.12.16,990,1,21,86,24,-62,B
churningpigskin 2003.12.16,740,1,21,103,52,-51,A
churningpigskin 2003.12.16,740,1,21,103,48,-55,B
Funditor 2006.10.04,907,1,40,92,40,-52,A
Funditor 2006.10.04,907,1,36,89,39,-50,B
tujhbq 2006.10.04,994,1,44,131,32,-99,A
tujhbq 2006.10.04,994,1,41,130,29,-101,B
Triplea 2003.05.01,990,1,13,187,46,-141,A
Triplea 2003.05.01,990,1,13,204,38,-166,B
DSSagent 2003.05.01,992,1,12,191,42,-149,A
DSSagent 2003.05.01,992,1,12,217,33,-184,B
uvrays 2006.10.31,831,1,19,52,32,-20,A
uvrays 2006.10.31,831,1,18,72,28,-44,B
nuthegoob 2006.10.31,936,1,20,105,25,-80,A
nuthegoob 2006.10.31,936,1,20,124,20,-104,B
ajwillington 2003.11.10,1054,1,24,188,38,-150,A
ajwillington 2003.11.10,1054,1,24,177,42,-135,B
WhiteSide 2003.11.10,923,1,26,264,42,-222,A
WhiteSide 2003.11.10,923,1,25,218,44,-174,B
nuthegoob 2006.10.17,933,2,29,238,10,-228,A
nuthegoob 2006.10.17,933,2,29,230,10,-220,B
DAarden 2006.10.17,975,1,20,256,25,-231,A
DAarden 2006.10.17,975,1,20,250,25,-225,B
eaglesloft 2003.03.29,1013,2,22,251,27,-224,A
eaglesloft 2003.03.29,1013,2,22,246,27,-219,B
mssronald 2003.03.29,874,2,28,284,21,-263,A
mssronald 2003.03.29,874,2,28,288,21,-267,B
marcuscole 2006.06.30,1003,2,52,110,40,-70,A
marcuscole 2006.06.30,1003,2,51,120,37,-83,B
Dkling 2006.06.30,952,2,51,122,39,-83,A
Dkling 2006.06.30,952,2,47,108,45,-63,B
BoardBoy 2003.12.12,1024,1,15,273,20,-253,A
BoardBoy 2003.12.12,1024,1,15,261,13,-248,B
DazedDj 2003.12.12,921,1,14,122,57,-65,A
DazedDj 2003.12.12,921,1,14,123,57,-66,B
uvrays 2006.10.17,878,1,8,368,0,-368,A
uvrays 2006.10.17,878,1,8,345,0,-345,B
Triplea 2003.04.20,1006,2,31,107,32,-75,A
Triplea 2003.04.20,1006,2,30,102,33,-69,B
KJett 2003.04.20,870,2,39,250,18,-232,A
KJett 2003.04.20,870,2,38,255,18,-237,B
SergB 2006.09.26,1153,1,38,118,47,-71,A
SergB 2006.09.26,1153,1,37,124,46,-78,B
uvrays 2006.09.26,806,1,35,95,43,-52,A
uvrays 2006.09.26,806,1,35,117,34,-83,B
DSSagent 2003.06.26,980,1,13,72,46,-26,A
DSSagent 2003.06.26,980,1,13,64,54,-10,B
churningpigskin 2003.06.26,797,1,13,169,15,-154,A
churningpigskin 2003.06.26,797,1,13,166,15,-151,B
HGBoone 2006.09.22,987,1,10,21,70,49,A
HGBoone 2006.09.22,987,1,9,45,44,-1,B
Funditor 2006.09.22,876,1,10,223,10,-213,A
Funditor 2006.09.22,876,1,11,209,18,-191,B
HEARTLESSWIZARD 2005.12.03,913,1,35,164,23,-141,A
HEARTLESSWIZARD 2005.12.03,913,1,35,179,26,-153,B
intelinside 2005.12.03,1027,1,36,198,42,-156,A
intelinside 2005.12.03,1027,1,35,200,40,-160,B
KJett 2003.09.22,894,1,37,218,32,-186,A
KJett 2003.09.22,894,1,35,201,34,-167,B
dumpyshubby 2003.09.22,984,1,41,272,29,-243,A
dumpyshubby 2003.09.22,984,1,38,252,21,-231,B
metallicguy 2006.09.13,1001,1,19,299,26,-273,A
metallicguy 2006.09.13,1001,1,19,262,21,-241,B
rossx 2006.09.13,998,1,21,296,33,-263,A
rossx 2006.09.13,998,1,21,282,24,-258,B
Mikimouse 2003.03.31,1017,1,13,276,23,-253,A
Mikimouse 2003.03.31,1017,1,12,279,25,-254,B
Giuditta 2003.03.31,980,1,9,86,33,-53,A
Giuditta 2003.03.31,980,1,7,78,43,-35,B
PawnStarrz 2003.04.04,1128,1,22,177,32,-145,A
PawnStarrz 2003.04.04,1128,1,22,187,32,-155,B
KJett 2003.04.04,869,1,26,276,23,-253,A
KJett 2003.04.04,869,1,22,298,14,-284,B
wwdotti 2005.11.28,1024,1,23,232,17,-215,A
wwdotti 2005.11.28,1024,1,22,200,18,-182,B
HEARTLESSWIZARD 2005.11.28,907,1,22,153,36,-117,A
HEARTLESSWIZARD 2005.11.28,907,1,21,135,33,-102,B
joelbow 2003.03.29,980,1,15,303,20,-283,A
joelbow 2003.03.29,980,1,15,294,20,-274,B
forkboy 2005.11.30,977,1,11,77,54,-23,A
forkboy 2005.11.30,977,1,10,49,60,11,B
HEARTLESSWIZARD 2005.11.30,924,1,11,162,36,-126,A
HEARTLESSWIZARD 2005.11.30,924,1,11,160,36,-124,B
Lexus 2003.05.10,1035,1,13,191,15,-176,A
Lexus 2003.05.10,1035,1,13,190,23,-167,B
KJett 2003.05.10,886,1,11,93,46,-47,A
KJett 2003.05.10,886,1,12,86,42,-44,B
Lexus 2003.05.03,1055,1,17,293,41,-252,A
Lexus 2003.05.03,1055,1,17,271,41,-230,B
KJett 2003.05.03,865,1,17,334,24,-310,A
KJett 2003.05.03,865,1,17,280,18,-262,B
ferking 2006.05.31,1111,3,52,219,29,-190,A
ferking 2006.05.31,1111,3,52,210,27,-183,B
Memnochblue 2006.05.31,841,3,52,215,35,-180,A
Memnochblue 2006.05.31,841,3,52,214,31,-183,B
Tarish 2006.09.13,705,1,12,169,50,-119,A
Tarish 2006.09.13,705,1,12,174,42,-132,B
jmgamber 2006.09.13,1226,1,11,147,18,-129,A
jmgamber 2006.09.13,1226,1,11,126,27,-99,B
nuthegoob 2006.10.16,963,1,20,394,20,-374,A
nuthegoob 2006.10.16,963,1,20,374,25,-349,B
Truelan 2006.10.16,932,1,18,310,22,-288,A
Truelan 2006.10.16,932,1,18,313,28,-285,B
dgreality 2003.04.11,923,1,13,206,38,-168,A
dgreality 2003.04.11,923,1,13,216,31,-185,B
ZEFER 2003.04.11,1071,1,16,272,31,-241,A
ZEFER 2003.04.11,1071,1,15,280,33,-247,B
KJett 2003.04.05,859,1,25,137,40,-97,A
KJett 2003.04.05,859,1,23,141,39,-102,B
dardanus 2003.04.05,1134,1,20,151,20,-131,A
dardanus 2003.04.05,1134,1,20,157,20,-137,B
redistribute 2006.10.03,1096,1,18,210,11,-199,A
redistribute 2006.10.03,1096,1,18,216,22,-194,B
Funditor 2006.10.03,892,1,17,113,29,-84,A
Funditor 2006.10.03,892,1,16,118,25,-93,B
Triplea 2003.04.12,1041,1,22,83,41,-42,A
Triplea 2003.04.12,1041,1,22,85,41,-44,B
Fitzakarle 2003.04.12,787,1,23,118,44,-74,A
Fitzakarle 2003.04.12,787,1,23,125,44,-81,B
Saldeeznuts 2006.09.28,937,1,15,170,27,-143,A
Saldeeznuts 2006.09.28,937,1,15,164,20,-144,B
Funditor 2006.09.28,1016,1,16,261,31,-230,A
Funditor 2006.09.28,1016,1,15,249,40,-209,B
nepvetm 2006.09.09,1053,1,24,238,29,-209,A
nepvetm 2006.09.09,1053,1,24,242,29,-213,B
shahar 2006.09.09,900,1,20,161,25,-136,A
shahar 2006.09.09,900,1,20,168,25,-143,B
pddchess 2005.12.14,957,1,18,202,28,-174,A
pddchess 2005.12.14,957,1,18,205,28,-177,B
azshtrdude 2005.12.14,881,1,16,156,31,-125,A
azshtrdude 2005.12.14,881,1,15,153,20,-133,B
reddawgdead 2006.07.26,936,1,33,208,27,-181,A
reddawgdead 2006.07.26,936,1,32,206,31,-175,B
TeddySauyet 2006.07.26,978,1,42,231,29,-202,A
TeddySauyet 2006.07.26,978,1,40,224,30,-194,B
hbengts 2006.06.09,973,1,22,109,32,-77,A
hbengts 2006.06.09,973,1,22,114,32,-82,B
supriyasodhi 2006.06.09,938,1,25,184,16,-168,A
supriyasodhi 2006.06.09,938,1,24,186,21,-165,B
Triplea 2003.02.01,871,1,21,306,29,-277,A
Triplea 2003.02.01,871,1,19,218,32,-186,B
brekneck 2003.02.01,1073,1,20,216,40,-176,A
brekneck 2003.02.01,1073,1,20,219,35,-184,B
SkarryLarry 2005.07.15,792,1,14,224,36,-188,A
SkarryLarry 2005.07.15,792,1,14,301,21,-280,B
Laddie 2005.07.15,1074,1,11,134,36,-98,A
Laddie 2005.07.15,1074,1,11,160,36,-124,B
iveyjr 2005.07.02,889,1,20,190,30,-160,A
iveyjr 2005.07.02,889,1,20,181,35,-146,B
MartyL 2005.07.02,958,2,37,211,27,-184,A
MartyL 2005.07.02,958,2,37,211,24,-187,B
jashevan 2005.12.09,1088,1,19,119,37,-82,A
jashevan 2005.12.09,1088,1,19,97,32,-65,B
clickoo 2005.12.09,820,1,20,218,35,-183,A
clickoo 2005.12.09,820,1,20,192,40,-152,B
bigrig 2005.12.04,1022,1,11,126,36,-90,A
bigrig 2005.12.04,1022,1,11,126,27,-99,B
clickoo 2005.12.04,862,1,11,170,46,-124,A
clickoo 2005.12.04,862,1,11,166,36,-130,B
Sunsfan 2006.07.26,1008,1,15,263,20,-243,A
Sunsfan 2006.07.26,1008,1,15,257,20,-237,B
VasTech 2006.07.26,985,1,11,373,9,-364,A
VasTech 2006.07.26,985,1,11,389,9,-380,B
eaglesloft 2003.02.15,1035,1,17,259,24,-235,A
eaglesloft 2003.02.15,1035,1,17,240,29,-211,B
mssronald 2003.02.15,849,1,19,384,16,-368,A
mssronald 2003.02.15,849,1,19,362,16,-346,B
dolphinsfan 2006.09.06,973,1,44,103,39,-64,A
dolphinsfan 2006.09.06,973,1,42,98,40,-58,B
Triplea 2003.03.22,863,1,13,108,46,-62,A
Triplea 2003.03.22,863,1,12,120,33,-87,B
Mikimouse 2003.03.22,1027,1,13,171,31,-140,A
Mikimouse 2003.03.22,1027,1,13,176,38,-138,B
darjos 2003.03.03,971,2,21,244,19,-225,A
darjos 2003.03.03,971,2,21,211,14,-197,B
brisham 2003.03.03,991,2,21,214,33,-181,A
brisham 2003.03.03,991,2,21,180,33,-147,B
LeFol 2006.06.11,1041,1,8,48,62,14,A
LeFol 2006.06.11,1041,1,8,33,62,29,B
twilc 2006.06.11,951,1,9,218,11,-207,A
twilc 2006.06.11,951,1,8,182,12,-170,B
achimdragos 2006.08.21,844,1,10,196,60,-136,A
achimdragos 2006.08.21,844,1,9,244,44,-200,B
hungerartist 2006.08.21,1090,1,11,301,27,-274,A
hungerartist 2006.08.21,1090,1,9,366,22,-344,B
milamores 2005.11.24,922,1,26,162,23,-139,A
milamores 2005.11.24,922,1,25,177,24,-153,B
uvrays 2005.11.24,908,1,24,189,17,-172,A
uvrays 2005.11.24,908,1,24,208,12,-196,B
astronomyguy 2005.11.30,1124,1,27,110,44,-66,A
astronomyguy 2005.11.30,1124,1,23,123,35,-88,B
Johnnyp 2005.11.30,828,1,29,226,31,-195,A
Johnnyp 2005.11.30,828,1,28,245,32,-213,B
dustbuni 2006.08.30,909,1,10,377,0,-377,A
dustbuni 2006.08.30,909,1,10,386,0,-386,B
cgorski 2006.08.30,988,1,7,61,71,10,A
cgorski 2006.08.30,988,1,7,60,71,11,B
americanista 2005.11.17,868,1,9,287,22,-265,A
americanista 2005.11.17,868,1,9,262,22,-240,B
mascota 2005.11.17,934,1,12,415,8,-407,A
mascota 2005.11.17,934,1,11,381,18,-363,B
rochon 2005.09.09,909,1,44,104,48,-56,A
rochon 2005.09.09,909,1,43,105,44,-61,B
unclebaal 2005.09.09,1081,1,45,155,31,-124,A
unclebaal 2005.09.09,1081,1,45,158,31,-127,B
LaFleurDeLys 2003.01.25,849,1,11,676,9,-667,A
LaFleurDeLys 2003.01.25,849,1,11,698,9,-689,B
Triplea 2003.01.25,822,3,41,201,29,-172,A
Triplea 2003.01.25,822,3,38,224,29,-195,B
abcc 2006.08.05,1083,1,42,102,36,-66,A
abcc 2006.08.05,1083,1,41,86,34,-52,B
Tizko 2006.08.05,887,1,42,73,43,-30,A
Tizko 2006.08.05,887,1,41,71,44,-27,B
pohlie 2005.11.24,1045,1,26,161,35,-126,A
pohlie 2005.11.24,1045,1,25,169,36,-133,B
HEARTLESSWIZARD 2005.11.24,928,1,27,239,33,-206,A
HEARTLESSWIZARD 2005.11.24,928,1,27,255,37,-218,B
TeddySauyet 2006.06.28,1010,1,13,290,38,-252,A
TeddySauyet 2006.06.28,1010,1,11,340,27,-313,B
SamuelJunior 2006.06.28,978,1,8,142,62,-80,A
SamuelJunior 2006.06.28,978,1,8,185,50,-135,B
Garzon 2006.07.26,1080,1,17,281,18,-263,A
Garzon 2006.07.26,1080,1,16,268,31,-237,B
augustuscaesar 2006.07.26,850,1,15,354,27,-327,A
augustuscaesar 2006.07.26,850,1,14,329,29,-300,B
LazyFIDERook 2006.08.22,922,1,34,198,35,-163,A
LazyFIDERook 2006.08.22,922,1,33,211,36,-175,B
netbrain 2006.08.22,1043,1,29,147,31,-116,A
netbrain 2006.08.22,1043,1,26,116,19,-97,B
aadeeb 2005.10.23,796,1,24,294,12,-282,A
aadeeb 2005.10.23,796,1,24,264,17,-247,B
Unknowner 2005.10.23,1071,1,21,195,29,-166,A
Unknowner 2005.10.23,1071,1,21,176,29,-147,B
HEARTLESSWIZARD 2005.11.27,918,1,11,238,18,-220,A
HEARTLESSWIZARD 2005.11.27,918,1,11,198,27,-171,B
DaveFromWazza 2005.11.27,1000,1,15,233,40,-193,A
DaveFromWazza 2005.11.27,1000,1,15,208,40,-168,B
cuzzer 2005.11.09,1067,1,37,291,22,-269,A
cuzzer 2005.11.09,1067,1,37,295,24,-271,B
kilkennycat 2005.11.09,904,1,36,270,22,-248,A
kilkennycat 2005.11.09,904,1,36,259,25,-234,B
BothFeet 2005.11.07,926,1,32,232,28,-204,A
BothFeet 2005.11.07,926,1,32,237,31,-206,B
BishopDaMan 2005.11.07,866,1,31,263,23,-240,A
BishopDaMan 2005.11.07,866,1,31,262,26,-236,B
dgreality 2003.03.22,1132,1,25,351,12,-339,A
dgreality 2003.03.22,1132,1,25,288,16,-272,B
KJett 2003.03.22,842,1,20,285,20,-265,A
KJett 2003.03.22,842,1,20,237,25,-212,B
KJett 2003.02.21,874,1,27,249,22,-227,A
KJett 2003.02.21,874,1,27,272,18,-254,B
gswiff 2003.02.21,1088,1,26,181,35,-146,A
gswiff 2003.02.21,1088,1,25,197,32,-165,B
coloradorover 2003.02.05,1141,1,13,194,15,-179,A
coloradorover 2003.02.05,1141,1,13,188,8,-180,B
Dusti 2003.02.05,837,1,14,303,21,-282,A
Dusti 2003.02.05,837,1,13,237,31,-206,B
AFMD 2006.07.19,1153,1,11,228,27,-201,A
AFMD 2006.07.19,1153,1,11,237,18,-219,B
twilc 2006.07.19,806,1,11,250,46,-204,A
twilc 2006.07.19,806,1,11,259,36,-223,B
Dkling 2006.06.29,987,2,42,186,24,-162,A
Dkling 2006.06.29,987,2,42,187,29,-158,B
marcuscole 2006.06.29,994,2,40,179,35,-144,A
marcuscole 2006.06.29,994,2,39,169,33,-136,B
jornf 2002.12.26,1039,1,7,48,57,9,A
jornf 2002.12.26,1039,1,8,48,50,2,B
coloradorover 2002.12.26,968,7,118,190,30,-160,A
coloradorover 2002.12.26,968,7,115,180,34,-146,B
philippeopr 2005.08.14,1135,1,21,68,33,-35,A
philippeopr 2005.08.14,1135,1,20,62,40,-22,B
SkarryLarry 2005.08.14,769,1,21,152,33,-119,A
SkarryLarry 2005.08.14,769,1,21,150,33,-117,B
Triplea 2003.03.16,826,1,10,216,20,-196,A
Triplea 2003.03.16,826,1,10,211,20,-191,B
Neeter 2003.03.16,890,1,12,366,25,-341,A
Neeter 2003.03.16,890,1,12,387,33,-354,B
bigrig 2005.10.10,1001,1,17,225,35,-190,A
bigrig 2005.10.10,1001,1,17,248,35,-213,B
smugknave 2005.10.10,989,1,17,343,24,-319,A
smugknave 2005.10.10,989,1,17,322,29,-293,B
coloradorover 2003.01.22,1032,2,35,173,20,-153,A
coloradorover 2003.01.22,1032,2,34,163,24,-139,B
mrudy 2003.01.22,964,1,18,209,28,-181,A
mrudy 2003.01.22,964,1,18,209,33,-176,B
puzzledmindLady 2005.08.07,1022,1,8,134,25,-109,A
puzzledmindLady 2005.08.07,1022,1,8,120,38,-82,B
bonillaice 2005.08.07,830,1,9,269,33,-236,A
bonillaice 2005.08.07,830,1,9,261,33,-228,B
xxYxxY 2006.05.09,980,1,10,59,40,-19,A
xxYxxY 2006.05.09,980,1,10,62,40,-22,B
DEDEE 2006.05.09,936,1,10,184,10,-174,A
DEDEE 2006.05.09,936,1,10,186,20,-166,B
apospap 2006.06.26,972,1,24,270,17,-253,A
apospap 2006.06.26,972,1,24,283,33,-250,B
TeddySauyet 2006.06.26,999,2,42,204,24,-180,A
TeddySauyet 2006.06.26,999,2,42,222,26,-196,B
Agee 2003.03.06,1020,1,45,198,27,-171,A
Agee 2003.03.06,1020,1,43,169,28,-141,B
KJett 2003.03.06,856,1,48,265,29,-236,A
KJett 2003.03.06,856,1,48,274,27,-247,B
eaglesloft 2003.03.04,1004,1,8,160,12,-148,A
eaglesloft 2003.03.04,1004,1,8,145,12,-133,B
flinn 2003.03.04,962,1,11,360,18,-342,A
flinn 2003.03.04,962,1,11,381,18,-363,B
trovillion 2005.09.07,1039,1,11,381,18,-363,A
trovillion 2005.09.07,1039,1,11,398,18,-380,B
rtgreen 2005.09.07,925,1,8,240,50,-190,A
rtgreen 2005.09.07,925,1,8,238,50,-188,B
TeddySauyet 2006.06.27,1027,1,30,385,37,-348,A
TeddySauyet 2006.06.27,1027,1,31,371,36,-335,B
SamuelJunior 2006.06.27,916,1,28,176,39,-137,A
SamuelJunior 2006.06.27,916,1,27,172,41,-131,B
supriyasodhi 2006.06.20,854,1,10,266,10,-256,A
supriyasodhi 2006.06.20,854,1,10,277,10,-267,B
ferking 2006.06.20,1118,1,9,160,44,-116,A
ferking 2006.06.20,1118,1,9,156,44,-112,B
nicolaus 2006.06.23,1084,1,21,142,29,-113,A
nicolaus 2006.06.23,1084,1,21,133,19,-114,B
Panzulo 2006.06.23,844,1,21,159,38,-121,A
Panzulo 2006.06.23,844,1,21,162,38,-124,B
Memnochblue 2006.05.26,850,2,50,188,28,-160,A
Memnochblue 2006.05.26,850,2,48,190,23,-167,B
jmlichtman 2006.05.26,961,1,10,261,20,-241,A
jmlichtman 2006.05.26,961,1,10,251,20,-231,B
FraserChapman 2005.08.28,961,1,12,232,8,-224,A
FraserChapman 2005.08.28,961,1,12,244,8,-236,B
Silicate 2005.08.28,884,1,15,190,20,-170,A
Silicate 2005.08.28,884,1,14,170,36,-134,B
LaFleurDeLys 2003.01.07,901,1,10,230,10,-220,A
LaFleurDeLys 2003.01.07,901,1,9,166,11,-155,B
coloradorover 2003.01.07,1046,2,18,153,39,-114,A
coloradorover 2003.01.07,1046,2,19,160,37,-123,B
Silicate 2005.08.29,899,1,23,140,35,-105,A
Silicate 2005.08.29,899,1,22,126,41,-85,B
DHunt 2005.08.29,1091,1,26,236,19,-217,A
DHunt 2005.08.29,1091,1,26,237,23,-214,B
SamuelJunior 2006.06.26,904,1,24,295,29,-266,A
SamuelJunior 2006.06.26,904,1,24,341,25,-316,B
KJett 2003.02.20,887,1,19,282,21,-261,A
KJett 2003.02.20,887,1,18,238,28,-210,B
claudiolozea 2003.02.20,1088,1,17,167,29,-138,A
claudiolozea 2003.02.20,1088,1,17,159,29,-130,B
KnightToRookSix 2003.02.02,1127,1,30,71,37,-34,A
KnightToRookSix 2003.02.02,1127,1,30,72,37,-35,B
WardBurtonfan 2003.02.02,821,1,32,127,31,-96,A
WardBurtonfan 2003.02.02,821,1,32,123,31,-92,B
WardBurtonfan 2003.01.24,892,1,8,166,38,-128,A
WardBurtonfan 2003.01.24,892,1,8,158,50,-108,B
CelticMoon 2003.01.24,1097,1,10,401,0,-401,A
CelticMoon 2003.01.24,1097,1,9,340,0,-340,B
crazycousins 2006.06.19,1156,1,12,266,33,-233,A
crazycousins 2006.06.19,1156,1,12,277,33,-244,B
twilc 2006.06.19,832,1,9,146,44,-102,A
twilc 2006.06.19,832,1,9,156,44,-112,B
WarlordNatick 2005.10.16,1117,1,18,136,61,-75,A
WarlordNatick 2005.10.16,1117,1,18,140,56,-84,B
rbb 2005.10.16,820,1,16,174,25,-149,A
rbb 2005.10.16,820,1,16,179,25,-154,B
KJett 2003.01.25,1003,1,36,250,25,-225,A
KJett 2003.01.25,1003,1,28,248,32,-216,B
Laddie 2002.12.26,1044,2,25,87,40,-47,A
Laddie 2002.12.26,1044,2,23,102,35,-67,B
skuller 2002.07.20,1073,1,12,246,17,-229,A
skuller 2002.07.20,1073,1,12,250,25,-225,B
aikloong 2002.07.20,698,1,13,303,31,-272,A
aikloong 2002.07.20,698,1,13,332,31,-301,B
pocheptsoff 2005.04.10,1046,1,18,140,33,-107,A
pocheptsoff 2005.04.10,1046,1,18,138,33,-105,B
talkymeat 2005.04.10,909,1,16,153,56,-97,A
talkymeat 2005.04.10,909,1,16,158,62,-96,B
lsilipo 2005.04.07,887,1,17,241,47,-194,A
lsilipo 2005.04.07,887,1,17,267,35,-232,B
Kyobutungi 2005.04.07,1067,1,15,141,33,-108,A
Kyobutungi 2005.04.07,1067,1,15,162,33,-129,B
mssronald 2003.02.13,944,1,18,251,22,-229,A
mssronald 2003.02.13,944,1,16,236,25,-211,B
eaglesloft 2003.02.13,1027,1,14,120,7,-113,A
eaglesloft 2003.02.13,1027,1,13,130,15,-115,B
Theodin 2005.10.20,998,1,24,198,42,-156,A
Theodin 2005.10.20,998,1,24,187,46,-141,B
rbb 2005.10.20,756,1,28,293,29,-264,A
rbb 2005.10.20,756,1,27,353,30,-323,B
agathea 2006.05.31,988,1,16,158,25,-133,A
agathea 2006.05.31,988,1,15,184,27,-157,B
powendel 2006.05.31,1002,1,16,254,12,-242,A
powendel 2006.05.31,1002,1,14,246,14,-232,B
BishopDaMan 2005.10.08,985,1,16,219,19,-200,A
BishopDaMan 2005.10.08,985,1,15,219,33,-186,B
znode 2005.10.08,1000,1,13,180,38,-142,A
znode 2005.10.08,1000,1,13,195,38,-157,B
shipwrecked 2005.07.04,1057,2,49,96,37,-59,A
shipwrecked 2005.07.04,1057,2,48,111,37,-74,B
HEARTLESSWIZARD 2005.07.04,897,2,52,157,40,-117,A
HEARTLESSWIZARD 2005.07.04,897,2,52,178,38,-140,B
TLorD 2005.06.13,1002,2,33,185,36,-149,A
TLorD 2005.06.13,1002,2,33,194,30,-164,B
Shadax 2005.06.13,969,2,30,142,37,-105,A
Shadax 2005.06.13,969,2,30,138,43,-95,B
Paestka 2005.05.17,946,1,25,130,20,-110,A
Paestka 2005.05.17,946,1,25,125,20,-105,B
TEMH 2005.05.17,1041,1,23,61,48,-13,A
TEMH 2005.05.17,1041,1,21,69,43,-26,B
IvoSt 2006.06.09,905,1,9,18,89,71,A
IvoSt 2006.06.09,905,1,9,24,89,65,B
hungerartist 2006.06.09,1013,1,9,218,33,-185,A
hungerartist 2006.06.09,1013,1,9,201,33,-168,B
ModestNihilist 2005.09.28,948,1,13,159,23,-136,A
ModestNihilist 2005.09.28,948,1,13,181,23,-158,B
loserman 2005.09.28,901,1,13,246,38,-208,A
loserman 2005.09.28,901,1,13,263,31,-232,B
trovillion 2005.09.05,979,1,25,324,32,-292,A
trovillion 2005.09.05,979,1,25,302,32,-270,B
jcizotti 2005.09.05,944,1,22,390,27,-363,A
jcizotti 2005.09.05,944,1,24,370,25,-345,B
jonohelms 2005.09.26,1130,1,19,177,21,-156,A
jonohelms 2005.09.26,1130,1,19,168,16,-152,B
rtgreen 2005.09.26,861,1,19,192,21,-171,A
rtgreen 2005.09.26,861,1,19,171,21,-150,B
GolfBob 2006.05.23,892,1,35,112,43,-69,A
GolfBob 2006.05.23,892,1,35,125,37,-88,B
ferking 2006.05.23,1089,1,41,263,24,-239,A
ferking 2006.05.23,1089,1,41,273,24,-249,B
BothFeet 2005.08.26,946,1,31,286,32,-254,A
BothFeet 2005.08.26,946,1,31,287,29,-258,B
HEARTLESSWIZARD 2005.08.26,979,1,25,157,28,-129,A
HEARTLESSWIZARD 2005.08.26,979,1,24,175,21,-154,B
KirkB 2003.01.25,1174,1,12,198,42,-156,A
KirkB 2003.01.25,1174,1,11,224,36,-188,B
rochon 2005.09.18,1069,1,12,214,33,-181,A
rochon 2005.09.18,1069,1,12,199,42,-157,B
jcizotti 2005.09.18,900,1,10,281,10,-271,A
jcizotti 2005.09.18,900,1,10,259,10,-249,B
wreckncrew 2005.06.28,896,1,13,99,31,-68,A
wreckncrew 2005.06.28,896,1,13,92,31,-61,B
Rohein 2005.06.28,1063,1,13,195,8,-187,A
Rohein 2005.06.28,1063,1,13,201,8,-193,B
iansss 2006.04.27,895,1,13,200,38,-162,A
iansss 2006.04.27,895,1,13,218,46,-172,B
Breneric 2006.04.27,1028,1,12,223,8,-215,A
Breneric 2006.04.27,1028,1,12,229,17,-212,B
bigrig 2005.09.04,985,1,43,207,28,-179,A
bigrig 2005.09.04,985,1,43,205,30,-175,B
Silicate 2005.09.04,964,1,40,132,42,-90,A
Silicate 2005.09.04,964,1,40,131,45,-86,B
LaFleurDeLys 2003.01.22,885,1,20,231,20,-211,A
LaFleurDeLys 2003.01.22,885,1,20,245,15,-230,B
KaleidoscopeEyes 2002.12.30,1019,1,11,244,36,-208,A
KaleidoscopeEyes 2002.12.30,1019,1,11,221,36,-185,B
coloradorover 2002.12.30,885,1,10,120,20,-100,A
coloradorover 2002.12.30,885,1,10,95,30,-65,B
Silicate 2005.08.27,891,1,17,144,35,-109,A
Silicate 2005.08.27,891,1,17,144,35,-109,B
jrico 2005.08.27,1086,1,16,96,19,-77,A
jrico 2005.08.27,1086,1,16,105,19,-86,B
passports 2005.09.19,1107,1,13,272,8,-264,A
passports 2005.09.19,1107,1,13,255,15,-240,B
aadeeb 2005.09.19,844,1,11,258,18,-240,A
aadeeb 2005.09.19,844,1,11,240,18,-222,B
danielp 2006.05.27,1087,1,20,104,60,-44,A
danielp 2006.05.27,1087,1,20,113,50,-63,B
danielp 2006.05.27,1087,1,20,115,45,-70,C
sixer 2006.05.27,829,1,21,198,24,-174,A
sixer 2006.05.27,829,1,21,202,29,-173,B
sixer 2006.05.27,829,1,21,212,29,-183,C
HEARTLESSWIZARD 2005.09.14,942,1,17,72,53,-19,A
HEARTLESSWIZARD 2005.09.14,942,1,17,53,53,0,B
GolfBob 2005.09.14,1016,1,17,153,24,-129,A
GolfBob 2005.09.14,1016,1,17,152,18,-134,B
hfarnsworth 2005.10.05,1047,1,12,353,8,-345,A
hfarnsworth 2005.10.05,1047,1,10,268,20,-248,B
PacManVideoGame 2005.10.05,941,1,8,232,50,-182,A
PacManVideoGame 2005.10.05,941,1,9,213,22,-191,B
Silicate 2005.09.02,932,1,18,190,56,-134,A
Silicate 2005.09.02,932,1,17,200,59,-141,B
SChlebowski 2005.09.02,1061,1,23,243,30,-213,A
SChlebowski 2005.09.02,1061,1,22,258,32,-226,B
TomJr 2005.10.15,873,1,21,216,24,-192,A
TomJr 2005.10.15,873,1,21,215,24,-191,B
Unknowner 2005.10.15,1088,1,20,169,35,-134,A
Unknowner 2005.10.15,1088,1,20,165,35,-130,B
newbeeforu 2005.07.01,1013,1,24,292,25,-267,A
newbeeforu 2005.07.01,1013,1,23,297,39,-258,B
MartyL 2005.07.01,915,1,19,209,37,-172,A
MartyL 2005.07.01,915,1,17,160,47,-113,B
pinkdragon 2006.04.27,906,1,17,512,6,-506,A
pinkdragon 2006.04.27,906,1,17,534,0,-534,B
Ccannibal 2006.04.27,1051,1,13,257,31,-226,A
Ccannibal 2006.04.27,1051,1,11,178,36,-142,B
MischiMaestro 2005.04.20,1045,5,68,155,40,-115,A
MischiMaestro 2005.04.20,1045,5,69,158,35,-123,B
fboccardo 2005.04.20,935,8,103,193,32,-161,A
fboccardo 2005.04.20,935,8,104,184,32,-152,B
coloradorover 2003.01.08,1023,1,10,232,0,-232,A
coloradorover 2003.01.08,1023,1,9,194,0,-194,B
LaFleurDeLys 2003.01.08,876,1,12,424,8,-416,A
LaFleurDeLys 2003.01.08,876,1,12,435,0,-435,B
ferking 2006.05.26,1074,1,39,213,33,-180,A
ferking 2006.05.26,1074,1,36,216,31,-185,B
franciscotlima 2005.08.13,993,1,16,142,31,-111,A
franciscotlima 2005.08.13,993,1,16,137,38,-99,B
HGBoone 2005.08.13,873,1,15,82,47,-35,A
HGBoone 2005.08.13,873,1,15,79,40,-39,B
BlindRoundTower 2002.12.26,1037,1,20,71,30,-41,A
BlindRoundTower 2002.12.26,1037,1,20,92,30,-62,B
HEARTLESSWIZARD 2005.07.24,949,1,16,277,0,-277,A
HEARTLESSWIZARD 2005.07.24,949,1,16,267,0,-267,B
cjott 2005.07.24,975,1,16,267,38,-229,A
cjott 2005.07.24,975,1,16,241,44,-197,B
bttfman 2002.11.07,995,2,22,154,18,-136,A
bttfman 2002.11.07,995,2,22,151,18,-133,B
AceEvl 2002.11.07,950,2,24,158,33,-125,A
AceEvl 2002.11.07,950,2,24,149,25,-124,B
Faeriedragon 2003.01.10,822,1,19,172,32,-140,A
Faeriedragon 2003.01.10,822,1,19,171,32,-139,B
RDearman 2003.01.10,1082,1,19,194,47,-147,A
RDearman 2003.01.10,1082,1,19,201,47,-154,B
jbpuffer 2005.07.30,848,5,95,290,18,-272,A
jbpuffer 2005.07.30,848,5,94,284,18,-266,B
noogit 2005.07.30,1007,3,60,169,25,-144,A
noogit 2005.07.30,1007,3,58,164,22,-142,B
HEARTLESSWIZARD 2005.07.30,951,2,28,139,43,-96,A
HEARTLESSWIZARD 2005.07.30,951,2,28,136,36,-100,B
Ziggles 2005.07.30,999,1,18,142,28,-114,A
Ziggles 2005.07.30,999,1,18,121,33,-88,B
BothFeet 2005.07.13,973,2,23,136,43,-93,A
BothFeet 2005.07.13,973,2,23,120,43,-77,B
SkarryLarry 2005.07.13,841,2,27,296,15,-281,A
SkarryLarry 2005.07.13,841,2,27,282,19,-263,B
mrudy 2003.01.07,894,1,11,132,36,-96,A
mrudy 2003.01.07,894,1,11,129,27,-102,B
jujupieces 2005.09.02,976,1,24,318,29,-289,A
jujupieces 2005.09.02,976,1,24,342,21,-321,B
dafke 2005.09.02,997,1,20,230,15,-215,A
dafke 2005.09.02,997,1,20,234,15,-219,B
yihan 2002.12.26,948,2,40,106,32,-74,A
yihan 2002.12.26,948,2,39,100,33,-67,B
NathanBlair 2005.07.12,1080,3,67,227,39,-188,A
NathanBlair 2005.07.12,1080,3,66,212,36,-176,B
HEARTLESSWIZARD 2005.07.12,861,2,43,162,28,-134,A
HEARTLESSWIZARD 2005.07.12,861,2,41,163,24,-139,B
Ziggles 2005.07.27,830,1,18,203,22,-181,A
Ziggles 2005.07.27,830,1,18,197,22,-175,B
BothFeet 2005.07.27,964,1,18,283,28,-255,A
BothFeet 2005.07.27,964,1,18,250,33,-217,B
ooohtodd 2005.07.26,951,1,14,409,29,-380,A
ooohtodd 2005.07.26,951,1,13,411,23,-388,B
tmth 2005.07.26,1043,1,11,196,54,-142,A
tmth 2005.07.26,1043,1,11,211,54,-157,B
SaltzLynnMa 2006.05.03,1107,1,50,135,44,-91,A
SaltzLynnMa 2006.05.03,1107,1,49,133,43,-90,B
marcuscole 2006.05.03,884,1,46,128,33,-95,A
marcuscole 2006.05.03,884,1,45,115,36,-79,B
NathanBlair 2005.08.06,929,1,23,134,30,-104,A
NathanBlair 2005.08.06,929,1,23,128,35,-93,B
TravisBarker 2005.08.06,1063,1,24,94,50,-44,A
TravisBarker 2005.08.06,1063,1,24,100,46,-54,B
bigrig 2005.08.06,866,1,28,250,21,-229,A
bigrig 2005.08.06,866,1,28,248,21,-227,B
mascota 2005.08.06,984,1,27,205,33,-172,A
mascota 2005.08.06,984,1,27,194,33,-161,B
pohlie 2006.05.10,986,1,13,180,23,-157,A
pohlie 2006.05.10,986,1,13,173,15,-158,B
punkat 2006.05.10,1013,1,11,84,36,-48,A
punkat 2006.05.10,1013,1,11,81,36,-45,B
iansss 2006.05.05,923,1,8,231,25,-206,A
iansss 2006.05.05,923,1,8,165,25,-140,B
marcuscole 2006.05.05,881,1,8,246,50,-196,A
marcuscole 2006.05.05,881,1,8,226,50,-176,B
HEARTLESSWIZARD 2005.08.17,975,1,22,159,23,-136,A
HEARTLESSWIZARD 2005.08.17,975,1,22,172,23,-149,B
pezzissimo 2005.08.17,879,1,23,173,44,-129,A
pezzissimo 2005.08.17,879,1,23,171,44,-127,B
iveyjr 2005.04.06,854,1,13,206,15,-191,A
iveyjr 2005.04.06,854,1,12,234,8,-226,B
Homki 2005.04.06,1065,1,10,85,10,-75,A
Homki 2005.04.06,1065,1,10,93,20,-73,B
ooohtodd 2005.07.12,1004,1,21,286,38,-248,A
ooohtodd 2005.07.12,1004,1,20,274,30,-244,B
LOZO 2005.08.14,987,1,48,122,38,-84,A
LOZO 2005.08.14,987,1,48,128,40,-88,B
jessmoll 2005.08.14,1009,1,52,119,44,-75,A
jessmoll 2005.08.14,1009,1,49,124,43,-81,B
pacetaker 2002.12.26,1125,1,9,124,44,-80,A
pacetaker 2002.12.26,1125,1,9,109,56,-53,B
Tibmag 2005.07.11,1029,1,20,67,35,-32,A
Tibmag 2005.07.11,1029,1,19,56,37,-19,B
MTSimkus 2005.07.11,969,1,20,112,25,-87,A
MTSimkus 2005.07.11,969,1,20,93,35,-58,B
Halfman 2006.04.24,1082,1,12,78,25,-53,A
Halfman 2006.04.24,1082,1,12,82,25,-57,B
wolfla 2006.04.24,874,1,12,161,17,-144,A
wolfla 2006.04.24,874,1,12,166,17,-149,B
fboccardo 2005.04.19,928,1,24,111,42,-69,A
fboccardo 2005.04.19,928,1,24,97,38,-59,B
giannhsk 2005.04.19,805,1,25,178,40,-138,A
giannhsk 2005.04.19,805,1,24,175,33,-142,B
garethcash 2005.04.20,1033,3,35,172,34,-138,A
garethcash 2005.04.20,1033,3,36,199,33,-166,B
HEARTLESSWIZARD 2005.07.22,879,1,13,109,23,-86,A
HEARTLESSWIZARD 2005.07.22,879,1,14,171,21,-150,B
iveyjr 2005.07.22,901,1,14,204,36,-168,A
iveyjr 2005.07.22,901,1,14,216,29,-187,B
MartyL 2005.06.21,932,2,31,264,23,-241,A
MartyL 2005.06.21,932,2,30,262,20,-242,B
artir 2005.06.21,1068,1,14,64,50,-14,A
artir 2005.06.21,1068,1,14,55,50,-5,B
TLorD 2005.06.08,961,1,26,87,50,-37,A
TLorD 2005.06.08,961,1,24,60,46,-14,B
HEARTLESSWIZARD 2005.06.08,909,1,28,121,25,-96,A
HEARTLESSWIZARD 2005.06.08,909,1,28,122,25,-97,B
doomie 2006.04.19,873,1,17,110,53,-57,A
doomie 2006.04.19,873,1,17,111,47,-64,B
ferking 2006.04.19,1078,1,16,135,31,-104,A
ferking 2006.04.19,1078,1,16,127,31,-96,B
iveyjr 2005.04.07,864,1,13,315,15,-300,A
iveyjr 2005.04.07,864,1,13,294,15,-279,B
DKG 2005.04.07,1077,1,12,202,42,-160,A
DKG 2005.04.07,1077,1,12,179,42,-137,B
BothFeet 2005.07.11,972,1,9,150,22,-128,A
BothFeet 2005.07.11,972,1,9,133,33,-100,B
bonillaice 2005.07.11,949,1,9,250,22,-228,A
bonillaice 2005.07.11,949,1,9,235,22,-213,B
Freakyflow 2005.07.30,1161,1,7,72,14,-58,A
Freakyflow 2005.07.30,1161,1,7,80,14,-66,B
zebrafish 2006.04.29,876,1,18,120,17,-103,A
zebrafish 2006.04.29,876,1,18,110,28,-82,B
aBlade 2006.04.29,1079,1,19,205,37,-168,A
aBlade 2006.04.29,1079,1,19,205,37,-168,B
pezzissimo 2005.06.13,910,1,19,225,21,-204,A
pezzissimo 2005.06.13,910,1,19,249,16,-233,B
johnoleary 2005.06.13,1044,1,18,146,50,-96,A
johnoleary 2005.06.13,1044,1,18,167,44,-123,B
iansss 2006.05.06,926,1,16,151,31,-120,A
iansss 2006.05.06,926,1,16,166,25,-141,B
morts 2006.05.06,1070,1,20,322,45,-277,A
morts 2006.05.06,1070,1,19,350,32,-318,B
Reeco 2005.07.23,1150,1,19,320,26,-294,A
Reeco 2005.07.23,1150,1,19,343,16,-327,B
bonillaice 2005.07.23,847,1,19,363,10,-353,A
bonillaice 2005.07.23,847,1,19,363,16,-347,B
doubleo 2005.06.29,962,1,28,193,25,-168,A
doubleo 2005.06.29,962,1,28,179,25,-154,B
BothFeet 2005.06.29,958,1,24,158,33,-125,A
BothFeet 2005.06.29,958,1,24,136,21,-115,B
AceEvl 2002.11.13,923,1,27,259,22,-237,A
AceEvl 2002.11.13,923,1,27,241,22,-219,B
bttfman 2002.11.13,1065,1,25,217,16,-201,A
bttfman 2002.11.13,1065,1,25,215,16,-199,B
undersoft 2005.06.23,928,1,11,255,36,-219,A
undersoft 2005.06.23,928,1,11,269,27,-242,B
MartyL 2005.06.23,956,1,16,399,6,-393,A
MartyL 2005.06.23,956,1,14,378,7,-371,B
ooohtodd 2005.07.15,968,1,16,224,19,-205,A
ooohtodd 2005.07.15,968,1,16,223,19,-204,B
mascota 2005.07.15,965,1,14,141,50,-91,A
mascota 2005.07.15,965,1,14,142,50,-92,B
ooohtodd 2005.07.18,946,1,14,201,29,-172,A
ooohtodd 2005.07.18,946,1,14,190,29,-161,B
BothFeet 2005.07.18,967,1,16,302,19,-283,A
BothFeet 2005.07.18,967,1,15,256,20,-236,B
caleas 2002.09.20,1021,1,19,106,37,-69,A
caleas 2002.09.20,1021,1,19,114,42,-72,B
younder 2002.09.20,920,1,18,114,33,-81,A
younder 2002.09.20,920,1,18,124,28,-96,B
wolfla 2006.04.25,846,2,30,261,20,-241,A
wolfla 2006.04.25,846,2,28,285,14,-271,B
nicolaus 2006.04.25,984,2,28,252,32,-220,A
nicolaus 2006.04.25,984,2,27,252,33,-219,B
iveyjr 2005.03.23,886,6,149,251,26,-225,A
iveyjr 2005.03.23,886,6,146,246,26,-220,B
FJB 2005.03.23,1011,10,246,165,31,-134,A
FJB 2005.03.23,1011,10,246,167,28,-139,B
FJB 2005.03.15,860,1,12,223,17,-206,A
FJB 2005.03.15,860,1,12,220,8,-212,B
dockson 2005.03.15,951,1,13,241,31,-210,A
dockson 2005.03.15,951,1,13,240,23,-217,B
Joinedup 2005.02.22,890,1,20,208,45,-163,A
Joinedup 2005.02.22,890,1,20,212,35,-177,B
ultradude 2005.02.22,885,1,21,237,19,-218,A
ultradude 2005.02.22,885,1,20,188,25,-163,B
HEARTLESSWIZARD 2005.07.02,931,1,18,231,11,-220,A
HEARTLESSWIZARD 2005.07.02,931,1,18,227,17,-210,B
ClaesF 2006.04.08,1036,1,19,293,5,-288,A
ClaesF 2006.04.08,1036,1,19,295,5,-290,B
Yesu 2006.04.08,901,1,18,191,28,-163,A
Yesu 2006.04.08,901,1,17,168,29,-139,B
nicknator 2006.05.04,1050,1,9,155,22,-133,A
nicknator 2006.05.04,1050,1,9,196,22,-174,B
Nemobxl 2006.05.04,901,1,9,266,22,-244,A
Nemobxl 2006.05.04,901,1,9,279,22,-257,B
MartyL 2005.06.26,897,1,9,128,44,-84,A
MartyL 2005.06.26,897,1,9,137,44,-93,B
Scottrick 2005.06.26,1004,1,10,320,30,-290,A
Scottrick 2005.06.26,1004,1,10,340,30,-310,B
pohlie 2005.06.30,1021,1,33,153,33,-120,A
pohlie 2005.06.30,1021,1,32,151,34,-117,B
shipwrecked 2005.06.30,954,1,30,132,43,-89,A
shipwrecked 2005.06.30,954,1,29,140,45,-95,B
matingrituals 2006.05.03,964,1,17,192,29,-163,A
matingrituals 2006.05.03,964,1,16,169,25,-144,B
Cybersun 2006.05.03,1031,1,14,94,43,-51,A
Cybersun 2006.05.03,1031,1,15,64,40,-24,B
amajouity 2002.08.02,930,1,30,273,33,-240,A
amajouity 2002.08.02,930,1,30,282,33,-249,B
Trasimene 2002.08.02,1043,1,28,243,29,-214,A
Trasimene 2002.08.02,1043,1,28,260,29,-231,B
schachmatze 2006.04.21,920,1,13,191,38,-153,A
schachmatze 2006.04.21,920,1,14,174,36,-138,B
Nemobxl 2006.04.21,930,1,21,367,19,-348,A
Nemobxl 2006.04.21,930,1,21,376,19,-357,B
lsilipo 2005.04.22,818,1,24,152,38,-114,A
lsilipo 2005.04.22,818,1,24,139,42,-97,B
pawnpeddler 2005.04.22,1068,1,23,183,30,-153,A
pawnpeddler 2005.04.22,1068,1,22,161,41,-120,B
pezzissimo 2005.06.14,862,1,87,107,30,-77,A
pezzissimo 2005.06.14,862,1,81,95,32,-63,B
Kyobutungi 2005.06.14,1130,1,89,148,26,-122,A
Kyobutungi 2005.06.14,1130,1,88,170,26,-144,B
knightscastle 2002.10.20,1084,1,29,292,17,-275,A
knightscastle 2002.10.20,1084,1,27,283,18,-265,B
chrisyacoub 2002.10.20,914,1,26,215,46,-169,A
chrisyacoub 2002.10.20,914,1,26,218,42,-176,B
aafire 2006.04.19,943,1,21,55,43,-12,A
aafire 2006.04.19,943,1,21,50,48,-2,B
Cybersun 2006.04.19,1043,1,24,187,17,-170,A
Cybersun 2006.04.19,1043,1,24,193,17,-176,B
vav 2002.11.09,953,1,26,283,27,-256,A
vav 2002.11.09,953,1,25,290,32,-258,B
cutenuke 2002.11.09,927,1,21,236,14,-222,A
cutenuke 2002.11.09,927,1,22,242,18,-224,B
Paestka 2005.05.16,982,1,21,240,19,-221,A
Paestka 2005.05.16,982,1,21,217,24,-193,B
CooperW 2005.05.16,1010,1,19,182,32,-150,A
CooperW 2005.05.16,1010,1,19,159,32,-127,B
hwm 2005.04.30,912,1,17,284,29,-255,A
hwm 2005.04.30,912,1,17,276,41,-235,B
LEOUTSAKOS 2005.04.30,1085,1,15,270,27,-243,A
LEOUTSAKOS 2005.04.30,1085,1,15,238,33,-205,B
Kyobutungi 2005.04.25,1101,1,27,178,41,-137,A
Kyobutungi 2005.04.25,1101,1,27,192,41,-151,B
lsilipo 2005.04.25,872,1,21,96,43,-53,A
lsilipo 2005.04.25,872,1,21,92,38,-54,B
entanglement 2005.06.21,994,1,13,295,31,-264,A
entanglement 2005.06.21,994,1,13,266,31,-235,B
HEARTLESSWIZARD 2005.06.19,875,1,59,301,27,-274,A
HEARTLESSWIZARD 2005.06.19,875,1,59,302,32,-270,B
Schuerer 2005.06.19,1067,1,51,204,28,-176,A
Schuerer 2005.06.19,1067,1,52,211,31,-180,B
chrisyacoub 2002.08.09,952,1,17,300,35,-265,A
chrisyacoub 2002.08.09,952,1,17,286,47,-239,B
MikeRN 2002.08.09,1023,1,14,188,29,-159,A
MikeRN 2002.08.09,1023,1,14,183,29,-154,B
dldnjstjq 2005.05.02,939,1,12,169,25,-144,A
dldnjstjq 2005.05.02,939,1,12,157,33,-124,B
iveyjr 2005.05.02,878,1,11,120,18,-102,A
iveyjr 2005.05.02,878,1,11,101,27,-74,B
BlueKeyboard 2005.05.06,1048,1,31,233,23,-210,A
BlueKeyboard 2005.05.06,1048,1,30,248,23,-225,B
hwm 2005.05.06,912,1,34,351,21,-330,A
hwm 2005.05.06,912,1,34,383,26,-357,B
muselaers 2005.05.12,1017,1,14,20,50,30,A
muselaers 2005.05.12,1017,1,12,13,67,54,B
Paestka 2005.05.12,918,1,18,101,28,-73,A
Paestka 2005.05.12,918,1,18,125,22,-103,B
exaanil 2006.04.23,1068,1,16,214,38,-176,A
exaanil 2006.04.23,1068,1,16,219,38,-181,B
zebrafish 2006.04.23,917,1,16,285,25,-260,A
zebrafish 2006.04.23,917,1,16,289,25,-264,B
JuliusG 2006.03.30,892,1,26,184,35,-149,A
JuliusG 2006.03.30,892,1,25,190,24,-166,B
ferking 2006.03.30,1021,1,26,254,19,-235,A
ferking 2006.03.30,1021,1,26,257,19,-238,B
ferking 2006.04.24,1131,1,11,132,0,-132,A
ferking 2006.04.24,1131,1,11,125,9,-116,B
Memnochblue 2006.04.24,860,1,11,192,18,-174,A
Memnochblue 2006.04.24,860,1,11,208,18,-190,B
iveyjr 2005.04.23,860,1,35,125,37,-88,A
iveyjr 2005.04.23,860,1,35,112,31,-81,B
OboeDeity 2005.04.23,929,1,34,121,29,-92,A
OboeDeity 2005.04.23,929,1,33,106,36,-70,B
iveyjr 2005.03.26,880,1,19,276,21,-255,A
iveyjr 2005.03.26,880,1,19,270,16,-254,B
debateking 2005.03.26,1031,1,18,285,22,-263,A
debateking 2005.03.26,1031,1,16,387,19,-368,B
FJB 2005.03.17,859,4,69,157,26,-131,A
FJB 2005.03.17,859,4,65,165,22,-143,B
GolfBob 2005.03.17,1108,1,20,173,10,-163,A
GolfBob 2005.03.17,1108,1,20,178,10,-168,B
Cybersun 2006.04.24,1021,1,18,288,17,-271,A
Cybersun 2006.04.24,1021,1,17,275,18,-257,B
Bossdog 2006.04.24,907,1,19,404,10,-394,A
Bossdog 2006.04.24,907,1,19,419,16,-403,B
Memnochblue 2006.04.10,1088,1,11,404,9,-395,A
Memnochblue 2006.04.10,1088,1,11,408,18,-390,B
Nemobxl 2006.04.10,820,1,8,207,38,-169,A
Nemobxl 2006.04.10,820,1,8,209,25,-184,B
Memnochblue 2006.04.22,873,2,63,135,37,-98,A
Memnochblue 2006.04.22,873,2,63,147,38,-109,B
ferking 2006.04.22,1119,2,61,102,34,-68,A
ferking 2006.04.22,1119,2,61,104,36,-68,B
fboccardo 2005.04.18,976,4,119,141,33,-108,A
fboccardo 2005.04.18,976,4,117,132,33,-99,B
garethcash 2005.04.18,1003,3,110,147,34,-113,A
garethcash 2005.04.18,1003,3,109,148,31,-117,B
Bossdog 2006.04.10,880,1,20,214,30,-184,A
Bossdog 2006.04.10,880,1,20,215,30,-185,B
Etka 2006.04.10,1048,1,16,274,25,-249,A
Etka 2006.04.10,1048,1,16,263,31,-232,B
garethcash 2005.04.22,994,2,50,135,26,-109,A
garethcash 2005.04.22,994,2,49,131,29,-102,B
fboccardo 2005.04.22,985,2,55,212,31,-181,A
fboccardo 2005.04.22,985,2,54,220,33,-187,B
MischiMaestro 2005.04.18,999,1,8,253,12,-241,A
MischiMaestro 2005.04.18,999,1,8,242,12,-230,B
utsutso 2002.05.12,1098,1,16,258,12,-246,A
utsutso 2002.05.12,1098,1,16,233,19,-214,B
whatbomb 2002.05.12,887,1,14,92,50,-42,A
whatbomb 2002.05.12,887,1,14,58,50,-8,B
SpacedCadet 2002.01.25,1028,2,25,265,12,-253,A
SpacedCadet 2002.01.25,1028,2,25,254,16,-238,B
Gaby 2002.01.25,930,2,24,274,33,-241,A
Gaby 2002.01.25,930,2,24,270,29,-241,B
debateking 2005.03.27,1101,1,21,191,43,-148,A
debateking 2005.03.27,1101,1,18,161,50,-111,B
iveyjr 2005.03.27,875,2,35,233,29,-204,A
iveyjr 2005.03.27,875,2,34,241,32,-209,B
debateking 2005.03.24,1039,1,12,179,17,-162,A
debateking 2005.03.24,1039,1,12,169,17,-152,B
iveyjr 2005.03.24,876,2,28,235,25,-210,A
iveyjr 2005.03.24,876,2,28,209,36,-173,B
Kyobutungi 2005.03.24,1095,1,15,193,13,-180,A
Kyobutungi 2005.03.24,1095,1,15,164,20,-144,B
varchata 2002.06.07,971,1,24,322,25,-297,A
varchata 2002.06.07,971,1,23,277,26,-251,B
amajouity 2002.06.07,907,1,13,204,23,-181,A
amajouity 2002.06.07,907,1,14,192,29,-163,B
lsilipo 2005.04.10,854,1,13,264,23,-241,A
lsilipo 2005.04.10,854,1,13,273,23,-250,B
diamonds 2005.04.10,1131,1,11,72,54,-18,A
diamonds 2005.04.10,1131,1,10,54,60,6,B
Mxkuma 2005.03.23,938,4,126,223,24,-199,A
Mxkuma 2005.03.23,938,4,125,214,24,-190,B
danlei 2006.04.09,891,1,44,173,25,-148,A
danlei 2006.04.09,891,1,44,164,32,-132,B
Bossdog 2006.04.09,900,1,44,172,23,-149,A
Bossdog 2006.04.09,900,1,44,172,20,-152,B
FJB 2005.03.22,951,7,83,167,31,-136,A
FJB 2005.03.22,951,7,81,154,30,-124,B
Hamhawk 2005.03.22,1006,1,10,337,10,-327,A
Hamhawk 2005.03.22,1006,1,10,324,10,-314,B
iveyjr 2005.04.03,857,1,15,305,27,-278,A
iveyjr 2005.04.03,857,1,15,294,27,-267,B
FJB 2005.04.03,1083,1,18,325,39,-286,A
FJB 2005.04.03,1083,1,18,321,39,-282,B
lager 2002.04.12,882,1,18,363,28,-335,A
lager 2002.04.12,882,1,17,391,24,-367,B
Endymion 2002.04.12,1046,1,14,297,29,-268,A
Endymion 2002.04.12,1046,1,15,270,27,-243,B
HEARTLESSWIZARD 2004.10.09,779,1,21,181,29,-152,A
HEARTLESSWIZARD 2004.10.09,779,1,22,200,32,-168,B
drevilrocks 2004.10.09,1119,1,32,394,22,-372,A
drevilrocks 2004.10.09,1119,1,31,429,19,-410,B
americanista 2006.01.01,1002,1,14,190,21,-169,A
americanista 2006.01.01,1002,1,14,192,29,-163,B
Halfman 2006.01.01,882,1,14,210,43,-167,A
Halfman 2006.01.01,882,1,14,220,43,-177,B
medilein 2005.03.28,1108,1,17,175,47,-128,A
medilein 2005.03.28,1108,1,16,178,44,-134,B
iveyjr 2005.03.28,866,1,17,182,35,-147,A
iveyjr 2005.03.28,866,1,17,184,35,-149,B
iveyjr 2005.03.22,920,7,97,272,14,-258,A
iveyjr 2005.03.22,920,7,99,265,15,-250,B
FJB 2005.03.27,1024,1,14,354,29,-325,A
FJB 2005.03.27,1024,1,14,368,29,-339,B
JuliusG 2006.04.01,927,1,26,157,35,-122,A
JuliusG 2006.04.01,927,1,25,139,40,-99,B
ninox 2006.04.01,1010,1,22,99,36,-63,A
ninox 2006.04.01,1010,1,21,109,33,-76,B
LeCrabe 2002.06.07,1056,1,29,176,28,-148,A
LeCrabe 2002.06.07,1056,1,29,183,28,-155,B
Guuyver 2002.06.07,815,1,29,176,41,-135,A
Guuyver 2002.06.07,815,1,28,189,43,-146,B
HEARTLESSWIZARD 2005.03.25,947,1,17,190,24,-166,A
HEARTLESSWIZARD 2005.03.25,947,1,17,179,18,-161,B
GolfBob 2005.03.25,1032,1,16,169,6,-163,A
GolfBob 2005.03.25,1032,1,16,143,6,-137,B
loserman 2006.03.29,887,1,11,185,27,-158,A
loserman 2006.03.29,887,1,10,154,20,-134,B
cpinya 2006.03.29,1063,2,22,220,36,-184,A
cpinya 2006.03.29,1063,2,22,208,41,-167,B
Nemobxl 2006.03.30,954,1,19,177,32,-145,A
Nemobxl 2006.03.30,954,1,19,164,32,-132,B
Nemobxl 2006.03.30,954,1,19,184,32,-152,C
hydek 2006.03.30,1033,1,20,201,40,-161,A
hydek 2006.03.30,1033,1,20,202,50,-152,B
hydek 2006.03.30,1033,1,20,210,45,-165,C
amajouity 2002.06.27,922,1,16,204,31,-173,A
amajouity 2002.06.27,922,1,15,221,33,-188,B
owenbagge 2002.06.27,943,1,11,56,54,-2,A
owenbagge 2002.06.27,943,1,10,64,50,-14,B
Guuyver 2002.05.17,817,1,43,114,23,-91,A
Guuyver 2002.05.17,817,1,41,120,22,-98,B
owlman 2002.05.17,1039,1,43,110,14,-96,A
owlman 2002.05.17,1039,1,42,108,29,-79,B
amajouity 2002.04.02,869,2,43,285,19,-266,A
amajouity 2002.04.02,869,2,42,263,21,-242,B
kingmicah 2002.04.02,1112,2,41,273,27,-246,A
kingmicah 2002.04.02,1112,2,41,268,27,-241,B
basitian 2005.03.14,1171,2,45,209,27,-182,A
basitian 2005.03.14,1171,2,44,216,23,-193,B
FJB 2005.03.14,840,2,44,170,36,-134,A
FJB 2005.03.14,840,2,44,140,34,-106,B
ferking 2006.03.16,1034,1,19,296,10,-286,A
ferking 2006.03.16,1034,1,20,307,10,-297,B
SUNNYMAN 2006.03.16,950,1,17,204,24,-180,A
SUNNYMAN 2006.03.16,950,1,17,181,24,-157,B
nosek 2005.03.17,1106,1,26,73,46,-27,A
nosek 2005.03.17,1106,1,21,91,48,-43,B
JuliusG 2006.03.26,914,1,27,162,26,-136,A
JuliusG 2006.03.26,914,1,26,148,23,-125,B
ninox 2006.03.26,985,1,25,121,28,-93,A
ninox 2006.03.26,985,1,25,106,36,-70,B
Kyobutungi 2005.03.22,1043,1,14,196,29,-167,A
Kyobutungi 2005.03.22,1043,1,14,188,21,-167,B
FJB 2005.03.21,870,4,73,185,22,-163,A
FJB 2005.03.21,870,4,73,175,22,-153,B
iveyjr 2005.03.21,988,4,74,205,34,-171,A
iveyjr 2005.03.21,988,4,75,197,32,-165,B
HOOT 2002.03.03,860,1,14,90,29,-61,A
HOOT 2002.03.03,860,1,12,82,50,-32,B
Cahta 2002.03.03,1116,1,15,163,13,-150,A
Cahta 2002.03.03,1116,1,16,157,25,-132,B
FJB 2005.03.16,836,1,31,314,26,-288,A
FJB 2005.03.16,836,1,30,318,23,-295,B
basitian 2005.03.16,1005,1,30,323,27,-296,A
basitian 2005.03.16,1005,1,27,278,33,-245,B
schnootzer 2006.03.29,837,2,25,214,32,-182,A
schnootzer 2006.03.29,837,2,23,189,30,-159,B
RoKStAR 2006.03.29,995,1,16,327,25,-302,A
RoKStAR 2006.03.29,995,1,16,325,31,-294,B
petergriffin 2006.03.22,1192,1,26,137,35,-102,A
petergriffin 2006.03.22,1192,1,26,137,35,-102,B
Tarish 2006.03.22,719,1,24,153,38,-115,A
Tarish 2006.03.22,719,1,24,163,25,-138,B
alexcardoso 2004.07.22,1086,2,27,197,22,-175,A
alexcardoso 2004.07.22,1086,2,28,183,25,-158,B
twno 2004.07.22,897,2,33,278,15,-263,A
twno 2004.07.22,897,2,33,265,15,-250,B
supertintin 2004.07.27,1229,1,71,105,49,-56,A
supertintin 2004.07.27,1229,1,71,119,51,-68,B
supertintin 2004.07.27,1229,1,69,117,49,-68,C
southwestco 2004.07.27,759,1,53,78,23,-55,A
southwestco 2004.07.27,759,1,52,86,25,-61,B
southwestco 2004.07.27,759,1,52,98,25,-73,C
icman 2005.03.04,1086,1,11,62,73,11,A
icman 2005.03.04,1086,1,11,64,73,9,B
youngrower 2005.03.04,910,1,11,152,18,-134,A
youngrower 2005.03.04,910,1,11,154,9,-145,B
olzie 2005.03.17,1031,1,12,150,25,-125,A
olzie 2005.03.17,1031,1,12,141,17,-124,B
FJB 2005.03.11,905,1,24,210,8,-202,A
FJB 2005.03.11,905,1,23,191,13,-178,B
dockson 2005.03.11,936,1,21,118,24,-94,A
dockson 2005.03.11,936,1,21,111,24,-87,B
Krandall 2006.03.20,918,1,27,156,26,-130,A
Krandall 2006.03.20,918,1,27,144,26,-118,B
Halfman 2006.03.20,1069,1,25,96,36,-60,A
Halfman 2006.03.20,1069,1,25,100,40,-60,B
schnootzer 2006.03.28,1108,2,35,186,43,-143,A
schnootzer 2006.03.28,1108,2,34,198,35,-163,B
cpinya 2006.03.28,970,1,22,171,41,-130,A
cpinya 2006.03.28,970,1,21,164,48,-116,B
calibra 2001.12.27,1049,1,10,99,40,-59,A
calibra 2001.12.27,1049,1,10,67,30,-37,B
Gaby 2001.12.27,945,1,12,288,42,-246,A
Gaby 2001.12.27,945,1,12,273,42,-231,B
BollNCSU 2001.07.30,953,3,34,206,24,-182,A
BollNCSU 2001.07.30,953,3,34,235,21,-214,B
Gaby 2001.07.30,1002,3,42,239,17,-222,A
Gaby 2001.07.30,1002,3,39,246,21,-225,B
Damagical 2006.03.26,1103,1,9,189,22,-167,A
Damagical 2006.03.26,1103,1,9,218,11,-207,B
KoolBreez 2006.03.26,868,1,9,292,33,-259,A
KoolBreez 2006.03.26,868,1,9,304,22,-282,B
IIpawnII 2000.02.02,750,4,110,130,33,-97,A
IIpawnII 2000.02.02,750,4,107,124,32,-92,B
Knighter 2000.02.02,959,9,219,149,32,-117,A
Knighter 2000.02.02,959,9,214,145,31,-114,B
basitian 2005.03.17,1001,1,8,86,38,-48,A
basitian 2005.03.17,1001,1,8,66,38,-28,B
johnald 2006.03.28,855,1,14,193,14,-179,A
johnald 2006.03.28,855,1,14,195,21,-174,B
HEARTLESSWIZARD 2005.02.09,853,1,13,96,38,-58,A
HEARTLESSWIZARD 2005.02.09,853,1,13,97,31,-66,B
Rhiannontg 2005.02.09,1068,1,12,82,58,-24,A
Rhiannontg 2005.02.09,1068,1,12,103,33,-70,B
telaviv 2004.10.10,1000,1,27,66,41,-25,A
telaviv 2004.10.10,1000,1,27,59,44,-15,B
HEARTLESSWIZARD 2004.10.10,862,1,31,192,23,-169,A
HEARTLESSWIZARD 2004.10.10,862,1,30,194,17,-177,B
iascrazyorioles 2006.03.26,954,1,21,262,33,-229,A
iascrazyorioles 2006.03.26,954,1,19,235,26,-209,B
Lightmonster 2006.03.26,983,1,20,203,30,-173,A
Lightmonster 2006.03.26,983,1,19,213,32,-181,B
jpresley 2001.10.10,1093,1,25,200,24,-176,A
jpresley 2001.10.10,1093,1,24,213,25,-188,B
CashCow 2001.10.10,850,2,56,353,25,-328,A
CashCow 2001.10.10,850,2,51,341,24,-317,B
Gaby 2001.01.07,1005,1,32,273,19,-254,A
Gaby 2001.01.07,1005,1,31,309,23,-286,B
hitchhiker 2001.01.07,912,1,32,237,25,-212,A
hitchhiker 2001.01.07,912,1,30,293,13,-280,B
JasperGreene 2006.03.01,1087,1,47,131,26,-105,A
JasperGreene 2006.03.01,1087,1,44,138,30,-108,B
mcgrail 2006.03.01,935,2,57,167,21,-146,A
mcgrail 2006.03.01,935,2,56,160,21,-139,B
StrwberyNBanana 2000.02.16,1002,1,9,214,22,-192,A
StrwberyNBanana 2000.02.16,1002,1,9,202,22,-180,B
mwcommander 2000.02.16,870,1,11,358,9,-349,A
mwcommander 2000.02.16,870,1,11,338,18,-320,B
ShawnB 2006.02.14,1126,2,66,191,32,-159,A
ShawnB 2006.02.14,1126,2,65,192,32,-160,B
spudthedud 2006.02.14,831,2,67,190,24,-166,A
spudthedud 2006.02.14,831,2,66,182,23,-159,B
honte 2005.02.11,940,1,47,220,38,-182,A
honte 2005.02.11,940,1,46,210,33,-177,B
rickx 2005.02.11,1054,1,44,194,30,-164,A
rickx 2005.02.11,1054,1,42,188,31,-157,B
merka 2005.01.18,810,1,41,93,20,-73,A
merka 2005.01.18,810,1,41,105,20,-85,B
pajac 2005.01.18,1101,1,40,56,40,-16,A
pajac 2005.01.18,1101,1,39,70,38,-32,B
newwave 2001.10.10,1005,1,31,361,23,-338,A
newwave 2001.10.10,1005,1,30,374,20,-354,B
HappyCrap 2000.02.02,885,1,34,61,32,-29,A
HappyCrap 2000.02.02,885,1,34,63,29,-34,B
Xillion 2006.03.20,1049,1,17,141,29,-112,A
Xillion 2006.03.20,1049,1,17,103,29,-74,B
johnald 2006.03.20,907,1,18,263,28,-235,A
johnald 2006.03.20,907,1,18,217,28,-189,B
dbalparda 2006.03.02,1165,1,18,36,50,14,A
dbalparda 2006.03.02,1165,1,18,32,56,24,B
mcgrail 2006.03.02,818,3,40,132,20,-112,A
mcgrail 2006.03.02,818,3,40,129,20,-109,B
rbb 2006.03.25,900,1,20,204,25,-179,A
rbb 2006.03.25,900,1,20,200,30,-170,B
Halfman 2006.03.25,1060,1,19,120,37,-83,A
Halfman 2006.03.25,1060,1,19,133,37,-96,B
EliteHunter 2006.03.18,1006,1,14,68,57,-11,A
EliteHunter 2006.03.18,1006,1,12,66,58,-8,B
Krandall 2006.03.18,978,1,18,138,28,-110,A
Krandall 2006.03.18,978,1,18,125,33,-92,B
MassachusettsFats 2006.03.21,1080,1,19,217,21,-196,A
MassachusettsFats 2006.03.21,1080,1,18,218,17,-201,B
betsys 2006.03.21,850,1,14,227,36,-191,A
betsys 2006.03.21,850,1,15,248,20,-228,B
HEARTLESSWIZARD 2004.12.23,827,1,36,184,28,-156,A
HEARTLESSWIZARD 2004.12.23,827,1,36,190,31,-159,B
GolfBob 2004.12.23,1005,1,34,137,24,-113,A
GolfBob 2004.12.23,1005,1,34,152,24,-128,B
Bulochka 2005.01.05,921,1,17,197,24,-173,A
Bulochka 2005.01.05,921,1,17,187,29,-158,B
Nett 2005.01.05,1004,1,15,76,33,-43,A
Nett 2005.01.05,1004,1,15,78,40,-38,B
StrwberyNBanana 2000.04.06,1052,1,16,159,38,-121,A
StrwberyNBanana 2000.04.06,1052,1,16,157,44,-113,B
mwcommander 2000.04.06,832,1,16,96,44,-52,A
mwcommander 2000.04.06,832,1,16,97,50,-47,B
allgood 2000.03.27,1015,1,12,112,17,-95,A
allgood 2000.03.27,1015,1,12,134,17,-117,B
obao 2000.03.27,857,1,15,262,13,-249,A
obao 2000.03.27,857,1,15,290,13,-277,B
KellBell 2001.07.05,547,1,12,236,42,-194,A
KellBell 2001.07.05,547,1,12,236,42,-194,B
konovalov 2001.07.05,1313,1,10,129,40,-89,A
konovalov 2001.07.05,1313,1,10,138,30,-108,B
MMen 2004.05.11,1070,1,13,176,15,-161,A
MMen 2004.05.11,1070,1,13,176,15,-161,B
twno 2004.05.11,869,1,15,187,33,-154,A
twno 2004.05.11,869,1,15,176,33,-143,B
ZZandirt 2006.01.04,977,1,7,0,86,86,A
ZZandirt 2006.01.04,977,1,7,0,86,86,B
ChessRio 2006.01.04,891,2,27,114,30,-84,A
ChessRio 2006.01.04,891,2,27,123,30,-93,B
daChodeMan 2006.03.01,883,1,27,173,33,-140,A
daChodeMan 2006.03.01,883,1,26,179,35,-144,B
Halfman 2006.03.01,986,1,22,139,50,-89,A
Halfman 2006.03.01,986,1,23,136,39,-97,B
Halfman 2006.02.18,925,1,21,228,14,-214,A
Halfman 2006.02.18,925,1,21,204,14,-190,B
mickeyl 2006.02.18,1008,1,21,204,43,-161,A
mickeyl 2006.02.18,1008,1,21,187,43,-144,B
voetbalfan 2004.09.25,978,1,14,141,43,-98,A
voetbalfan 2004.09.25,978,1,14,151,43,-108,B
HEARTLESSWIZARD 2004.09.25,804,2,24,230,33,-197,A
HEARTLESSWIZARD 2004.09.25,804,2,25,280,28,-252,B
Knighter 2000.01.22,925,1,20,136,20,-116,A
Knighter 2000.01.22,925,1,20,133,20,-113,B
stefaan 2000.01.22,1024,1,19,87,37,-50,A
stefaan 2000.01.22,1024,1,19,83,37,-46,B
Knighter 1999.12.28,926,1,14,231,14,-217,A
Knighter 1999.12.28,926,1,14,216,14,-202,B
Chronoscepter 1999.12.28,799,1,12,147,42,-105,A
Chronoscepter 1999.12.28,799,1,12,134,50,-84,B
southwestco 2004.07.05,990,3,56,273,18,-255,A
southwestco 2004.07.05,990,3,56,276,18,-258,B
alexcardoso 2004.07.05,938,3,50,205,22,-183,A
alexcardoso 2004.07.05,938,3,50,204,20,-184,B
GaryP 2001.06.12,934,1,14,95,43,-52,A
GaryP 2001.06.12,934,1,14,83,43,-40,B
chessmoker 2001.06.12,946,1,14,176,29,-147,A
chessmoker 2001.06.12,946,1,14,166,29,-137,B
LuckyG 2006.03.13,1053,1,20,137,30,-107,A
LuckyG 2006.03.13,1053,1,20,155,35,-120,B
betsys 2006.03.13,942,1,20,145,30,-115,A
betsys 2006.03.13,942,1,20,175,30,-145,B
marioandluigi 2006.03.05,1130,1,14,169,21,-148,A
marioandluigi 2006.03.05,1130,1,14,186,14,-172,B
mcgrail 2006.03.05,832,3,51,178,27,-151,A
mcgrail 2006.03.05,832,3,51,170,31,-139,B
allgood 2000.03.28,1095,1,23,313,30,-283,A
allgood 2000.03.28,1095,1,24,306,33,-273,B
obao 2000.03.28,785,2,80,262,27,-235,A
obao 2000.03.28,785,2,78,250,29,-221,B
JuliusG 2006.03.14,831,1,7,132,29,-103,A
JuliusG 2006.03.14,831,1,6,197,17,-180,B
ferking 2006.03.14,1043,1,12,281,50,-231,A
ferking 2006.03.14,1043,1,12,284,50,-234,B
returnofcaz 2006.03.02,1003,1,10,203,30,-173,A
returnofcaz 2006.03.02,1003,1,10,200,20,-180,B
allgood 2000.04.02,1049,1,10,48,50,2,A
allgood 2000.04.02,1049,1,10,50,30,-20,B
obao 2000.04.02,747,1,10,219,10,-209,A
obao 2000.04.02,747,1,10,219,10,-209,B
mwcommander 2000.02.26,857,1,10,226,0,-226,A
mwcommander 2000.02.26,857,1,10,217,0,-217,B
MnM 2000.02.26,1091,1,9,74,44,-30,A
MnM 2000.02.26,1091,1,9,70,44,-26,B
Playlight 2000.03.28,1142,1,55,144,44,-100,A
Playlight 2000.03.28,1142,1,55,142,44,-98,B
spudthedud 2006.02.12,874,2,41,189,29,-160,A
spudthedud 2006.02.12,874,2,37,186,35,-151,B
stdonn 2006.02.12,1097,1,15,142,13,-129,A
stdonn 2006.02.12,1097,1,12,117,17,-100,B
IOMatrix 2001.01.21,1137,1,36,162,33,-129,A
IOMatrix 2001.01.21,1137,1,35,200,37,-163,B
Auerweck 2001.01.21,850,1,37,138,24,-114,A
Auerweck 2001.01.21,850,1,35,148,23,-125,B
HEARTLESSWIZARD 2004.10.22,846,1,29,175,17,-158,A
HEARTLESSWIZARD 2004.10.22,846,1,29,163,17,-146,B
spiZ 2004.10.22,1047,1,26,116,54,-62,A
spiZ 2004.10.22,1047,1,26,112,46,-66,B
mrfriday 2000.02.07,758,1,18,169,44,-125,A
mrfriday 2000.02.07,758,1,18,161,39,-122,B
aet 2000.02.07,1040,1,17,95,35,-60,A
aet 2000.02.07,1040,1,17,86,35,-51,B
cpinya 2006.03.05,962,1,16,300,19,-281,A
cpinya 2006.03.05,962,1,15,296,27,-269,B
ewrosenthal 2006.03.04,1159,1,11,156,36,-120,A
ewrosenthal 2006.03.04,1159,1,11,172,36,-136,B
mcgrail 2006.03.04,826,1,11,233,46,-187,A
mcgrail 2006.03.04,826,1,11,249,46,-203,B
ennil 2004.10.05,916,1,32,96,41,-55,A
ennil 2004.10.05,916,1,32,98,44,-54,B
telaviv 2004.10.05,1035,1,33,146,42,-104,A
telaviv 2004.10.05,1035,1,33,163,27,-136,B
Tarish 2006.03.01,755,3,85,208,27,-181,A
Tarish 2006.03.01,755,3,81,193,26,-167,B
gottago 2006.03.01,1136,4,91,167,30,-137,A
gottago 2006.03.01,1136,4,92,165,24,-141,B
wavewave 2006.03.05,1168,1,23,111,30,-81,A
wavewave 2006.03.05,1168,1,23,103,30,-73,B
Cortez 2000.02.02,970,1,17,48,29,-19,A
Cortez 2000.02.02,970,1,17,37,35,-2,B
mrfriday 2000.01.29,724,1,20,274,15,-259,A
mrfriday 2000.01.29,724,1,20,251,15,-236,B
Knighter 2000.01.29,954,1,18,158,33,-125,A
Knighter 2000.01.29,954,1,17,147,29,-118,B
SChlebowski 2006.02.13,1152,1,18,291,22,-269,A
SChlebowski 2006.02.13,1152,1,18,242,28,-214,B
spudthedud 2006.02.13,766,1,19,327,32,-295,A
spudthedud 2006.02.13,766,1,19,288,26,-262,B
StrwberyNBanana 2000.03.29,1090,1,25,154,12,-142,A
StrwberyNBanana 2000.03.29,1090,1,25,157,20,-137,B
mwcommander 2000.03.29,844,1,25,185,12,-173,A
mwcommander 2000.03.29,844,1,25,184,16,-168,B
StrwberyNBanana 2000.02.05,990,1,34,228,12,-216,A
StrwberyNBanana 2000.02.05,990,1,34,264,6,-258,B
mwcommander 2000.02.05,898,1,29,224,14,-210,A
mwcommander 2000.02.05,898,1,27,223,15,-208,B
twno 2004.07.16,920,2,18,229,11,-218,A
twno 2004.07.16,920,2,18,251,6,-245,B
alexcardoso 2004.07.16,1055,2,17,136,18,-118,A
alexcardoso 2004.07.16,1055,2,18,141,28,-113,B
RHankinsJr 2006.02.12,1149,1,19,53,42,-11,A
RHankinsJr 2006.02.12,1149,1,18,58,50,-8,B
twno 2004.04.04,890,1,18,113,39,-74,A
twno 2004.04.04,890,1,17,58,41,-17,B
hcube 2004.04.04,1092,1,18,164,17,-147,A
hcube 2004.04.04,1092,1,18,159,22,-137,B
ennil 2004.10.02,929,1,11,69,46,-23,A
ennil 2004.10.02,929,1,11,65,54,-11,B
caracaskid 2004.10.02,895,1,12,273,25,-248,A
caracaskid 2004.10.02,895,1,12,262,25,-237,B
Vox 2004.11.19,806,1,12,145,33,-112,A
Vox 2004.11.19,806,1,12,150,33,-117,B
EvilenasThrone 2004.11.19,1033,1,14,203,36,-167,A
EvilenasThrone 2004.11.19,1033,1,14,204,36,-168,B
vismaior 2006.03.02,936,1,14,173,21,-152,A
vismaior 2006.03.02,936,1,14,159,21,-138,B
surrencytw 2004.11.13,1093,1,18,534,11,-523,A
surrencytw 2004.11.13,1093,1,18,527,11,-516,B
ConditionZero 2004.11.13,873,1,13,350,31,-319,A
ConditionZero 2004.11.13,873,1,13,372,31,-341,B
fuz 2000.02.02,933,2,27,178,15,-163,A
fuz 2000.02.02,933,2,27,181,15,-166,B
ZeroKool 2000.02.06,914,1,26,158,23,-135,A
ZeroKool 2000.02.06,914,1,26,142,23,-119,B
aet 2000.02.06,993,1,25,92,36,-56,A
aet 2000.02.06,993,1,25,75,36,-39,B
spudthedud 2006.02.15,965,1,24,122,38,-84,A
spudthedud 2006.02.15,965,1,24,118,42,-76,B
Cybersun 2006.02.15,992,1,32,105,28,-77,A
Cybersun 2006.02.15,992,1,26,129,19,-110,B
Shuckey 2000.01.28,916,1,26,88,54,-34,A
Shuckey 2000.01.28,916,1,26,91,54,-37,B
Shuckey 2000.01.28,916,1,26,91,50,-41,C
Knighter 2000.01.28,925,1,26,112,38,-74,A
Knighter 2000.01.28,925,1,26,107,38,-69,B
Knighter 2000.01.28,925,1,26,105,42,-63,C
azshtrdude 2004.09.11,963,1,23,312,22,-290,A
azshtrdude 2004.09.11,963,1,23,309,17,-292,B
HEARTLESSWIZARD 2004.09.11,764,1,21,234,38,-196,A
HEARTLESSWIZARD 2004.09.11,764,1,21,235,33,-202,B
laconique 2000.01.15,1019,1,37,82,35,-47,A
laconique 2000.01.15,1019,1,36,75,31,-44,B
Tarish 2006.02.28,775,1,17,184,24,-160,A
Tarish 2006.02.28,775,1,14,176,29,-147,B
petergriffin 2006.02.28,1167,1,12,84,42,-42,A
petergriffin 2006.02.28,1167,1,12,80,42,-38,B
Knighter 2000.01.23,893,1,19,240,32,-208,A
Knighter 2000.01.23,893,1,19,248,37,-211,B
giles 2000.01.23,888,1,15,99,20,-79,A
giles 2000.01.23,888,1,15,100,20,-80,B
HEARTLESSWIZARD 2004.07.29,827,1,16,201,38,-163,A
HEARTLESSWIZARD 2004.07.29,827,1,16,194,44,-150,B
Zumon 2004.07.29,1089,1,17,233,29,-204,A
Zumon 2004.07.29,1089,1,16,224,31,-193,B
Halfman 2006.02.13,930,1,13,349,23,-326,A
Halfman 2006.02.13,930,1,13,358,23,-335,B
prodenter 2006.02.13,1041,1,8,102,50,-52,A
prodenter 2006.02.13,1041,1,8,142,25,-117,B
Knighter 2000.01.26,911,1,50,190,22,-168,A
Knighter 2000.01.26,911,1,50,188,14,-174,B
gnutz 2000.01.26,855,1,48,140,27,-113,A
gnutz 2000.01.26,855,1,48,145,23,-122,B
mrcapp 2004.04.17,867,1,23,209,26,-183,A
mrcapp 2004.04.17,867,1,23,204,26,-178,B
mcavoy 2004.04.17,1064,1,20,131,40,-91,A
mcavoy 2004.04.17,1064,1,20,122,40,-82,B
andermec 2006.01.07,900,1,17,106,35,-71,A
andermec 2006.01.07,900,1,16,117,38,-79,B
Halfman 2006.01.07,897,2,41,149,24,-125,A
Halfman 2006.01.07,897,2,41,157,27,-130,B
hwqa 2004.09.25,1055,1,9,117,33,-84,A
hwqa 2004.09.25,1055,1,8,131,38,-93,B
mrfriday 2000.01.27,737,1,30,140,37,-103,A
mrfriday 2000.01.27,737,1,30,133,30,-103,B
Knighter 2000.01.27,903,1,30,113,27,-86,A
Knighter 2000.01.27,903,1,29,111,24,-87,B
army 2000.01.29,881,1,18,163,17,-146,A
army 2000.01.29,881,1,17,168,18,-150,B
aet 2000.01.29,994,1,15,64,53,-11,A
aet 2000.01.29,994,1,15,52,47,-5,B
nspirit 2004.07.12,1021,2,60,229,35,-194,A
nspirit 2004.07.12,1021,2,53,251,34,-217,B
sammyCmtww 2004.07.12,908,2,45,120,42,-78,A
sammyCmtww 2004.07.12,908,2,41,126,37,-89,B
ChessProzac 2000.02.02,974,1,19,45,37,-8,A
ChessProzac 2000.02.02,974,1,18,35,50,15,B
vismaior 2006.02.20,947,1,22,150,41,-109,A
vismaior 2006.02.20,947,1,22,145,41,-104,B
kimida 2006.02.20,1041,1,21,199,24,-175,A
kimida 2006.02.20,1041,1,21,200,29,-171,B
Knighter 2000.01.30,952,1,13,123,23,-100,A
Knighter 2000.01.30,952,1,13,109,23,-86,B
slingdraw 2000.01.30,899,1,14,191,36,-155,A
slingdraw 2000.01.30,899,1,13,199,31,-168,B
maxmaz 2004.05.15,1077,1,12,198,25,-173,A
maxmaz 2004.05.15,1077,1,12,198,25,-173,B
twno 2004.05.15,904,2,32,207,31,-176,A
twno 2004.05.15,904,2,32,217,34,-183,B
ChessRio 2005.12.30,912,1,14,129,36,-93,A
ChessRio 2005.12.30,912,1,14,141,36,-105,B
Halfman 2005.12.30,897,1,14,199,36,-163,A
Halfman 2005.12.30,897,1,14,200,29,-171,B
HEARTLESSWIZARD 2004.09.02,791,1,23,186,9,-177,A
HEARTLESSWIZARD 2004.09.02,791,1,22,188,9,-179,B
GolfBob 2004.09.02,999,1,25,187,28,-159,A
GolfBob 2004.09.02,999,1,24,198,25,-173,B
Cybersun 2006.02.12,1004,1,16,277,12,-265,A
Cybersun 2006.02.12,1004,1,15,253,13,-240,B
Panzerkampfwagon 2006.02.12,912,1,14,187,43,-144,A
Panzerkampfwagon 2006.02.12,912,1,14,186,36,-150,B
WesternRed 1999.11.24,1126,1,10,135,10,-125,A
WesternRed 1999.11.24,1126,1,10,145,20,-125,B
Kimber 1999.11.24,865,1,11,289,27,-262,A
Kimber 1999.11.24,865,1,11,306,18,-288,B
colpitts 2004.09.05,1064,1,8,236,25,-211,A
colpitts 2004.09.05,1064,1,8,181,38,-143,B
Foufoutos 2004.09.05,854,1,10,406,10,-396,A
Foufoutos 2004.09.05,854,1,10,342,30,-312,B
twno 2004.07.15,918,1,9,502,0,-502,A
twno 2004.07.15,918,1,9,468,0,-468,B
collmemasteur 2004.07.15,1008,1,7,307,29,-278,A
collmemasteur 2004.07.15,1008,1,7,313,29,-284,B
leffub 2004.08.29,901,1,16,209,25,-184,A
leffub 2004.08.29,901,1,16,228,25,-203,B
HEARTLESSWIZARD 2004.08.29,843,1,11,188,18,-170,A
HEARTLESSWIZARD 2004.08.29,843,1,11,208,18,-190,B
southwestco 2004.07.14,782,1,15,179,13,-166,A
southwestco 2004.07.14,782,1,15,182,13,-169,B
alexcardoso 2004.07.14,1066,1,12,122,17,-105,A
alexcardoso 2004.07.14,1066,1,12,103,25,-78,B
arragorn 1999.12.13,959,1,13,215,15,-200,A
arragorn 1999.12.13,959,1,13,188,15,-173,B
Agenbite 1999.12.13,1025,1,12,88,33,-55,A
Agenbite 1999.12.13,1025,1,12,72,33,-39,B
southwestco 2004.07.15,770,1,22,140,23,-117,A
southwestco 2004.07.15,770,1,22,155,23,-132,B
vat 2004.07.15,1217,1,21,36,52,16,A
vat 2004.07.15,1217,1,20,46,45,-1,B
HEARTLESSWIZARD 2004.08.01,804,1,20,319,25,-294,A
HEARTLESSWIZARD 2004.08.01,804,1,20,341,30,-311,B
Derro 2004.08.01,1151,1,21,310,29,-281,A
Derro 2004.08.01,1151,1,21,373,24,-349,B
wolfla 2006.02.12,913,1,20,116,55,-61,A
wolfla 2006.02.12,913,1,19,108,58,-50,B
dbalparda 2006.02.12,966,1,21,218,29,-189,A
dbalparda 2006.02.12,966,1,20,179,35,-144,B
cybersmash 2004.06.08,1020,1,16,178,12,-166,A
cybersmash 2004.06.08,1020,1,16,155,12,-143,B
alexcardoso 2004.06.08,956,1,23,415,9,-406,A
alexcardoso 2004.06.08,956,1,22,341,18,-323,B
MMen 2004.05.12,1017,1,16,165,6,-159,A
MMen 2004.05.12,1017,1,16,195,6,-189,B
twno 2004.05.12,876,2,34,163,29,-134,A
twno 2004.05.12,876,2,35,163,34,-129,B
Parne 2004.05.15,1075,1,13,143,46,-97,A
Parne 2004.05.15,1075,1,13,136,46,-90,B
Tarish 2006.01.27,861,1,30,227,33,-194,A
Tarish 2006.01.27,861,1,30,237,37,-200,B
olinebeefs 2006.01.27,1036,1,27,206,33,-173,A
olinebeefs 2006.01.27,1036,1,27,221,37,-184,B
pddchess 2005.12.22,882,1,30,196,40,-156,A
pddchess 2005.12.22,882,1,29,199,34,-165,B
Nassor 2005.12.22,1055,1,28,172,43,-129,A
Nassor 2005.12.22,1055,1,27,175,41,-134,B
Turtleskies 2004.07.27,891,1,14,161,36,-125,A
Turtleskies 2004.07.27,891,1,14,154,36,-118,B
Farfarer 2004.07.27,1100,1,17,192,35,-157,A
Farfarer 2004.07.27,1100,1,18,197,33,-164,B
HEARTLESSWIZARD 2006.01.29,963,1,11,309,9,-300,A
HEARTLESSWIZARD 2006.01.29,963,1,11,297,9,-288,B
Johnnyp 2006.01.29,802,1,11,323,27,-296,A
Johnnyp 2006.01.29,802,1,11,308,36,-272,B
Nassor 2005.12.23,950,2,55,107,38,-69,A
Nassor 2005.12.23,950,2,55,106,40,-66,B
rnajerac 2005.12.23,951,2,55,129,49,-80,A
rnajerac 2005.12.23,951,2,55,127,45,-82,B
HEARTLESSWIZARD 2004.06.10,963,1,23,243,13,-230,A
HEARTLESSWIZARD 2004.06.10,963,1,22,241,18,-223,B
OwenDeathstalker 2004.06.10,968,1,20,166,45,-121,A
OwenDeathstalker 2004.06.10,968,1,20,158,45,-113,B
sammyCmtww 2004.07.09,861,1,10,204,20,-184,A
sammyCmtww 2004.07.09,861,1,11,175,27,-148,B
alexcardoso 2004.07.09,1042,1,12,324,33,-291,A
alexcardoso 2004.07.09,1042,1,12,347,25,-322,B
SkyReaper 2006.02.12,834,1,10,110,30,-80,A
SkyReaper 2006.02.12,834,1,10,85,30,-55,B
aalaptop 2006.02.12,1124,1,11,328,27,-301,A
aalaptop 2006.02.12,1124,1,11,284,27,-257,B
Armoral 2004.04.17,1029,1,15,150,33,-117,A
Armoral 2004.04.17,1029,1,15,160,33,-127,B
vibronic 2004.04.17,931,1,15,146,20,-126,A
vibronic 2004.04.17,931,1,15,143,20,-123,B
Halfman 2006.01.20,887,2,50,195,32,-163,A
Halfman 2006.01.20,887,2,46,217,28,-189,B
petergriffin 2006.01.20,873,2,44,146,20,-126,A
petergriffin 2006.01.20,873,2,41,157,24,-133,B
Kimber 1999.12.01,828,1,30,289,27,-262,A
Kimber 1999.12.01,828,1,30,278,20,-258,B
WesternRed 1999.12.01,1126,1,30,237,23,-214,A
WesternRed 1999.12.01,1126,1,30,251,17,-234,B
ChessRio 2005.12.29,925,1,18,289,33,-256,A
ChessRio 2005.12.29,925,1,18,294,33,-261,B
americanista 2005.12.29,1069,1,15,104,33,-71,A
americanista 2005.12.29,1069,1,15,120,40,-80,B
pddchess 2006.01.23,887,1,15,285,20,-265,A
pddchess 2006.01.23,887,1,14,309,14,-295,B
Pancetta 2006.01.23,1075,1,12,292,25,-267,A
Pancetta 2006.01.23,1075,1,12,289,25,-264,B
GolfBob 2004.06.17,950,1,38,67,29,-38,A
GolfBob 2004.06.17,950,1,37,71,30,-41,B
HEARTLESSWIZARD 2004.06.17,917,1,45,160,18,-142,A
HEARTLESSWIZARD 2004.06.17,917,1,45,159,13,-146,B
platyjoe 2004.07.03,1051,1,15,326,13,-313,A
platyjoe 2004.07.03,1051,1,11,393,18,-375,B
sammyCmtww 2004.07.03,809,1,6,278,0,-278,A
sammyCmtww 2004.07.03,809,1,6,281,0,-281,B
WesternRed 1999.11.30,1123,1,7,76,57,-19,A
WesternRed 1999.11.30,1123,1,8,94,62,-32,B
Kimber 1999.11.30,838,1,11,247,36,-211,A
Kimber 1999.11.30,838,1,11,242,46,-196,B
sibil 2004.04.26,1104,1,15,148,40,-108,A
sibil 2004.04.26,1104,1,15,143,40,-103,B
twno 2004.04.26,890,1,17,226,18,-208,A
twno 2004.04.26,890,1,17,233,24,-209,B
Halfman 2006.01.03,876,2,43,70,37,-33,A
Halfman 2006.01.03,876,2,43,75,40,-35,B
olinebeefs 2006.01.03,1089,2,48,149,33,-116,A
olinebeefs 2006.01.03,1089,2,48,165,29,-136,B
Anoten 2006.02.04,913,1,23,399,22,-377,A
Anoten 2006.02.04,913,1,21,339,29,-310,B
aalaptop 2006.02.04,1082,1,18,291,11,-280,A
aalaptop 2006.02.04,1082,1,16,239,12,-227,B
pddchess 2006.01.10,926,1,15,230,20,-210,A
pddchess 2006.01.10,926,1,15,222,20,-202,B
SChlebowski 2006.01.10,1078,1,15,211,27,-184,A
SChlebowski 2006.01.10,1078,1,15,199,33,-166,B
smod 2006.01.23,984,1,13,82,46,-36,A
smod 2006.01.23,984,1,13,94,38,-56,B
Halfman 2006.01.23,876,1,13,222,23,-199,A
Halfman 2006.01.23,876,1,13,238,15,-223,B
PIONPAGO 2006.01.31,985,1,31,122,45,-77,A
PIONPAGO 2006.01.31,985,1,30,93,53,-40,B
PIONPAGO 2006.01.31,985,1,28,100,46,-54,C
Halfman 2006.01.31,915,1,34,160,21,-139,A
Halfman 2006.01.31,915,1,32,150,22,-128,B
Halfman 2006.01.31,915,1,28,156,21,-135,C
Halfman 2006.01.12,867,1,13,38,38,0,A
Halfman 2006.01.12,867,1,11,39,36,-3,B
aGameofChess 2006.01.12,1111,1,15,138,20,-118,A
aGameofChess 2006.01.12,1111,1,14,144,21,-123,B
JorgeAdRomero 2006.01.04,1028,1,20,164,35,-129,A
JorgeAdRomero 2006.01.04,1028,1,20,175,35,-140,B
Ljovusa 2004.05.12,1013,1,18,240,28,-212,A
Ljovusa 2004.05.12,1013,1,18,224,28,-196,B
twno 2004.04.06,883,1,16,438,19,-419,A
twno 2004.04.06,883,1,17,478,24,-454,B
dockson 2004.04.06,984,1,16,431,19,-412,A
dockson 2004.04.06,984,1,16,467,19,-448,B
PIONPAGO 2006.01.13,931,2,32,214,22,-192,A
PIONPAGO 2006.01.13,931,2,29,159,28,-131,B
KarstenBlom 2006.01.13,1063,1,10,165,20,-145,A
KarstenBlom 2006.01.13,1063,1,11,143,36,-107,B
Pfistou 2005.12.24,1112,1,8,206,38,-168,A
Pfistou 2005.12.24,1112,1,8,270,38,-232,B
Spartagus 2005.12.24,1007,1,12,512,8,-504,A
Spartagus 2005.12.24,1007,1,11,559,9,-550,B
twno 2004.04.21,930,1,19,195,32,-163,A
twno 2004.04.21,930,1,19,209,26,-183,B
Ureshii 2004.04.21,908,1,18,144,11,-133,A
Ureshii 2004.04.21,908,1,18,147,17,-130,B
dillondeck 2006.01.13,967,1,19,250,10,-240,A
dillondeck 2006.01.13,967,1,19,235,10,-225,B
PIONPAGO 2006.01.14,945,2,35,189,46,-143,A
PIONPAGO 2006.01.14,945,2,34,173,44,-129,B
BigIrish 2006.01.14,975,1,8,366,38,-328,A
BigIrish 2006.01.14,975,1,9,315,44,-271,B
willcarter 2006.01.14,1027,1,25,138,32,-106,A
willcarter 2006.01.14,1027,1,24,134,38,-96,B
ELMC 2006.01.04,1057,1,23,116,17,-99,A
ELMC 2006.01.04,1057,1,23,120,17,-103,B
Halfman 2006.01.04,912,1,22,48,46,-2,A
Halfman 2006.01.04,912,1,22,54,46,-8,B
ninox 2006.01.07,999,1,21,94,19,-75,A
ninox 2006.01.07,999,1,20,84,25,-59,B
