Name,Rating,Games,Result,Moves,CPL,MM,Sort Score,Analysis
mariusmattheus 2009.08.12,1111,3,3,25,76,40,-36,A
mariusmattheus 2009.08.12,1111,3,3,25,94,44,-50,B
Loran 2009.08.12,774,3,0,27,250,19,-231,A
Loran 2009.08.12,774,3,0,27,227,15,-212,B
nathy 2009.08.11,746,3,1,29,377,17,-360,A
nathy 2009.08.11,746,3,1,29,366,14,-352,B
Booyens 2009.08.11,927,1,1,5,114,80,-34,A
Booyens 2009.08.11,927,1,1,5,121,80,-41,B
nathy 2009.12.25,736,4,0,64,267,22,-245,A
nathy 2009.12.25,736,4,0,64,256,17,-239,B
Sokka 2009.12.25,1062,1,1,23,180,30,-150,A
Sokka 2009.12.25,1062,1,1,23,182,26,-156,B
powerfail 2009.12.28,1009,1,1,8,173,25,-148,A
powerfail 2009.12.28,1009,1,1,8,153,25,-128,B
nathy 2009.12.28,722,1,0,8,283,38,-245,A
nathy 2009.12.28,722,1,0,8,269,25,-244,B
OSZCAR 2009.08.07,1003,1,1,6,108,17,-91,A
OSZCAR 2009.08.07,1003,1,1,6,88,17,-71,B
nathy 2009.08.07,732,4,0,37,361,27,-334,A
nathy 2009.08.07,732,4,0,37,404,19,-385,B
nathy 2009.08.12,736,1,0,11,286,9,-277,A
nathy 2009.08.12,736,1,0,11,203,18,-185,B
getit 2009.08.12,1010,1,1,4,40,75,35,A
getit 2009.08.12,1010,1,1,4,16,75,59,B
reframed 2009.08.11,909,1,0.5,31,122,39,-83,A
reframed 2009.08.11,909,1,0.5,31,113,45,-68,B
OSZCAR 2009.08.11,1031,1,0.5,35,257,43,-214,A
OSZCAR 2009.08.11,1031,1,0.5,35,222,43,-179,B
kybrai 2009.12.27,759,2,1,20,303,30,-273,A
kybrai 2009.12.27,759,2,1,20,342,30,-312,B
japhet 2009.12.27,1087,2,1,17,337,35,-302,A
japhet 2009.12.27,1087,2,1,17,374,29,-345,B
EvilQueen 2009.08.11,958,1,1,15,289,13,-276,A
EvilQueen 2009.08.11,958,1,1,15,297,13,-284,B
TheDancingQueen 2009.08.11,891,1,0,16,321,19,-302,A
TheDancingQueen 2009.08.11,891,1,0,16,302,19,-283,B
nathy 2009.08.09,728,1,0,12,322,33,-289,A
nathy 2009.08.09,728,1,0,12,304,17,-287,B
samoancharger 2009.08.09,1081,1,1,11,274,18,-256,A
samoancharger 2009.08.09,1081,1,1,11,242,18,-224,B
nathy 2009.12.26,721,7,1,111,236,26,-210,A
nathy 2009.12.26,721,7,1,111,233,25,-208,B
fektija 2009.12.26,1046,2,1,36,173,25,-148,A
fektija 2009.12.26,1046,2,1,36,180,22,-158,B
Shurka 2009.10.02,1167,1,1,13,115,46,-69,A
Shurka 2009.10.02,1167,1,1,13,103,54,-49,B
Loran 2009.10.02,752,1,0,16,268,13,-255,A
Loran 2009.10.02,752,1,0,16,238,12,-226,B
francod 2009.12.26,996,1,1,17,264,24,-240,A
francod 2009.12.26,996,1,1,17,247,24,-223,B
Hosed 2009.08.11,1055,2,1,18,190,22,-168,A
Hosed 2009.08.11,1055,2,1,18,168,22,-146,B
kybrai 2009.12.30,862,2,0,36,215,31,-184,A
kybrai 2009.12.30,862,2,0,36,200,36,-164,B
japhet 2009.12.30,1057,2,2,41,211,32,-179,A
japhet 2009.12.30,1057,2,2,41,211,29,-182,B
smalldreams 2009.08.07,1027,1,1,8,164,12,-152,A
smalldreams 2009.08.07,1027,1,1,8,173,12,-161,B
hippyman 2009.12.22,900,4,3,52,294,23,-271,A
hippyman 2009.12.22,900,4,3,52,293,17,-276,B
nathy 2009.12.22,747,5,0.5,99,275,28,-247,A
nathy 2009.12.22,747,5,0.5,99,260,25,-235,B
Hazardo 2009.08.04,929,1,0.5,38,151,50,-101,A
Hazardo 2009.08.04,929,1,0.5,38,146,42,-104,B
Bhunt 2009.08.04,1050,1,0.5,40,203,22,-181,A
Bhunt 2009.08.04,1050,1,0.5,40,230,25,-205,B
Bhunt 2009.08.03,1049,1,1,26,240,23,-217,A
Bhunt 2009.08.03,1049,1,1,26,243,19,-224,B
Adolar 2009.08.03,1023,7,2,120,287,23,-264,A
Adolar 2009.08.03,1023,7,2,120,282,22,-260,B
EdSleazy 2009.12.17,1046,1,1,12,326,17,-309,A
EdSleazy 2009.12.17,1046,1,1,12,322,17,-305,B
Boofstrini 2009.12.17,929,1,0,11,254,9,-245,A
Boofstrini 2009.12.17,929,1,0,11,238,9,-229,B
russkime 2009.08.08,1012,1,0,12,112,42,-70,A
russkime 2009.08.08,1012,1,0,12,107,33,-74,B
byronjmilhall 2009.08.08,980,1,1,12,70,50,-20,A
byronjmilhall 2009.08.08,980,1,1,12,64,33,-31,B
japhet 2009.12.20,1086,2,2,24,191,25,-166,A
japhet 2009.12.20,1086,2,2,24,172,25,-147,B
kybrai 2009.12.20,778,2,0,29,323,24,-299,A
kybrai 2009.12.20,778,2,0,29,281,24,-257,B
Kloth 2009.12.26,987,3,3,39,68,51,-17,A
Kloth 2009.12.26,987,3,3,39,67,56,-11,B
Kloth 2009.12.26,987,3,3,39,62,54,-8,C
intellow 2009.10.06,911,1,0,22,214,23,-191,A
intellow 2009.10.06,911,1,0,22,195,23,-172,B
gobemouche 2009.10.06,966,1,1,19,239,26,-213,A
gobemouche 2009.10.06,966,1,1,19,166,21,-145,B
smalldreams 2009.08.06,1025,1,1,2,156,0,-156,A
smalldreams 2009.08.06,1025,1,1,2,166,50,-116,B
brntout 2009.08.06,947,1,0,6,265,33,-232,A
brntout 2009.08.06,947,1,0,6,263,33,-230,B
nathy 2009.12.27,718,2,0.5,15,158,27,-131,A
nathy 2009.12.27,718,2,0.5,15,186,27,-159,B
powerfail 2009.12.27,1048,1,0.5,11,131,27,-104,A
powerfail 2009.12.27,1048,1,0.5,11,136,18,-118,B
mergall 2009.12.25,1056,1,1,22,82,50,-32,A
mergall 2009.12.25,1056,1,1,22,154,50,-104,B
mergall 2009.12.25,1056,1,1,22,158,46,-112,C
Nopolis 2009.12.23,884,1,1,14,242,21,-221,A
Nopolis 2009.12.23,884,1,1,14,235,29,-206,B
farofero 2009.12.23,999,1,0,16,380,25,-355,A
farofero 2009.12.23,999,1,0,16,402,12,-390,B
Roquinho 2009.10.01,1010,1,0,5,312,0,-312,A
Roquinho 2009.10.01,1010,1,0,5,338,0,-338,B
praxodes 2009.10.01,982,1,1,5,177,40,-137,A
praxodes 2009.10.01,982,1,1,5,208,20,-188,B
stota 2009.09.29,972,2,0,67,151,33,-118,A
stota 2009.09.29,972,2,0,67,152,36,-116,B
samoancharger 2009.09.29,1024,2,2,66,108,47,-61,A
samoancharger 2009.09.29,1024,2,2,66,102,48,-54,B
kybrai 2009.12.28,848,1,0.5,16,256,25,-231,A
kybrai 2009.12.28,848,1,0.5,16,286,12,-274,B
japhet 2009.12.28,1058,1,0.5,16,301,25,-276,A
japhet 2009.12.28,1058,1,0.5,16,283,25,-258,B
ktinfl 2009.10.04,890,1,0,12,191,42,-149,A
ktinfl 2009.10.04,890,1,0,12,196,33,-163,B
silverspruce 2009.10.04,994,1,1,8,64,50,-14,A
silverspruce 2009.10.04,994,1,1,8,66,38,-28,B
Giully 2009.12.30,1020,1,1,9,112,33,-79,A
Giully 2009.12.30,1020,1,1,9,135,22,-113,B
Khotaa 2009.12.30,843,1,0,9,265,33,-232,A
Khotaa 2009.12.30,843,1,0,9,287,33,-254,B
gobemouche 2009.12.26,1013,1,1,5,116,40,-76,A
gobemouche 2009.12.26,1013,1,1,5,107,40,-67,B
gobemouche 2009.10.04,971,1,1,11,102,9,-93,A
gobemouche 2009.10.04,971,1,1,11,102,18,-84,B
intellow 2009.10.04,909,2,0,54,182,13,-169,A
intellow 2009.10.04,909,2,0,54,179,11,-168,B
nathy 2009.08.05,742,5,0,70,277,21,-256,A
nathy 2009.08.05,742,5,0,70,278,23,-255,B
holmesianman 2009.08.05,880,2,2,27,101,41,-60,A
holmesianman 2009.08.05,880,2,2,27,95,37,-58,B
nathy 2009.12.20,750,2,0.5,38,289,24,-265,A
nathy 2009.12.20,750,2,0.5,38,296,26,-270,B
charlestacda 2009.12.20,1026,1,1,14,149,21,-128,A
charlestacda 2009.12.20,1026,1,1,14,100,21,-79,B
nathy 2009.08.04,757,3,0,26,334,15,-319,A
nathy 2009.08.04,757,3,0,26,339,12,-327,B
tomys 2009.08.04,1054,2,2,13,147,15,-132,A
tomys 2009.08.04,1054,2,2,13,151,38,-113,B
Hazardo 2009.08.03,894,2,2,18,222,22,-200,A
Hazardo 2009.08.03,894,2,2,18,200,22,-178,B
Hazardo 2009.08.11,956,1,1,20,153,40,-113,A
Hazardo 2009.08.11,956,1,1,20,153,40,-113,B
ElevatorJoe 2009.08.11,1024,1,0,18,236,28,-208,A
ElevatorJoe 2009.08.11,1024,1,0,18,235,28,-207,B
badstep 2009.08.07,1064,1,0,21,146,38,-108,A
badstep 2009.08.07,1064,1,0,21,183,24,-159,B
Hazardo 2009.08.07,929,1,1,22,215,41,-174,A
Hazardo 2009.08.07,929,1,1,22,204,36,-168,B
SundanceKidIN 2009.12.25,1059,2,2,14,143,36,-107,A
SundanceKidIN 2009.12.25,1059,2,2,14,108,36,-72,B
nathy 2009.12.23,728,2,0,71,240,17,-223,A
nathy 2009.12.23,728,2,0,71,246,18,-228,B
ZAMMA 2009.12.23,1021,1,1,30,288,20,-268,A
ZAMMA 2009.12.23,1021,1,1,30,306,10,-296,B
karpovasparov 2009.12.20,919,1,1,16,260,38,-222,A
karpovasparov 2009.12.20,919,1,1,16,262,44,-218,B
KingzKill 2009.12.20,1072,1,0,14,226,36,-190,A
KingzKill 2009.12.20,1072,1,0,14,251,36,-215,B
Hazardo 2009.08.05,932,2,2,26,259,27,-232,A
Hazardo 2009.08.05,932,2,2,26,248,35,-213,B
intellow 2009.09.30,918,2,0,65,202,32,-170,A
intellow 2009.09.30,918,2,0,65,187,31,-156,B
zqnzt 2009.09.30,1071,2,2,69,240,20,-220,A
zqnzt 2009.09.30,1071,2,2,69,223,22,-201,B
markhodges 2009.07.27,1116,1,1,8,260,12,-248,A
markhodges 2009.07.27,1116,1,1,8,259,12,-247,B
ktinfl 2009.07.27,863,1,0,8,289,0,-289,A
ktinfl 2009.07.27,863,1,0,8,277,0,-277,B
stota 2009.09.23,1004,1,1,8,132,62,-70,A
stota 2009.09.23,1004,1,1,8,127,62,-65,B
Ifex 2009.09.23,953,1,0,16,282,25,-257,A
Ifex 2009.09.23,953,1,0,16,272,25,-247,B
scoroyale 2009.08.02,925,2,1.5,45,171,31,-140,A
scoroyale 2009.08.02,925,2,1.5,45,161,31,-130,B
dadoc 2009.08.02,965,1,0,15,376,27,-349,A
dadoc 2009.08.02,965,1,0,15,361,27,-334,B
mergall 2009.12.27,1074,1,1,4,186,50,-136,A
mergall 2009.12.27,1074,1,1,4,246,25,-221,B
AndyYuk 2009.08.07,935,1,1,7,139,57,-82,A
AndyYuk 2009.08.07,935,1,1,7,167,43,-124,B
Hazardo 2009.08.06,940,2,0,17,465,24,-441,A
Hazardo 2009.08.06,940,2,0,17,482,18,-464,B
badstep 2009.08.06,1045,2,2,12,169,67,-102,A
badstep 2009.08.06,1045,2,2,12,169,58,-111,B
hippyman 2009.12.21,886,3,2,31,284,19,-265,A
hippyman 2009.12.21,886,3,2,31,230,19,-211,B
dhally 2009.12.21,1104,1,0,9,215,33,-182,A
dhally 2009.12.21,1104,1,0,9,237,33,-204,B
QuantumMystic 2009.09.30,987,1,0,10,253,10,-243,A
QuantumMystic 2009.09.30,987,1,0,10,285,10,-275,B
Hazardo 2009.09.30,953,1,1,9,126,33,-93,A
Hazardo 2009.09.30,953,1,1,9,153,33,-120,B
ANDYTASTIC 2009.08.10,970,1,0,18,260,28,-232,A
ANDYTASTIC 2009.08.10,970,1,0,18,239,28,-211,B
Hazardo 2009.08.10,939,1,1,17,176,41,-135,A
Hazardo 2009.08.10,939,1,1,17,164,41,-123,B
catfu 2009.08.07,1045,1,1,6,212,67,-145,A
catfu 2009.08.07,1045,1,1,6,155,67,-88,B
ivebeenabducted 2009.08.10,995,1,1,22,254,14,-240,A
ivebeenabducted 2009.08.10,995,1,1,22,231,9,-222,B
brntout 2009.08.10,858,1,0,24,329,25,-304,A
brntout 2009.08.10,858,1,0,24,333,25,-308,B
rseymoure 2009.10.02,1063,1,0,21,142,38,-104,A
rseymoure 2009.10.02,1063,1,0,21,98,43,-55,B
HareBrain 2009.10.02,850,1,1,15,64,47,-17,A
HareBrain 2009.10.02,850,1,1,15,59,47,-12,B
Adolar 2009.08.04,909,1,1,6,99,17,-82,A
Adolar 2009.08.04,909,1,1,6,91,33,-58,B
Jia 2009.08.04,1044,1,0,6,276,0,-276,A
Jia 2009.08.04,1044,1,0,6,289,0,-289,B
remotoots 2009.08.06,970,1,1,9,38,56,18,A
remotoots 2009.08.06,970,1,1,9,42,67,25,B
ANDYTASTIC 2009.08.06,1015,1,0,9,160,22,-138,A
ANDYTASTIC 2009.08.06,1015,1,0,9,187,22,-165,B
OxoCube 2009.10.04,1066,1,1,39,157,26,-131,A
OxoCube 2009.10.04,1066,1,1,39,147,23,-124,B
catfu 2009.08.06,1039,1,1,13,126,31,-95,A
catfu 2009.08.06,1039,1,1,13,131,31,-100,B
nathy 2009.08.06,735,2,0,30,220,20,-200,A
nathy 2009.08.06,735,2,0,30,202,20,-182,B
thechrisfactor 2009.12.21,1091,1,0,12,380,33,-347,A
thechrisfactor 2009.12.21,1091,1,0,12,372,33,-339,B
egidio 2009.10.05,1085,1,1,8,132,38,-94,A
egidio 2009.10.05,1085,1,1,8,148,25,-123,B
niCeMoovez 2009.10.05,908,1,0,8,351,0,-351,A
niCeMoovez 2009.10.05,908,1,0,8,352,0,-352,B
HareBrain 2009.08.04,1001,1,0,8,347,0,-347,A
HareBrain 2009.08.04,1001,1,0,8,419,0,-419,B
ktinfl 2009.08.04,863,1,1,14,363,21,-342,A
ktinfl 2009.08.04,863,1,1,14,346,21,-325,B
kybrai 2009.12.18,799,6,1.0,59,286,24,-262,A
kybrai 2009.12.18,799,6,1.0,59,259,22,-237,B
japhet 2009.12.18,1076,6,5.0,54,267,30,-237,A
japhet 2009.12.18,1076,6,5.0,54,270,26,-244,B
Sawedoff 2009.09.22,1093,1,1,6,140,0,-140,A
Sawedoff 2009.09.22,1093,1,1,6,133,0,-133,B
Kundeohmar 2009.09.22,904,1,0,5,70,20,-50,A
Kundeohmar 2009.09.22,904,1,0,5,77,20,-57,B
Hazardo 2009.08.02,902,1,0,18,236,44,-192,A
Hazardo 2009.08.02,902,1,0,18,240,44,-196,B
beverlyframingham 2009.08.02,1095,1,1,15,158,60,-98,A
beverlyframingham 2009.08.02,1095,1,1,15,131,60,-71,B
SecondQueen 2009.08.06,1069,1,1,15,110,33,-77,A
SecondQueen 2009.08.06,1069,1,1,15,94,33,-61,B
JTKhouw 2009.08.04,949,1,1,9,80,56,-24,A
JTKhouw 2009.08.04,949,1,1,9,73,56,-17,B
fektija 2009.12.18,1020,1,1,9,157,33,-124,A
fektija 2009.12.18,1020,1,1,9,140,33,-107,B
hippyman 2009.12.18,929,3,0,37,226,32,-194,A
hippyman 2009.12.18,929,3,0,37,232,27,-205,B
SkyMeadow 2009.10.03,957,1,0,13,335,38,-297,A
SkyMeadow 2009.10.03,957,1,0,13,338,38,-300,B
HareBrain 2009.10.03,916,1,1,11,226,36,-190,A
HareBrain 2009.10.03,916,1,1,11,228,27,-201,B
stota 2009.10.01,938,1,0,18,222,22,-200,A
stota 2009.10.01,938,1,0,18,219,11,-208,B
happyelk 2009.10.01,1051,1,1,15,121,40,-81,A
happyelk 2009.10.01,1051,1,1,15,121,40,-81,B
onomatopeia 2009.10.01,1095,1,1,13,55,31,-24,A
onomatopeia 2009.10.01,1095,1,1,13,49,31,-18,B
WoodyMac 2009.10.01,893,1,0,13,106,31,-75,A
WoodyMac 2009.10.01,893,1,0,13,100,38,-62,B
onomatopeia 2009.09.27,1066,1,1,8,349,0,-349,A
onomatopeia 2009.09.27,1066,1,1,8,338,0,-338,B
nathy 2009.09.27,775,1,0,8,444,12,-432,A
nathy 2009.09.27,775,1,0,8,438,12,-426,B
kybrai 2009.12.16,891,1,0,8,203,38,-165,A
kybrai 2009.12.16,891,1,0,8,224,38,-186,B
japhet 2009.12.16,1061,1,1,11,295,27,-268,A
japhet 2009.12.16,1061,1,1,11,315,27,-288,B
xuch 2009.09.21,846,1,0,6,304,17,-287,A
xuch 2009.09.21,846,1,0,6,319,17,-302,B
sisohristov 2009.09.21,1127,1,1,5,151,40,-111,A
sisohristov 2009.09.21,1127,1,1,5,162,40,-122,B
WoodyMac 2009.10.02,855,1,1,3,161,0,-161,A
WoodyMac 2009.10.02,855,1,1,3,215,0,-215,B
lowandbehold 2009.10.02,998,1,0,5,686,0,-686,A
lowandbehold 2009.10.02,998,1,0,5,732,0,-732,B
intellow 2009.09.29,913,1,0,14,257,50,-207,A
intellow 2009.09.29,913,1,0,14,280,29,-251,B
onomatopeia 2009.09.29,1080,1,1,16,348,12,-336,A
onomatopeia 2009.09.29,1080,1,1,16,345,19,-326,B
chessboyjazz 2009.08.03,1072,1,1,5,34,60,26,A
chessboyjazz 2009.08.03,1072,1,1,5,57,40,-17,B
corrosiv 2009.09.22,972,1,1,11,242,27,-215,A
corrosiv 2009.09.22,972,1,1,11,266,18,-248,B
gobemouche 2009.09.22,1014,1,0,11,350,18,-332,A
gobemouche 2009.09.22,1014,1,0,11,328,18,-310,B
vannman 2009.12.22,1063,1,1,5,90,40,-50,A
vannman 2009.12.22,1063,1,1,5,91,40,-51,B
Loran 2009.09.29,759,1,0,15,231,27,-204,A
Loran 2009.09.29,759,1,0,15,237,27,-210,B
Acdtume 2009.09.29,1222,1,1,12,54,50,-4,A
Acdtume 2009.09.29,1222,1,1,12,47,42,-5,B
graphiboy 2009.12.10,990,1,0,17,301,18,-283,A
graphiboy 2009.12.10,990,1,0,17,274,18,-256,B
kevincollins 2009.12.10,1005,1,1,16,249,25,-224,A
kevincollins 2009.12.10,1005,1,1,16,221,25,-196,B
PieceMover 2009.09.20,1221,1,1,7,89,29,-60,A
PieceMover 2009.09.20,1221,1,1,7,109,14,-95,B
Loran 2009.09.20,740,1,0,7,171,57,-114,A
Loran 2009.09.20,740,1,0,7,191,29,-162,B
beatleeleven 2009.12.19,998,1,0,13,370,15,-355,A
beatleeleven 2009.12.19,998,1,0,13,383,8,-375,B
newscot 2009.12.19,900,1,1,10,200,40,-160,A
newscot 2009.12.19,900,1,1,10,214,40,-174,B
pets 2009.12.23,1062,1,1,37,140,22,-118,A
pets 2009.12.23,1062,1,1,37,139,32,-107,B
nathy 2009.12.19,757,1,0,8,128,25,-103,A
nathy 2009.12.19,757,1,0,8,157,12,-145,B
onexdata 2009.12.19,952,1,1,6,93,50,-43,A
onexdata 2009.12.19,952,1,1,6,75,33,-42,B
nathy 2009.08.03,763,3,0,45,264,18,-246,A
nathy 2009.08.03,763,3,0,45,273,22,-251,B
Nebri 2009.12.23,1149,1,1,11,65,46,-19,A
Nebri 2009.12.23,1149,1,1,11,67,54,-13,B
Plainzero 2009.12.23,806,1,0,11,213,36,-177,A
Plainzero 2009.12.23,806,1,0,11,142,36,-106,B
Fukiyama 2009.12.20,997,1,1,10,176,20,-156,A
Fukiyama 2009.12.20,997,1,1,10,188,20,-168,B
beatleeleven 2009.12.20,958,1,0,10,218,40,-178,A
beatleeleven 2009.12.20,958,1,0,10,240,30,-210,B
youwereromeo 2009.10.03,898,1,0,5,335,20,-315,A
youwereromeo 2009.10.03,898,1,0,5,345,20,-325,B
musick 2009.10.03,1029,1,1,4,53,50,-3,A
musick 2009.10.03,1029,1,1,4,42,75,33,B
Konta 2009.08.05,1081,1,1,8,246,12,-234,A
Konta 2009.08.05,1081,1,1,8,226,38,-188,B
holmesianman 2009.08.03,1018,1,0,12,383,17,-366,A
holmesianman 2009.08.03,1018,1,0,12,204,17,-187,B
Mnika 2009.12.22,991,1,1,16,312,38,-274,A
Mnika 2009.12.22,991,1,1,16,299,31,-268,B
blackknightwa 2009.12.20,1025,1,1,10,96,40,-56,A
blackknightwa 2009.12.20,1025,1,1,10,114,30,-84,B
schnookLberry 2009.12.20,936,1,0,10,147,40,-107,A
schnookLberry 2009.12.20,936,1,0,10,173,50,-123,B
chakmo 2009.12.22,983,1,1,23,320,26,-294,A
chakmo 2009.12.22,983,1,1,23,385,30,-355,B
Nopolis 2009.12.22,886,1,0,14,151,57,-94,A
Nopolis 2009.12.22,886,1,0,14,160,50,-110,B
andrejas 2009.08.05,1087,1,1,21,86,33,-53,A
andrejas 2009.08.05,1087,1,1,21,74,33,-41,B
Adolar 2009.08.05,903,1,0,28,188,32,-156,A
Adolar 2009.08.05,903,1,0,28,189,29,-160,B
Fukiyama 2009.12.22,1044,1,0.5,36,165,33,-132,A
Fukiyama 2009.12.22,1044,1,0.5,36,160,31,-129,B
Fukiyama 2009.12.21,982,1,1,5,83,40,-43,A
Fukiyama 2009.12.21,982,1,1,5,33,60,27,B
Kkidplayer 2009.12.21,1010,1,0,4,44,75,31,A
Kkidplayer 2009.12.21,1010,1,0,4,64,50,-14,B
chaosmonger 2009.12.21,1028,1,1,16,172,25,-147,A
chaosmonger 2009.12.21,1028,1,1,16,190,19,-171,B
Loran 2009.10.01,757,1,0,19,482,16,-466,A
Loran 2009.10.01,757,1,0,19,485,16,-469,B
corrosiv 2009.10.01,1034,1,1,18,409,17,-392,A
corrosiv 2009.10.01,1034,1,1,18,415,17,-398,B
nabisko 2009.12.18,1051,1,1,11,140,36,-104,A
nabisko 2009.12.18,1051,1,1,11,137,36,-101,B
danielbmarques 2009.12.18,1093,1,1,14,92,36,-56,A
danielbmarques 2009.12.18,1093,1,1,14,90,21,-69,B
xuch 2009.09.27,886,1,0,14,147,36,-111,A
xuch 2009.09.27,886,1,0,14,189,36,-153,B
NRking 2009.09.27,1042,1,1,14,159,36,-123,A
NRking 2009.09.27,1042,1,1,14,182,43,-139,B
adnjrw 2009.08.03,811,1,0,10,57,70,13,A
adnjrw 2009.08.03,811,1,0,10,55,70,15,B
gobemouche 2009.12.18,995,1,0,33,281,33,-248,A
gobemouche 2009.12.18,995,1,0,33,213,33,-180,B
Kkidplayer 2009.12.18,987,1,1,29,193,52,-141,A
Kkidplayer 2009.12.18,987,1,1,29,211,45,-166,B
hedgardo 2009.09.24,1075,1,1,11,173,27,-146,A
hedgardo 2009.09.24,1075,1,1,11,168,27,-141,B
nathy 2009.09.24,778,1,0,12,318,17,-301,A
nathy 2009.09.24,778,1,0,12,280,25,-255,B
nathy 2009.09.21,789,1,0,15,267,20,-247,A
nathy 2009.09.21,789,1,0,15,314,20,-294,B
kkj 2009.09.21,1007,1,1,15,306,13,-293,A
kkj 2009.09.21,1007,1,1,15,302,13,-289,B
Volodymir 2009.12.14,1102,2,2,23,181,22,-159,A
Volodymir 2009.12.14,1102,2,2,23,161,26,-135,B
hippyman 2009.12.14,863,2,0,22,275,23,-252,A
hippyman 2009.12.14,863,2,0,22,255,27,-228,B
hamaa 2009.12.20,952,1,0.5,22,481,23,-458,A
hamaa 2009.12.20,952,1,0.5,22,475,18,-457,B
happyelk 2009.09.25,1066,1,1,22,168,14,-154,A
happyelk 2009.09.25,1066,1,1,22,144,18,-126,B
BessieBoodle 2009.09.25,933,1,0,21,176,19,-157,A
BessieBoodle 2009.09.25,933,1,0,21,155,14,-141,B
maggiedog 2009.12.09,1057,1,1,4,144,50,-94,A
maggiedog 2009.12.09,1057,1,1,4,145,50,-95,B
hippyman 2009.12.09,886,2,0,33,235,27,-208,A
hippyman 2009.12.09,886,2,0,33,271,27,-244,B
elfrieda 2009.11.16,1006,1,0,11,65,54,-11,A
elfrieda 2009.11.16,1006,1,0,11,70,54,-16,B
topherpalmtree 2009.11.16,925,1,1,10,69,50,-19,A
topherpalmtree 2009.11.16,925,1,1,10,69,60,-9,B
SGTMAJUSMC 2009.11.11,898,1,1,5,23,100,77,A
SGTMAJUSMC 2009.11.11,898,1,1,5,61,60,-1,B
xXxghostxXx 2009.11.11,987,1,0,10,174,30,-144,A
xXxghostxXx 2009.11.11,987,1,0,10,179,30,-149,B
ANDYTASTIC 2009.08.03,973,3,3,49,165,33,-132,A
ANDYTASTIC 2009.08.03,973,3,3,49,166,29,-137,B
ANDYTASTIC 2009.08.02,973,1,0.5,33,144,24,-120,A
ANDYTASTIC 2009.08.02,973,1,0.5,33,138,42,-96,B
lacceroswaldo 2009.12.14,1060,1,1,25,148,36,-112,A
lacceroswaldo 2009.12.14,1060,1,1,25,140,32,-108,B
Nopolis 2009.12.14,888,2,0,43,173,30,-143,A
Nopolis 2009.12.14,888,2,0,43,175,26,-149,B
nathy 2009.09.19,771,3,2,29,243,31,-212,A
nathy 2009.09.19,771,3,2,29,241,28,-213,B
raysfan 2009.09.19,1080,2,1,19,253,21,-232,A
raysfan 2009.09.19,1080,2,1,19,240,26,-214,B
Hazardo 2009.09.25,931,1,1,10,237,0,-237,A
Hazardo 2009.09.25,931,1,1,10,230,0,-230,B
Bhunt 2009.09.25,1066,1,0,10,290,0,-290,A
Bhunt 2009.09.25,1066,1,0,10,282,0,-282,B
zqnzt 2009.12.15,1218,1,1,6,40,0,-40,A
zqnzt 2009.12.15,1218,1,1,6,39,17,-22,B
saipanislandboy 2009.12.15,696,1,0,6,193,17,-176,A
saipanislandboy 2009.12.15,696,1,0,6,191,0,-191,B
sccoach 2009.12.13,960,2,2,15,240,67,-173,A
sccoach 2009.12.13,960,2,2,15,207,53,-154,B
mergall 2009.12.13,1023,2,0,15,480,7,-473,A
mergall 2009.12.13,1023,2,0,15,412,20,-392,B
intellow 2009.09.21,988,1,0,10,180,20,-160,A
intellow 2009.09.21,988,1,0,10,182,20,-162,B
owzat 2009.09.21,928,1,1,9,41,44,3,A
owzat 2009.09.21,928,1,1,9,46,44,-2,B
mrmackenfan 2009.11.23,839,1,0,11,244,0,-244,A
mrmackenfan 2009.11.23,839,1,0,11,248,0,-248,B
Quien 2009.11.23,932,1,1,9,190,33,-157,A
Quien 2009.11.23,932,1,1,9,140,22,-118,B
Loran 2009.09.17,748,1,0,4,296,0,-296,A
Loran 2009.09.17,748,1,0,4,282,0,-282,B
nokto 2009.09.17,1071,1,1,4,9,75,66,A
nokto 2009.09.17,1071,1,1,4,0,100,100,B
southerncastle 2009.11.18,1046,1,1,4,208,50,-158,A
southerncastle 2009.11.18,1046,1,1,4,252,50,-202,B
mergall 2009.11.18,946,1,0,6,179,33,-146,A
mergall 2009.11.18,946,1,0,6,209,50,-159,B
elfrieda 2009.11.14,997,1,1,19,213,21,-192,A
elfrieda 2009.11.14,997,1,1,19,191,26,-165,B
silverspruce 2009.11.14,994,1,0,17,240,18,-222,A
silverspruce 2009.11.14,994,1,0,17,222,24,-198,B
intellow 2009.11.05,912,1,1,7,42,43,1,A
intellow 2009.11.05,912,1,1,7,59,43,-16,B
Langan 2009.11.05,1085,1,0,8,185,12,-173,A
Langan 2009.11.05,1085,1,0,8,199,12,-187,B
bigtruckrida 2009.09.23,1032,1,1,2,134,50,-84,A
bigtruckrida 2009.09.23,1032,1,1,2,123,50,-73,B
intellow 2009.09.23,955,1,0,7,546,0,-546,A
intellow 2009.09.23,955,1,0,7,549,0,-549,B
uetuseuu 2009.09.22,1019,1,0,10,238,50,-188,A
uetuseuu 2009.09.22,1019,1,0,10,241,20,-221,B
xuch 2009.09.22,821,1,1,6,138,33,-105,A
xuch 2009.09.22,821,1,1,6,122,33,-89,B
Yumster 2009.09.21,922,1,1,7,60,71,11,A
Yumster 2009.09.21,922,1,1,7,42,71,29,B
tanimachi 2009.09.21,1057,2,1,25,294,12,-282,A
tanimachi 2009.09.21,1057,2,1,25,312,8,-304,B
powerfail 2009.12.16,994,1,1,34,106,47,-59,A
powerfail 2009.12.16,994,1,1,34,101,47,-54,B
powerfail 2009.12.16,994,1,1,34,104,47,-57,C
Puscifer 2009.12.16,994,1,0,30,98,50,-48,A
Puscifer 2009.12.16,994,1,0,30,101,53,-48,B
Puscifer 2009.12.16,994,1,0,30,107,50,-57,C
mergall 2009.12.11,984,1,1,13,182,46,-136,A
mergall 2009.12.11,984,1,1,13,221,46,-175,B
Dconneen 2009.12.11,937,1,0,15,280,27,-253,A
Dconneen 2009.12.11,937,1,0,15,314,27,-287,B
mmjchess 2009.12.04,923,5,0,53,270,28,-242,A
mmjchess 2009.12.04,923,5,0,53,266,28,-238,B
Kkidplayer 2009.12.04,957,1,1,18,234,39,-195,A
Kkidplayer 2009.12.04,957,1,1,18,230,39,-191,B
uetuseuu 2009.09.23,992,1,1,14,368,43,-325,A
uetuseuu 2009.09.23,992,1,1,14,364,43,-321,B
niCeMoovez 2009.09.23,890,1,0,11,254,46,-208,A
niCeMoovez 2009.09.23,890,1,0,11,255,46,-209,B
kybrai 2009.12.17,854,1,0,28,176,29,-147,A
kybrai 2009.12.17,854,1,0,28,168,21,-147,B
japhet 2009.12.17,1067,1,1,23,123,48,-75,A
japhet 2009.12.17,1067,1,1,23,108,48,-60,B
BTX 2009.12.16,1029,1,0,12,195,8,-187,A
BTX 2009.12.16,1029,1,0,12,223,8,-215,B
Kkidplayer 2009.12.16,930,1,1,11,86,36,-50,A
Kkidplayer 2009.12.16,930,1,1,11,104,36,-68,B
lashaberulava 2009.12.09,1011,1,1,22,90,23,-67,A
lashaberulava 2009.12.09,1011,1,1,22,88,23,-65,B
Ifex 2009.09.19,1039,1,0,13,374,15,-359,A
Ifex 2009.09.19,1039,1,0,13,379,15,-364,B
Sokka 2009.09.15,1027,1,1,6,232,67,-165,A
Sokka 2009.09.15,1027,1,1,6,235,50,-185,B
nathy 2009.09.15,786,1,0,6,507,17,-490,A
nathy 2009.09.15,786,1,0,6,515,17,-498,B
kwe 2009.11.21,1036,2,1,20,322,35,-287,A
kwe 2009.11.21,1036,2,1,20,305,30,-275,B
mergall 2009.11.21,923,2,1,19,272,21,-251,A
mergall 2009.11.21,923,2,1,19,276,16,-260,B
Sawedoff 2009.09.23,1169,1,1,5,213,0,-213,A
Sawedoff 2009.09.23,1169,1,1,5,195,20,-175,B
tangelo 2009.09.23,821,1,0,9,381,33,-348,A
tangelo 2009.09.23,821,1,0,9,382,22,-360,B
notrightnow 2009.12.07,993,1,1,4,128,50,-78,A
notrightnow 2009.12.07,993,1,1,4,141,50,-91,B
ChessOwnU 2009.12.07,966,2,1,13,169,23,-146,A
ChessOwnU 2009.12.07,966,2,1,13,203,31,-172,B
nathy 2009.08.26,731,8,2,94,211,21,-190,A
nathy 2009.08.26,731,8,2,94,205,21,-184,B
Marcvz 2009.08.26,1045,1,1,10,172,30,-142,A
Marcvz 2009.08.26,1045,1,1,10,193,30,-163,B
gobemouche 2009.09.12,973,1,0,27,287,11,-276,A
gobemouche 2009.09.12,973,1,0,27,294,11,-283,B
Hazardo 2009.09.12,946,1,1,27,245,30,-215,A
Hazardo 2009.09.12,946,1,1,27,243,33,-210,B
gobemouche 2009.09.11,965,2,1,48,173,29,-144,A
gobemouche 2009.09.11,965,2,1,48,159,27,-132,B
Shridaren 2009.09.11,1005,1,1,8,82,25,-57,A
Shridaren 2009.09.11,1005,1,1,8,82,38,-44,B
Hazardo 2009.09.11,962,1,0,43,208,26,-182,A
Hazardo 2009.09.11,962,1,0,43,199,30,-169,B
TRADICIONAL 2009.09.06,1121,1,1,10,58,50,-8,A
TRADICIONAL 2009.09.06,1121,1,1,10,58,50,-8,B
Loran 2009.09.06,734,1,0,14,202,14,-188,A
Loran 2009.09.06,734,1,0,14,217,14,-203,B
lukeex 2009.12.14,1029,1,1,19,195,32,-163,A
lukeex 2009.12.14,1029,1,1,19,194,32,-162,B
Lovesin 2009.09.20,1142,1,0,4,230,25,-205,A
Lovesin 2009.09.20,1142,1,0,4,195,25,-170,B
Baskoot 2009.09.20,850,1,1,5,359,0,-359,A
Baskoot 2009.09.20,850,1,1,5,313,0,-313,B
nathy 2009.09.17,780,1,0,14,150,29,-121,A
nathy 2009.09.17,780,1,0,14,172,29,-143,B
dewie 2009.09.17,1065,1,1,13,238,31,-207,A
dewie 2009.09.17,1065,1,1,13,244,31,-213,B
chakmo 2009.12.09,951,1,0,16,294,12,-282,A
chakmo 2009.12.09,951,1,0,16,286,12,-274,B
robbienorma 2009.12.09,1045,1,1,15,223,33,-190,A
robbienorma 2009.12.09,1045,1,1,15,208,33,-175,B
chakmo 2009.12.07,947,1,1,17,287,41,-246,A
chakmo 2009.12.07,947,1,1,17,288,41,-247,B
hippyman 2009.12.07,934,2,0,44,364,27,-337,A
hippyman 2009.12.07,934,2,0,44,363,20,-343,B
azote 2009.08.03,1009,1,1,36,204,33,-171,A
azote 2009.08.03,1009,1,1,36,194,36,-158,B
MikiD 2009.12.06,961,2,2,13,71,38,-33,A
MikiD 2009.12.06,961,2,2,13,77,38,-39,B
ChessOwnU 2009.12.06,884,1,0,8,134,38,-96,A
ChessOwnU 2009.12.06,884,1,0,8,140,25,-115,B
guisbi 2009.12.07,965,2,1,34,337,29,-308,A
guisbi 2009.12.07,965,2,1,34,346,26,-320,B
Contranigma 2009.09.17,934,1,1,30,146,17,-129,A
Contranigma 2009.09.17,934,1,1,30,141,23,-118,B
mathspriyanka 2009.09.17,1060,1,0,28,121,32,-89,A
mathspriyanka 2009.09.17,1060,1,0,28,118,36,-82,B
Loran 2009.09.21,738,1,0,21,315,19,-296,A
Loran 2009.09.21,738,1,0,21,336,19,-317,B
Laskerson 2009.12.05,1031,1,1,17,319,24,-295,A
Laskerson 2009.12.05,1031,1,1,17,317,18,-299,B
hippyman 2009.12.05,905,1,0,17,260,35,-225,A
hippyman 2009.12.05,905,1,0,17,281,24,-257,B
HareBrain 2009.11.27,962,1,1,23,221,13,-208,A
HareBrain 2009.11.27,962,1,1,23,214,13,-201,B
Hempnotic 2009.11.27,997,1,0,19,265,26,-239,A
Hempnotic 2009.11.27,997,1,0,19,223,21,-202,B
duesse 2009.11.06,729,1,0,8,424,12,-412,A
duesse 2009.11.06,729,1,0,8,374,25,-349,B
planetchess 2009.11.06,1239,1,1,7,237,43,-194,A
planetchess 2009.11.06,1239,1,1,7,253,29,-224,B
tangelo 2009.09.20,849,1,0,39,336,20,-316,A
tangelo 2009.09.20,849,1,0,39,318,20,-298,B
gobemouche 2009.09.20,1014,1,1,34,226,21,-205,A
gobemouche 2009.09.20,1014,1,1,34,232,24,-208,B
SkyMeadow 2009.11.19,1112,1,1,11,393,9,-384,A
SkyMeadow 2009.11.19,1112,1,1,11,421,0,-421,B
weshoward 2009.11.19,886,1,0,16,586,19,-567,A
weshoward 2009.11.19,886,1,0,16,589,19,-570,B
SkyMeadow 2009.11.15,980,1,1,20,141,35,-106,A
SkyMeadow 2009.11.15,980,1,1,20,128,30,-98,B
Quien 2009.11.15,942,1,0,20,237,20,-217,A
Quien 2009.11.15,942,1,0,20,232,30,-202,B
Loran 2009.11.08,734,1,0,14,312,7,-305,A
Loran 2009.11.08,734,1,0,14,308,7,-301,B
pmineirov 2009.11.08,1109,1,1,12,158,42,-116,A
pmineirov 2009.11.08,1109,1,1,12,161,33,-128,B
nathy 2009.08.29,773,9,1,112,301,25,-276,A
nathy 2009.08.29,773,9,1,112,290,26,-264,B
CHIMOL 2009.08.29,958,1,1,5,407,0,-407,A
CHIMOL 2009.08.29,958,1,1,5,440,0,-440,B
nathy 2009.12.06,773,1,0,18,282,39,-243,A
nathy 2009.12.06,773,1,0,18,245,39,-206,B
Nopolis 2009.12.06,855,1,1,19,346,32,-314,A
Nopolis 2009.12.06,855,1,1,19,222,21,-201,B
gobemouche 2009.09.17,972,1,0,35,138,34,-104,A
gobemouche 2009.09.17,972,1,0,35,135,34,-101,B
stota 2009.09.17,972,2,1,48,119,25,-94,A
stota 2009.09.17,972,2,1,48,103,27,-76,B
MrWannaB 2009.09.14,942,1,1,6,30,67,37,A
MrWannaB 2009.09.14,942,1,1,6,22,83,61,B
Bhunt 2009.09.14,992,1,0,7,262,0,-262,A
Bhunt 2009.09.14,992,1,0,7,273,0,-273,B
nathy 2009.11.05,803,2,0,28,193,32,-161,A
nathy 2009.11.05,803,2,0,28,173,32,-141,B
SkyMeadow 2009.11.05,938,1,1,12,323,25,-298,A
SkyMeadow 2009.11.05,938,1,1,12,300,25,-275,B
Fukiyama 2009.12.12,1032,1,1,10,89,30,-59,A
Fukiyama 2009.12.12,1032,1,1,10,82,40,-42,B
hippyman 2009.12.12,872,1,0,12,222,33,-189,A
hippyman 2009.12.12,872,1,0,12,226,33,-193,B
SexyTime 2009.12.04,1091,2,2,14,169,36,-133,A
SexyTime 2009.12.04,1091,2,2,14,176,29,-147,B
berthusganja 2009.11.27,1081,1,1,21,388,33,-355,A
berthusganja 2009.11.27,1081,1,1,21,407,24,-383,B
fargeklatt 2009.11.27,920,2,0,28,310,29,-281,A
fargeklatt 2009.11.27,920,2,0,28,342,25,-317,B
Minkowsky 2009.11.26,1069,1,1,9,161,22,-139,A
Minkowsky 2009.11.26,1069,1,1,9,226,11,-215,B
fargeklatt 2009.11.26,922,3,1,29,313,21,-292,A
fargeklatt 2009.11.26,922,3,1,29,293,24,-269,B
stota 2009.09.14,971,1,0.5,48,172,25,-147,A
stota 2009.09.14,971,1,0.5,48,164,33,-131,B
kkj 2009.09.14,1026,1,0.5,48,175,27,-148,A
kkj 2009.09.14,1026,1,0.5,48,182,25,-157,B
Bhunt 2009.09.13,1012,1,0,17,293,12,-281,A
Bhunt 2009.09.13,1012,1,0,17,273,6,-267,B
gobemouche 2009.09.13,972,1,1,13,121,38,-83,A
gobemouche 2009.09.13,972,1,1,13,132,38,-94,B
LaurentDelaon 2009.12.09,1149,1,1,10,225,20,-205,A
LaurentDelaon 2009.12.09,1149,1,1,10,292,20,-272,B
duesse 2009.12.09,722,1,0,13,466,8,-458,A
duesse 2009.12.09,722,1,0,13,440,8,-432,B
kakenrni 2009.12.04,977,1,1,4,70,75,5,A
kakenrni 2009.12.04,977,1,1,4,50,50,0,B
jpjcalculator 2009.09.17,925,1,1,8,45,38,-7,A
jpjcalculator 2009.09.17,925,1,1,8,38,38,0,B
tangelo 2009.09.17,963,1,0,7,142,29,-113,A
tangelo 2009.09.17,963,1,0,7,143,14,-129,B
Loran 2009.09.12,724,1,0,9,249,22,-227,A
Loran 2009.09.12,724,1,0,9,259,11,-248,B
ziglag 2009.09.12,1199,1,1,8,169,25,-144,A
ziglag 2009.09.12,1199,1,1,8,157,38,-119,B
SkyMeadow 2009.11.26,1042,1,1,20,140,25,-115,A
SkyMeadow 2009.11.26,1042,1,1,20,164,25,-139,B
HareBrain 2009.11.26,951,1,0,25,303,24,-279,A
HareBrain 2009.11.26,951,1,0,25,314,24,-290,B
bluetac 2009.11.22,985,1,0,23,115,35,-80,A
bluetac 2009.11.22,985,1,0,23,131,30,-101,B
StarAsia 2009.11.22,982,1,1,21,64,33,-31,A
StarAsia 2009.11.22,982,1,1,21,72,33,-39,B
onexdata 2009.12.06,979,1,0,6,392,0,-392,A
onexdata 2009.12.06,979,1,0,6,376,0,-376,B
weshoward 2009.11.22,906,2,2,23,191,22,-169,A
weshoward 2009.11.22,906,2,2,23,193,17,-176,B
HareBrain 2009.11.22,1015,2,0,23,275,9,-266,A
HareBrain 2009.11.22,1015,2,0,23,289,9,-280,B
nathy 2009.11.09,792,6,1,61,270,23,-247,A
nathy 2009.11.09,792,6,1,61,284,21,-263,B
mawhin 2009.11.09,942,1,0,9,249,11,-238,A
mawhin 2009.11.09,942,1,0,9,242,11,-231,B
TheDuster 2009.11.11,913,1,1,18,186,22,-164,A
TheDuster 2009.11.11,913,1,1,18,182,28,-154,B
Azerath 2009.11.11,907,1,0,18,254,6,-248,A
Azerath 2009.11.11,907,1,0,18,260,11,-249,B
nathy 2009.09.18,774,1,0,17,143,24,-119,A
nathy 2009.09.18,774,1,0,17,110,29,-81,B
raysfan 2009.09.18,1017,1,1,16,36,50,14,A
raysfan 2009.09.18,1017,1,1,16,34,56,22,B
sccoach 2009.11.26,1004,2,1,21,232,29,-203,A
sccoach 2009.11.26,1004,2,1,21,241,29,-212,B
intellow 2009.11.21,966,2,0.5,61,170,31,-139,A
intellow 2009.11.21,966,2,0.5,61,162,36,-126,B
HareBrain 2009.11.21,995,2,1.5,61,168,33,-135,A
HareBrain 2009.11.21,995,2,1.5,61,161,38,-123,B
graphiboy 2009.11.09,1051,1,1,13,201,23,-178,A
graphiboy 2009.11.09,1051,1,1,13,210,23,-187,B
TheDuster 2009.10.31,894,2,1,20,162,40,-122,A
TheDuster 2009.10.31,894,2,1,20,164,35,-129,B
sccoach 2009.10.31,1070,2,1,23,263,35,-228,A
sccoach 2009.10.31,1070,2,1,23,235,30,-205,B
dadop 2009.11.02,1254,1,1,6,125,50,-75,A
dadop 2009.11.02,1254,1,1,6,122,50,-72,B
Loran 2009.11.02,737,1,0,7,286,14,-272,A
Loran 2009.11.02,737,1,0,7,281,14,-267,B
praxodes 2009.11.20,1124,1,1,61,180,33,-147,A
praxodes 2009.11.20,1124,1,1,61,180,38,-142,B
karpovasparov 2009.11.20,836,1,0,53,86,34,-52,A
karpovasparov 2009.11.20,836,1,0,53,78,42,-36,B
Admirn 2009.11.27,995,1,1,8,212,38,-174,A
Admirn 2009.11.27,995,1,1,8,223,38,-185,B
JBWALKER 2009.12.04,967,1,1,13,289,31,-258,A
JBWALKER 2009.12.04,967,1,1,13,272,31,-241,B
mergall 2009.11.29,961,1,1,11,127,18,-109,A
mergall 2009.11.29,961,1,1,11,107,18,-89,B
Phye 2009.11.29,1031,1,0,10,170,30,-140,A
Phye 2009.11.29,1031,1,0,10,141,40,-101,B
Ifex 2009.09.17,981,1,1,17,285,24,-261,A
Ifex 2009.09.17,981,1,1,17,259,24,-235,B
aixrad 2009.11.18,1015,1,1,3,154,100,-54,A
aixrad 2009.11.18,1015,1,1,3,143,67,-76,B
Kkidplayer 2009.11.18,971,1,0,5,445,20,-425,A
Kkidplayer 2009.11.18,971,1,0,5,440,20,-420,B
whowant 2009.08.29,1012,2,2,24,155,21,-134,A
whowant 2009.08.29,1012,2,2,24,162,21,-141,B
Nebri 2009.11.29,1092,1,1,9,88,56,-32,A
Nebri 2009.11.29,1092,1,1,9,90,67,-23,B
Plainzero 2009.11.29,847,1,0,10,210,10,-200,A
Plainzero 2009.11.29,847,1,0,10,211,10,-201,B
kardsplz 2009.11.26,937,1,0,30,107,40,-67,A
kardsplz 2009.11.26,937,1,0,30,111,33,-78,B
drinkingwater 2009.11.26,1029,1,1,28,77,50,-27,A
drinkingwater 2009.11.26,1029,1,1,28,76,43,-33,B
Quien 2009.11.30,942,1,1,11,275,27,-248,A
Quien 2009.11.30,942,1,1,11,261,18,-243,B
topherpalmtree 2009.11.30,914,1,0,10,190,20,-170,A
topherpalmtree 2009.11.30,914,1,0,10,167,20,-147,B
lowandbehold 2009.09.15,1012,1,1,26,237,35,-202,A
lowandbehold 2009.09.15,1012,1,1,26,234,31,-203,B
Bhunt 2009.09.15,987,1,0,28,296,25,-271,A
Bhunt 2009.09.15,987,1,0,28,254,21,-233,B
Tyzore 2009.10.28,937,2,0.5,37,147,19,-128,A
Tyzore 2009.10.28,937,2,0.5,37,145,24,-121,B
Hosed 2009.10.28,1031,2,1.5,36,75,44,-31,A
Hosed 2009.10.28,1031,2,1.5,36,81,42,-39,B
intellow 2009.08.28,1024,1,0.5,12,269,17,-252,A
intellow 2009.08.28,1024,1,0.5,12,259,17,-242,B
nathy 2009.08.28,755,5,1.5,62,317,18,-299,A
nathy 2009.08.28,755,5,1.5,62,321,19,-302,B
whowant 2009.08.27,971,3,2,45,313,36,-277,A
whowant 2009.08.27,971,3,2,45,312,27,-285,B
HareBrain 2009.08.27,917,1,0,14,247,36,-211,A
HareBrain 2009.08.27,917,1,0,14,197,36,-161,B
chessboyjazz 2009.11.25,1106,1,0.5,24,204,50,-154,A
chessboyjazz 2009.11.25,1106,1,0.5,24,219,46,-173,B
SGTMAJUSMC 2009.11.25,882,1,0.5,19,143,42,-101,A
SGTMAJUSMC 2009.11.25,882,1,0.5,19,126,37,-89,B
kardsplz 2009.11.08,994,2,0,51,193,24,-169,A
kardsplz 2009.11.08,994,2,0,51,189,22,-167,B
antharas 2009.11.08,1003,2,2,48,126,29,-97,A
antharas 2009.11.08,1003,2,2,48,122,27,-95,B
michaelhu 2009.09.04,1158,2,2,23,104,39,-65,A
michaelhu 2009.09.04,1158,2,2,23,102,43,-59,B
Loran 2009.09.04,752,2,0,27,196,19,-177,A
Loran 2009.09.04,752,2,0,27,197,26,-171,B
GaKK 2009.10.27,968,1,0,17,149,41,-108,A
GaKK 2009.10.27,968,1,0,17,157,29,-128,B
mdxp 2009.10.27,1006,2,1,29,230,31,-199,A
mdxp 2009.10.27,1006,2,1,29,231,24,-207,B
gobemouche 2009.08.28,955,2,0,21,170,24,-146,A
gobemouche 2009.08.28,955,2,0,21,171,24,-147,B
hailu 2009.08.28,961,1,1,10,79,50,-29,A
hailu 2009.08.28,961,1,1,10,71,50,-21,B
IanRemsen 2009.11.26,1085,1,0.5,17,186,29,-157,A
IanRemsen 2009.11.26,1085,1,0.5,17,191,35,-156,B
SGTMAJUSMC 2009.11.26,886,1,0.5,18,230,22,-208,A
SGTMAJUSMC 2009.11.26,886,1,0.5,18,259,22,-237,B
Sirenus 2009.09.13,1123,1,1,8,138,38,-100,A
Sirenus 2009.09.13,1123,1,1,8,198,25,-173,B
Contranigma 2009.09.13,876,1,0,10,318,20,-298,A
Contranigma 2009.09.13,876,1,0,10,350,10,-340,B
SkyMeadow 2009.11.16,984,2,2,31,269,23,-246,A
SkyMeadow 2009.11.16,984,2,2,31,266,32,-234,B
Quien 2009.11.16,920,1,0,9,674,0,-674,A
Quien 2009.11.16,920,1,0,9,653,0,-653,B
intellow 2009.11.09,934,1,1,12,272,17,-255,A
intellow 2009.11.09,934,1,1,12,282,25,-257,B
powerpass 2009.11.07,968,1,1,6,237,50,-187,A
powerpass 2009.11.07,968,1,1,6,218,50,-168,B
SkyMeadow 2009.11.07,955,1,0,8,370,12,-358,A
SkyMeadow 2009.11.07,955,1,0,8,359,12,-347,B
soffan 2009.11.05,1068,1,1,18,95,33,-62,A
soffan 2009.11.05,1068,1,1,18,90,39,-51,B
Marcvz 2009.09.07,1168,1,1,5,16,80,64,A
Marcvz 2009.09.07,1168,1,1,5,16,80,64,B
Loran 2009.09.07,731,2,0,14,221,0,-221,A
Loran 2009.09.07,731,2,0,14,207,0,-207,B
nathy 2009.09.16,783,1,0,8,365,12,-353,A
nathy 2009.09.16,783,1,0,8,407,25,-382,B
sarduspater 2009.09.16,1079,1,1,6,126,33,-93,A
sarduspater 2009.09.16,1079,1,1,6,137,33,-104,B
zEviscerator 2009.09.13,955,1,1,22,172,36,-136,A
zEviscerator 2009.09.13,955,1,1,22,174,36,-138,B
gwhatever 2009.09.13,945,1,0,23,238,22,-216,A
gwhatever 2009.09.13,945,1,0,23,233,22,-211,B
gobemouche 2009.09.10,965,1,0,9,512,0,-512,A
gobemouche 2009.09.10,965,1,0,9,526,0,-526,B
BeRelax 2009.09.10,1030,1,1,6,420,0,-420,A
BeRelax 2009.09.10,1030,1,1,6,448,0,-448,B
Gasparinho 2009.08.29,1028,2,2,28,180,36,-144,A
Gasparinho 2009.08.29,1028,2,2,28,221,32,-189,B
xDieInAFirex 2009.10.27,667,1,0,19,205,32,-173,A
xDieInAFirex 2009.10.27,667,1,0,19,209,32,-177,B
RichardJohnson 2009.10.27,1322,1,1,17,155,24,-131,A
RichardJohnson 2009.10.27,1322,1,1,17,160,24,-136,B
ironwutang 2009.08.27,841,2,1,19,256,16,-240,A
ironwutang 2009.08.27,841,2,1,19,252,21,-231,B
nathy 2009.11.17,778,1,0,19,133,21,-112,A
nathy 2009.11.17,778,1,0,19,159,21,-138,B
Phye 2009.11.17,1008,1,1,17,67,65,-2,A
Phye 2009.11.17,1008,1,1,17,78,65,-13,B
niCeMoovez 2009.10.29,902,2,1,31,288,23,-265,A
niCeMoovez 2009.10.29,902,2,1,31,254,23,-231,B
BrootFaus 2009.10.29,1003,2,1,29,324,28,-296,A
BrootFaus 2009.10.29,1003,2,1,29,322,28,-294,B
drewblastoff 2009.09.13,957,1,1,12,245,17,-228,A
drewblastoff 2009.09.13,957,1,1,12,258,17,-241,B
nathy 2009.09.13,792,1,0,13,319,38,-281,A
nathy 2009.09.13,792,1,0,13,332,38,-294,B
mergall 2009.11.17,919,1,1,8,43,62,19,A
mergall 2009.11.17,919,1,1,8,63,50,-13,B
SkyMeadow 2009.11.17,1016,1,0,9,233,22,-211,A
SkyMeadow 2009.11.17,1016,1,0,9,236,33,-203,B
Loran 2009.11.14,727,2,0,15,293,33,-260,A
Loran 2009.11.14,727,2,0,15,311,27,-284,B
hedgardo 2009.11.14,1187,2,2,12,81,42,-39,A
hedgardo 2009.11.14,1187,2,2,12,81,42,-39,B
sarduspater 2009.11.09,1037,3,3,21,227,43,-184,A
sarduspater 2009.11.09,1037,3,3,21,233,48,-185,B
timeToLive 2009.09.11,1077,1,1,14,56,21,-35,A
timeToLive 2009.09.11,1077,1,1,14,66,14,-52,B
SeanMohsin 2009.09.11,889,1,0,14,131,21,-110,A
SeanMohsin 2009.09.11,889,1,0,14,133,36,-97,B
thotthescribe 2009.09.08,1097,1,1,9,114,33,-81,A
thotthescribe 2009.09.08,1097,1,1,9,108,33,-75,B
Contranigma 2009.09.08,891,1,0,10,285,10,-275,A
Contranigma 2009.09.08,891,1,0,10,297,10,-287,B
mrdigital 2009.09.05,1177,2,2,9,93,33,-60,A
mrdigital 2009.09.05,1177,2,2,9,72,44,-28,B
Loran 2009.09.05,743,3,0,22,422,41,-381,A
Loran 2009.09.05,743,3,0,22,433,32,-401,B
LaurentDelaon 2009.09.05,1075,1,1,7,393,14,-379,A
LaurentDelaon 2009.09.05,1075,1,1,7,407,14,-393,B
nathy 2009.09.05,781,1,0,7,496,29,-467,A
nathy 2009.09.05,781,1,0,7,505,29,-476,B
mdxp 2009.10.28,1018,1,1,13,127,31,-96,A
mdxp 2009.10.28,1018,1,1,13,112,38,-74,B
SkyMeadow 2009.10.28,923,2,1,38,201,34,-167,A
SkyMeadow 2009.10.28,923,2,1,38,167,34,-133,B
joulu 2009.08.28,835,1,1,8,126,38,-88,A
joulu 2009.08.28,835,1,1,8,132,38,-94,B
Hazardo 2009.08.28,963,1,0,7,166,29,-137,A
Hazardo 2009.08.28,963,1,0,7,184,29,-155,B
mergall 2009.11.16,972,1,0,20,85,30,-55,A
mergall 2009.11.16,972,1,0,20,93,25,-68,B
drewblastoff 2009.09.11,1007,1,1,20,216,30,-186,A
drewblastoff 2009.09.11,1007,1,1,20,153,40,-113,B
niCeMoovez 2009.09.11,921,1,0,24,263,25,-238,A
niCeMoovez 2009.09.11,921,1,0,24,244,25,-219,B
jiamenguk 2009.11.12,1115,1,1,4,192,50,-142,A
jiamenguk 2009.11.12,1115,1,1,4,164,25,-139,B
BattlerV 2009.11.12,870,1,0,5,429,20,-409,A
BattlerV 2009.11.12,870,1,0,5,426,20,-406,B
Hosed 2009.11.04,1035,1,1,7,75,43,-32,A
Hosed 2009.11.04,1035,1,1,7,77,43,-34,B
SkyMeadow 2009.11.04,947,1,0,7,219,0,-219,A
SkyMeadow 2009.11.04,947,1,0,7,212,0,-212,B
ktinfl 2009.10.27,858,1,0,17,228,24,-204,A
ktinfl 2009.10.27,858,1,0,17,207,6,-201,B
biondy 2009.10.27,1019,2,1,29,195,28,-167,A
biondy 2009.10.27,1019,2,1,29,189,24,-165,B
gobemouche 2009.10.12,915,2,1,41,280,24,-256,A
gobemouche 2009.10.12,915,2,1,41,235,24,-211,B
MaximilliannKidd 2009.10.12,1056,1,1,22,194,18,-176,A
MaximilliannKidd 2009.10.12,1056,1,1,22,190,14,-176,B
fargeklatt 2009.11.14,1049,1,1,5,302,20,-282,A
fargeklatt 2009.11.14,1049,1,1,5,272,20,-252,B
ACGD 2009.11.14,888,1,0,3,127,67,-60,A
ACGD 2009.11.14,888,1,0,3,138,33,-105,B
ktinfl 2009.11.01,841,1,1,21,277,48,-229,A
ktinfl 2009.11.01,841,1,1,21,247,48,-199,B
SkyMeadow 2009.11.01,919,1,0,25,393,32,-361,A
SkyMeadow 2009.11.01,919,1,0,25,414,28,-386,B
intellow 2009.11.14,939,1,0,15,218,27,-191,A
intellow 2009.11.14,939,1,0,15,234,20,-214,B
Phye 2009.11.14,1008,1,1,15,227,13,-214,A
Phye 2009.11.14,1008,1,1,15,230,20,-210,B
tangelo 2009.09.10,934,1,0,15,189,13,-176,A
tangelo 2009.09.10,934,1,0,15,180,20,-160,B
phuziOn 2009.09.10,965,1,1,11,138,46,-92,A
phuziOn 2009.09.10,965,1,1,11,139,46,-93,B
saipanislandboy 2009.10.30,721,1,0,8,336,12,-324,A
saipanislandboy 2009.10.30,721,1,0,8,352,0,-352,B
chagf 2009.10.30,1052,1,1,8,162,25,-137,A
chagf 2009.10.30,1052,1,1,8,205,0,-205,B
bennywalsh 2009.08.30,1047,2,2,29,213,17,-196,A
bennywalsh 2009.08.30,1047,2,2,29,191,24,-167,B
nathy 2009.08.30,793,5,0,74,270,26,-244,A
nathy 2009.08.30,793,5,0,74,281,26,-255,B
MasterBelch 2009.10.20,888,1,0,16,141,12,-129,A
MasterBelch 2009.10.20,888,1,0,16,151,12,-139,B
kkj 2009.10.20,1053,1,1,15,95,40,-55,A
kkj 2009.10.20,1053,1,1,15,101,40,-61,B
kinkobel 2009.11.07,1038,1,0.5,32,209,12,-197,A
kinkobel 2009.11.07,1038,1,0.5,32,222,9,-213,B
HareBrain 2009.11.07,957,1,0.5,31,173,19,-154,A
HareBrain 2009.11.07,957,1,0.5,31,182,19,-163,B
Hazardo 2009.11.06,1029,1,1,6,174,33,-141,A
Hazardo 2009.11.06,1029,1,1,6,175,33,-142,B
intellow 2009.11.06,936,1,0,5,67,60,-7,A
intellow 2009.11.06,936,1,0,5,74,60,-14,B
drunkindurham 2009.09.07,1264,1,1,9,48,44,-4,A
drunkindurham 2009.09.07,1264,1,1,9,49,33,-16,B
ElectronTheory 2009.09.05,1153,1,1,10,385,40,-345,A
ElectronTheory 2009.09.05,1153,1,1,10,226,50,-176,B
gobemouche 2009.10.31,957,1,0.5,23,229,22,-207,A
gobemouche 2009.10.31,957,1,0.5,23,197,22,-175,B
intellow 2009.10.31,904,1,0.5,24,248,21,-227,A
intellow 2009.10.31,904,1,0.5,24,219,21,-198,B
SameerMalik 2009.09.05,1047,1,1,8,55,50,-5,A
SameerMalik 2009.09.05,1047,1,1,8,52,50,-2,B
GMenBigBlue 2009.09.05,916,1,0,8,248,0,-248,A
GMenBigBlue 2009.09.05,916,1,0,8,231,0,-231,B
whowant 2009.08.30,1011,2,2,23,171,39,-132,A
whowant 2009.08.30,1011,2,2,23,174,35,-139,B
nathy 2009.08.31,781,1,0,11,161,46,-115,A
nathy 2009.08.31,781,1,0,11,178,36,-142,B
LaurentDelaon 2009.08.31,1099,1,1,10,28,80,52,A
LaurentDelaon 2009.08.31,1099,1,1,10,31,70,39,B
gwhatever 2009.09.09,942,1,0,27,141,26,-115,A
gwhatever 2009.09.09,942,1,0,27,136,33,-103,B
sammakkon 2009.09.09,1029,1,1,27,113,37,-76,A
sammakkon 2009.09.09,1029,1,1,27,115,44,-71,B
SkyMeadow 2009.10.27,936,4,2,47,247,19,-228,A
SkyMeadow 2009.10.27,936,4,2,47,228,19,-209,B
smalldreams 2009.08.29,1099,1,1,3,86,67,-19,A
smalldreams 2009.08.29,1099,1,1,3,39,67,28,B
gobemouche 2009.10.23,980,2,1,23,118,61,-57,A
gobemouche 2009.10.23,980,2,1,23,119,44,-75,B
MasterBelch 2009.10.23,1018,2,1,22,254,36,-218,A
MasterBelch 2009.10.23,1018,2,1,22,253,27,-226,B
Giully 2009.10.27,1048,1,1,8,53,38,-15,A
Giully 2009.10.27,1048,1,1,8,46,50,4,B
pendaggie 2009.10.25,899,1,0,6,145,17,-128,A
pendaggie 2009.10.25,899,1,0,6,152,17,-135,B
asewasew 2009.10.25,1081,1,1,5,15,80,65,A
asewasew 2009.10.25,1081,1,1,5,35,60,25,B
nathy 2009.09.08,778,1,0,16,224,31,-193,A
nathy 2009.09.08,778,1,0,16,216,31,-185,B
dafics 2009.09.08,1099,1,1,13,143,8,-135,A
dafics 2009.09.08,1099,1,1,13,131,15,-116,B
mrmackenfan 2009.10.25,849,1,0,7,252,29,-223,A
mrmackenfan 2009.10.25,849,1,0,7,256,29,-227,B
sccoach 2009.10.25,1096,1,1,5,74,20,-54,A
sccoach 2009.10.25,1096,1,1,5,82,20,-62,B
soffan 2009.09.03,1033,1,0,7,56,57,1,A
soffan 2009.09.03,1033,1,0,7,70,57,-13,B
gobemouche 2009.09.03,954,1,1,13,290,23,-267,A
gobemouche 2009.09.03,954,1,1,13,315,23,-292,B
TheDuster 2009.10.29,952,1,0,11,284,9,-275,A
TheDuster 2009.10.29,952,1,0,11,270,9,-261,B
SkyMeadow 2009.10.29,914,2,1,29,198,24,-174,A
SkyMeadow 2009.10.29,914,2,1,29,182,24,-158,B
antharas 2009.10.31,987,1,1,40,140,35,-105,A
antharas 2009.10.31,987,1,1,40,148,30,-118,B
ktinfl 2009.10.31,848,1,0,41,221,27,-194,A
ktinfl 2009.10.31,848,1,0,41,202,29,-173,B
SkyMeadow 2009.10.30,916,1,1,29,101,38,-63,A
SkyMeadow 2009.10.30,916,1,1,29,92,38,-54,B
biondy 2009.10.30,1066,1,0,29,157,24,-133,A
biondy 2009.10.30,1066,1,0,29,134,31,-103,B
SkyMeadow 2009.10.21,943,2,0,20,371,10,-361,A
SkyMeadow 2009.10.21,943,2,0,20,359,10,-349,B
tanimachi 2009.10.21,1018,2,2,11,232,0,-232,A
tanimachi 2009.10.21,1018,2,2,11,224,0,-224,B
topherpalmtree 2009.10.20,815,1,1,9,19,67,48,A
topherpalmtree 2009.10.20,815,1,1,9,14,78,64,B
duesse 2009.10.20,920,1,0,11,155,27,-128,A
duesse 2009.10.20,920,1,0,11,153,27,-126,B
pendaggie 2009.10.18,957,1,0,4,386,0,-386,A
pendaggie 2009.10.18,957,1,0,4,367,0,-367,B
intellow 2009.10.18,895,1,1,4,254,25,-229,A
intellow 2009.10.18,895,1,1,4,204,25,-179,B
ironwutang 2009.08.26,999,1,0,20,261,25,-236,A
ironwutang 2009.08.26,999,1,0,20,267,25,-242,B
JooBoo 2009.08.26,986,1,1,16,147,44,-103,A
JooBoo 2009.08.26,986,1,1,16,136,44,-92,B
SkyMeadow 2009.10.31,925,1,0,23,289,22,-267,A
SkyMeadow 2009.10.31,925,1,0,23,300,22,-278,B
japhet 2009.10.31,1056,1,1,24,297,25,-272,A
japhet 2009.10.31,1056,1,1,24,311,25,-286,B
auglaize 2009.08.29,1052,1,1,10,59,50,-9,A
auglaize 2009.08.29,1052,1,1,10,65,40,-25,B
GMenBigBlue 2009.08.29,945,1,0,10,56,40,-16,A
GMenBigBlue 2009.08.29,945,1,0,10,71,40,-31,B
shailen 2009.08.27,947,1,1,11,220,46,-174,A
shailen 2009.08.27,947,1,1,11,238,36,-202,B
andrejas 2009.08.27,1028,1,0,14,431,43,-388,A
andrejas 2009.08.27,1028,1,0,14,432,21,-411,B
protoz 2009.10.15,1009,1,1,11,186,27,-159,A
protoz 2009.10.15,1009,1,1,11,197,9,-188,B
intellow 2009.10.15,905,1,0,11,219,36,-183,A
intellow 2009.10.15,905,1,0,11,208,27,-181,B
antharas 2009.10.11,955,1,1,7,135,0,-135,A
antharas 2009.10.11,955,1,1,7,125,0,-125,B
intellow 2009.10.11,916,1,0,8,130,38,-92,A
intellow 2009.10.11,916,1,0,8,121,38,-83,B
markhodges 2009.09.05,1127,1,0,24,193,29,-164,A
markhodges 2009.09.05,1127,1,0,24,202,25,-177,B
soffan 2009.09.05,844,1,1,26,286,35,-251,A
soffan 2009.09.05,844,1,1,26,270,31,-239,B
AlfredJ 2009.08.28,1080,1,1,9,87,56,-31,A
AlfredJ 2009.08.28,1080,1,1,9,81,56,-25,B
SkyMeadow 2009.10.22,915,2,0,21,288,14,-274,A
SkyMeadow 2009.10.22,915,2,0,21,308,10,-298,B
antharas 2009.10.22,1004,1,1,7,110,57,-53,A
antharas 2009.10.22,1004,1,1,7,100,43,-57,B
yanfen 2009.10.13,994,1,1,11,131,18,-113,A
yanfen 2009.10.13,994,1,1,11,111,46,-65,B
antharas 2009.10.13,978,1,0,12,179,17,-162,A
antharas 2009.10.13,978,1,0,12,174,8,-166,B
HareBrain 2009.08.29,869,2,1,36,213,19,-194,A
HareBrain 2009.08.29,869,2,1,36,229,22,-207,B
niCeMoovez 2009.10.26,903,1,0,8,248,12,-236,A
niCeMoovez 2009.10.26,903,1,0,8,238,38,-200,B
tomecki 2009.10.26,756,1,1,7,31,43,12,A
tomecki 2009.10.26,756,1,1,7,24,57,33,B
DeathKnights 2009.08.28,951,1,1,21,96,33,-63,A
DeathKnights 2009.08.28,951,1,1,21,124,29,-95,B
badstep 2009.08.28,1028,1,0,23,242,35,-207,A
badstep 2009.08.28,1028,1,0,23,223,35,-188,B
Loran 2009.09.02,743,1,0.5,13,245,23,-222,A
Loran 2009.09.02,743,1,0.5,13,276,23,-253,B
Thantos 2009.09.02,1141,1,0.5,8,108,38,-70,A
Thantos 2009.09.02,1141,1,0.5,8,108,38,-70,B
owzat 2009.10.24,997,1,1,21,366,33,-333,A
owzat 2009.10.24,997,1,1,21,373,24,-349,B
ACECAKER 2009.10.24,987,1,0,14,384,14,-370,A
ACECAKER 2009.10.24,987,1,0,14,311,29,-282,B
DrillOp 2009.10.22,960,2,1,17,293,29,-264,A
DrillOp 2009.10.22,960,2,1,17,308,24,-284,B
Demolishor 2009.10.10,900,2,0,21,215,29,-186,A
Demolishor 2009.10.10,900,2,0,21,208,29,-179,B
intellow 2009.10.10,905,2,2,17,72,35,-37,A
intellow 2009.10.10,905,2,2,17,77,35,-42,B
tdalex 2009.08.16,1080,1,1,20,114,30,-84,A
tdalex 2009.08.16,1080,1,1,20,98,30,-68,B
nathy 2009.08.16,733,1,0,22,205,14,-191,A
nathy 2009.08.16,733,1,0,22,196,23,-173,B
Musclorman 2009.08.30,884,1,1,10,442,0,-442,A
Musclorman 2009.08.30,884,1,1,10,426,0,-426,B
bgilby 2009.10.28,1043,1,0,29,244,31,-213,A
bgilby 2009.10.28,1043,1,0,29,211,34,-177,B
Sagi 2009.10.29,1051,1,1,14,211,50,-161,A
Sagi 2009.10.29,1051,1,1,14,190,50,-140,B
Hosed 2009.10.27,1020,1,1,12,160,25,-135,A
Hosed 2009.10.27,1020,1,1,12,162,25,-137,B
HareBrain 2009.10.22,959,1,1,3,193,33,-160,A
HareBrain 2009.10.22,959,1,1,3,221,33,-188,B
Enato 2009.10.13,1107,1,1,20,221,5,-216,A
Enato 2009.10.13,1107,1,1,20,235,5,-230,B
intellow 2009.10.13,881,1,0,20,314,10,-304,A
intellow 2009.10.13,881,1,0,20,296,5,-291,B
jumpinggreenfrog 2009.08.24,909,4,2,72,165,37,-128,A
jumpinggreenfrog 2009.08.24,909,4,2,72,164,39,-125,B
GoGoYubari 2009.08.24,1087,2,2,35,179,34,-145,A
GoGoYubari 2009.08.24,1087,2,2,35,187,37,-150,B
sxsonar 2009.01.13,987,1,1,25,219,28,-191,A
sxsonar 2009.01.13,987,1,1,25,221,32,-189,B
Crashinator 2009.01.13,814,1,0,22,169,27,-142,A
Crashinator 2009.01.13,814,1,0,22,156,32,-124,B
LucasKerberHara 2009.08.28,957,1,0,9,275,11,-264,A
LucasKerberHara 2009.08.28,957,1,0,9,273,11,-262,B
tomecki 2009.10.19,836,2,0,30,200,27,-173,A
tomecki 2009.10.19,836,2,0,30,198,27,-171,B
WillByron 2009.10.19,1128,2,2,29,125,45,-80,A
WillByron 2009.10.19,1128,2,2,29,117,45,-72,B
chagf 2009.10.12,999,1,1,22,139,32,-107,A
chagf 2009.10.12,999,1,1,22,137,27,-110,B
saipanislandboy 2009.10.12,942,1,0,24,218,12,-206,A
saipanislandboy 2009.10.12,942,1,0,24,209,12,-197,B
intellow 2009.10.07,899,3,2,68,237,26,-211,A
intellow 2009.10.07,899,3,2,68,228,24,-204,B
lowandbehold 2009.10.07,976,2,2,44,235,39,-196,A
lowandbehold 2009.10.07,976,2,2,44,224,39,-185,B
ironwutang 2009.08.28,828,1,1,11,256,36,-220,A
ironwutang 2009.08.28,828,1,1,11,246,36,-210,B
smalldreams 2009.08.28,1131,1,0,10,348,30,-318,A
smalldreams 2009.08.28,1131,1,0,10,343,30,-313,B
FaustArp 2009.08.28,945,1,1,12,168,17,-151,A
FaustArp 2009.08.28,945,1,1,12,164,17,-147,B
spiritswords 2009.08.22,970,3,2.0,82,89,50,-39,A
spiritswords 2009.08.22,970,3,2.0,82,82,52,-30,B
spiritswords 2009.08.22,970,3,2.0,82,78,48,-30,C
hailu 2009.08.22,953,3,1.0,84,183,37,-146,A
hailu 2009.08.22,953,3,1.0,84,161,37,-124,B
hailu 2009.08.22,953,3,1.0,84,147,33,-114,C
Loran 2009.08.23,754,2,0,18,338,6,-332,A
Loran 2009.08.23,754,2,0,18,317,11,-306,B
Tyranth 2009.08.23,1070,2,2,16,150,25,-125,A
Tyranth 2009.08.23,1070,2,2,16,163,25,-138,B
Loran 2009.08.15,756,1,0,13,174,23,-151,A
Loran 2009.08.15,756,1,0,13,174,31,-143,B
mariusmattheus 2009.08.15,1203,1,1,11,121,36,-85,A
mariusmattheus 2009.08.15,1203,1,1,11,124,36,-88,B
sammyblade 2009.08.29,1031,1,1,10,83,50,-33,A
sammyblade 2009.08.29,1031,1,1,10,99,50,-49,B
brickell 2009.08.28,902,1,0,5,264,40,-224,A
brickell 2009.08.28,902,1,0,5,261,40,-221,B
Mikemm 2009.08.28,1040,1,1,4,88,50,-38,A
Mikemm 2009.08.28,1040,1,1,4,101,50,-51,B
getit 2009.08.28,1008,1,1,16,414,12,-402,A
getit 2009.08.28,1008,1,1,16,394,12,-382,B
graphiboy 2009.10.21,1023,1,1,11,256,36,-220,A
graphiboy 2009.10.21,1023,1,1,11,230,46,-184,B
Dreamlight 2009.08.26,1048,1,1,9,125,33,-92,A
Dreamlight 2009.08.26,1048,1,1,9,130,22,-108,B
pendaggie 2009.10.23,943,1,0,6,285,0,-285,A
pendaggie 2009.10.23,943,1,0,6,254,17,-237,B
candries 2009.10.23,1042,1,1,5,378,20,-358,A
candries 2009.10.23,1042,1,1,5,385,20,-365,B
nathy 2009.10.23,806,1,0,20,279,25,-254,A
nathy 2009.10.23,806,1,0,20,275,35,-240,B
pmineirov 2009.10.23,1097,1,1,19,235,26,-209,A
pmineirov 2009.10.23,1097,1,1,19,228,21,-207,B
gobemouche 2009.10.16,947,1,0,24,273,25,-248,A
gobemouche 2009.10.16,947,1,0,24,241,29,-212,B
sandiren 2009.10.16,1048,1,1,19,196,32,-164,A
sandiren 2009.10.16,1048,1,1,19,147,26,-121,B
Demolishor 2009.10.11,923,1,0,7,258,29,-229,A
Demolishor 2009.10.11,923,1,0,7,248,14,-234,B
Kundeohmar 2009.10.11,913,1,1,5,24,40,16,A
Kundeohmar 2009.10.11,913,1,1,5,25,40,15,B
sigggih 2009.08.26,1045,1,1,19,142,42,-100,A
sigggih 2009.08.26,1045,1,1,19,144,37,-107,B
brickell 2009.08.25,883,1,0.5,46,241,37,-204,A
brickell 2009.08.25,883,1,0.5,46,248,33,-215,B
andrejas 2009.08.25,1019,1,0.5,36,123,39,-84,A
andrejas 2009.08.25,1019,1,0.5,36,128,42,-86,B
paderboots 2009.08.28,944,1,1,10,257,10,-247,A
paderboots 2009.08.28,944,1,1,10,195,20,-175,B
uetuseuu 2009.10.17,990,1,0,17,259,24,-235,A
uetuseuu 2009.10.17,990,1,0,17,262,29,-233,B
owzat 2009.10.17,979,1,1,11,140,27,-113,A
owzat 2009.10.17,979,1,1,11,138,27,-111,B
topherpalmtree 2009.10.13,900,1,0,7,80,29,-51,A
topherpalmtree 2009.10.13,900,1,0,7,98,14,-84,B
lowandbehold 2009.10.13,1028,1,1,7,126,29,-97,A
lowandbehold 2009.10.13,1028,1,1,7,125,29,-96,B
TheBlack 2009.10.21,923,1,0,5,398,0,-398,A
TheBlack 2009.10.21,923,1,0,5,431,0,-431,B
ElectronTheory 2009.10.11,1163,2,1,25,276,28,-248,A
ElectronTheory 2009.10.11,1163,2,1,25,245,32,-213,B
hautefoxx 2009.10.11,831,2,1,27,305,18,-287,A
hautefoxx 2009.10.11,831,2,1,27,291,18,-273,B
ElectronTheory 2009.10.10,1160,2,1.5,40,198,30,-168,A
ElectronTheory 2009.10.10,1160,2,1.5,40,190,35,-155,B
hautefoxx 2009.10.10,836,2,0.5,39,191,36,-155,A
hautefoxx 2009.10.10,836,2,0.5,39,180,36,-144,B
getit 2009.08.26,1007,1,1,8,126,12,-114,A
getit 2009.08.26,1007,1,1,8,116,25,-91,B
Kundeohmar 2009.10.09,893,1,0.5,8,46,25,-21,A
Kundeohmar 2009.10.09,893,1,0.5,8,45,38,-7,B
gobemouche 2009.10.09,949,1,0.5,9,159,33,-126,A
gobemouche 2009.10.09,949,1,0.5,9,157,22,-135,B
lowandbehold 2009.08.21,904,3,1,23,249,22,-227,A
lowandbehold 2009.08.21,904,3,1,23,235,22,-213,B
Bhunt 2009.08.21,1050,2,1,27,176,30,-146,A
Bhunt 2009.08.21,1050,2,1,27,191,26,-165,B
Musclorman 2009.08.20,927,2,0.5,27,327,33,-294,A
Musclorman 2009.08.20,927,2,0.5,27,321,33,-288,B
Ravacholsixneuf 2009.08.20,991,1,1,14,151,36,-115,A
Ravacholsixneuf 2009.08.20,991,1,1,14,142,43,-99,B
protoz 2009.10.10,953,1,1,9,137,33,-104,A
protoz 2009.10.10,953,1,1,9,126,33,-93,B
gobemouche 2009.10.10,927,1,0,11,230,46,-184,A
gobemouche 2009.10.10,927,1,0,11,239,46,-193,B
chagf 2009.10.20,1018,1,1,34,119,35,-84,A
chagf 2009.10.20,1018,1,1,34,116,29,-87,B
saipanislandboy 2009.10.20,785,1,0,35,190,26,-164,A
saipanislandboy 2009.10.20,785,1,0,35,182,17,-165,B
Mels 2009.08.26,1051,1,1,19,206,26,-180,A
Mels 2009.08.26,1051,1,1,19,239,21,-218,B
Loran 2009.10.09,752,1,0,18,328,11,-317,A
Loran 2009.10.09,752,1,0,18,340,6,-334,B
sandiren 2009.10.09,1057,1,1,12,98,25,-73,A
sandiren 2009.10.09,1057,1,1,12,103,25,-78,B
stota 2009.10.09,996,1,0,22,96,50,-46,A
stota 2009.10.09,996,1,0,22,89,59,-30,B
stota 2009.10.09,996,1,0,22,97,50,-47,C
tramontane 2009.10.09,1003,1,1,22,106,36,-70,A
tramontane 2009.10.09,1003,1,1,22,109,27,-82,B
tramontane 2009.10.09,1003,1,1,22,106,32,-74,C
Hazardo 2009.10.20,975,1,1,5,188,20,-168,A
Hazardo 2009.10.20,975,1,1,5,176,20,-156,B
salona 2009.10.20,1023,1,0,7,331,0,-331,A
salona 2009.10.20,1023,1,0,7,308,0,-308,B
GMenBigBlue 2009.08.26,966,1,0,7,84,71,-13,A
GMenBigBlue 2009.08.26,966,1,0,7,93,57,-36,B
LaurentDelaon 2009.08.26,1062,2,1,23,264,26,-238,A
LaurentDelaon 2009.08.26,1062,2,1,23,265,22,-243,B
TheDancingQueen 2009.08.13,835,2,0,35,346,9,-337,A
TheDancingQueen 2009.08.13,835,2,0,35,324,11,-313,B
EvilQueen 2009.08.13,1024,2,2,41,269,22,-247,A
EvilQueen 2009.08.13,1024,2,2,41,268,32,-236,B
bialyhetman 2009.10.19,1221,1,1,9,319,11,-308,A
bialyhetman 2009.10.19,1221,1,1,9,333,11,-322,B
Loran 2009.10.19,744,1,0,9,382,11,-371,A
Loran 2009.10.19,744,1,0,9,410,11,-399,B
Bhunt 2009.08.24,1005,3,0.5,31,288,23,-265,A
Bhunt 2009.08.24,1005,3,0.5,31,254,23,-231,B
gobemouche 2009.08.25,921,1,1,14,212,21,-191,A
gobemouche 2009.08.25,921,1,1,14,192,21,-171,B
Hazardo 2009.08.25,972,1,0,14,244,29,-215,A
Hazardo 2009.08.25,972,1,0,14,247,29,-218,B
Hazardo 2009.08.20,935,1,0,16,283,19,-264,A
Hazardo 2009.08.20,935,1,0,16,280,19,-261,B
samoancharger 2009.08.20,1009,1,1,14,111,36,-75,A
samoancharger 2009.08.20,1009,1,1,14,97,50,-47,B
MasterBelch 2009.10.12,975,1,0,17,457,6,-451,A
MasterBelch 2009.10.12,975,1,0,17,323,0,-323,B
alonsofer 2009.08.26,945,1,1,11,233,9,-224,A
alonsofer 2009.08.26,945,1,1,11,232,9,-223,B
andrejas 2009.08.26,1014,1,0,11,299,27,-272,A
andrejas 2009.08.26,1014,1,0,11,303,27,-276,B
GaKK 2009.10.09,996,1,0,21,85,29,-56,A
GaKK 2009.10.09,996,1,0,21,60,38,-22,B
GaKK 2009.10.09,996,1,0,21,70,33,-37,C
yuyoyu 2009.10.09,1001,1,1,21,22,62,40,A
yuyoyu 2009.10.09,1001,1,1,21,17,52,35,B
yuyoyu 2009.10.09,1001,1,1,21,13,62,49,C
pinkbunny 2009.08.22,892,2,2,26,178,38,-140,A
pinkbunny 2009.08.22,892,2,2,26,189,31,-158,B
Tyranth 2009.08.22,1068,1,0,14,270,21,-249,A
Tyranth 2009.08.22,1068,1,0,14,277,21,-256,B
paderboots 2009.08.19,874,2,1.5,31,113,39,-74,A
paderboots 2009.08.19,874,2,1.5,31,113,39,-74,B
robbienorma 2009.08.19,1080,1,0.5,14,107,50,-57,A
robbienorma 2009.08.19,1080,1,0.5,14,108,57,-51,B
reframed 2009.08.13,899,2,1,44,199,39,-160,A
reframed 2009.08.13,899,2,1,44,211,36,-175,B
OSZCAR 2009.08.13,1017,1,1,20,105,45,-60,A
OSZCAR 2009.08.13,1017,1,1,20,125,35,-90,B
CHIMOL 2009.08.25,958,1,0,21,114,33,-81,A
CHIMOL 2009.08.25,958,1,0,21,108,33,-75,B
Bhunt 2009.08.25,983,1,1,22,192,27,-165,A
Bhunt 2009.08.25,983,1,1,22,189,23,-166,B
pinkbunny 2009.08.23,926,2,0,31,222,32,-190,A
pinkbunny 2009.08.23,926,2,0,31,209,36,-173,B
ktinfl 2009.08.23,904,1,1,18,166,22,-144,A
ktinfl 2009.08.23,904,1,1,18,162,22,-140,B
DaydreamXXI 2009.08.16,977,2,0,37,131,24,-107,A
DaydreamXXI 2009.08.16,977,2,0,37,123,24,-99,B
ElevatorJoe 2009.08.16,992,9,8,94,176,40,-136,A
ElevatorJoe 2009.08.16,992,9,8,94,171,43,-128,B
Loran 2009.10.07,769,1,0,7,289,14,-275,A
Loran 2009.10.07,769,1,0,7,292,14,-278,B
pinkbunny 2009.08.21,884,1,1,29,158,45,-113,A
pinkbunny 2009.08.21,884,1,1,29,161,45,-116,B
badstep 2009.08.21,1055,2,1,34,161,35,-126,A
badstep 2009.08.21,1055,2,1,34,162,35,-127,B
TheRedSkin 2009.10.07,964,1,0,13,366,38,-328,A
TheRedSkin 2009.10.07,964,1,0,13,349,38,-311,B
LaurentDelaon 2009.08.18,1059,2,1,24,257,25,-232,A
LaurentDelaon 2009.08.18,1059,2,1,24,243,33,-210,B
pinkbunny 2009.08.18,851,3,1,35,270,20,-250,A
pinkbunny 2009.08.18,851,3,1,35,244,26,-218,B
pinkbunny 2009.08.16,931,12,2,133,267,32,-235,A
pinkbunny 2009.08.16,931,12,2,133,267,31,-236,B
AlfredJ 2009.08.18,1032,1,1,11,108,46,-62,A
AlfredJ 2009.08.18,1032,1,1,11,110,46,-64,B
russkime 2009.08.18,962,1,0,12,237,25,-212,A
russkime 2009.08.18,962,1,0,12,228,17,-211,B
samoancharger 2009.08.16,982,4,4,53,182,36,-146,A
samoancharger 2009.08.16,982,4,4,53,194,36,-158,B
sospo 2009.08.21,1034,1,0,10,255,20,-235,A
sospo 2009.08.21,1034,1,0,10,240,20,-220,B
GMenBigBlue 2009.08.21,1015,2,1,16,106,25,-81,A
GMenBigBlue 2009.08.21,1015,2,1,16,118,31,-87,B
tdalex 2009.08.24,1146,1,1,12,93,33,-60,A
tdalex 2009.08.24,1146,1,1,12,80,50,-30,B
xSnakex 2009.08.24,843,1,0,12,142,33,-109,A
xSnakex 2009.08.24,843,1,0,12,150,25,-125,B
antharas 2009.10.07,955,1,0,33,278,21,-257,A
antharas 2009.10.07,955,1,0,33,286,21,-265,B
Xoppo 2009.08.17,1073,2,2,21,291,29,-262,A
Xoppo 2009.08.17,1073,2,2,21,280,29,-251,B
pinkbunny 2009.08.17,763,5,2,57,331,21,-310,A
pinkbunny 2009.08.17,763,5,2,57,333,21,-312,B
lowandbehold 2009.08.24,876,2,1.5,32,141,50,-91,A
lowandbehold 2009.08.24,876,2,1.5,32,150,44,-106,B
pinkbunny 2009.08.19,859,1,0,18,368,28,-340,A
pinkbunny 2009.08.19,859,1,0,18,351,22,-329,B
Bhunt 2009.08.19,1047,1,1,17,330,29,-301,A
Bhunt 2009.08.19,1047,1,1,17,322,24,-298,B
graystanley 2009.08.21,898,1,0,18,181,11,-170,A
graystanley 2009.08.21,898,1,0,18,174,17,-157,B
rylruler 2009.08.17,946,1,0,25,275,24,-251,A
rylruler 2009.08.17,946,1,0,25,280,20,-260,B
wildbeal 2009.08.17,989,1,1,21,123,48,-75,A
wildbeal 2009.08.17,989,1,1,21,128,48,-80,B
Hazardo 2009.08.24,964,1,1,14,160,29,-131,A
Hazardo 2009.08.24,964,1,1,14,148,21,-127,B
ANDYTASTIC 2009.08.17,1018,1,0,11,327,27,-300,A
ANDYTASTIC 2009.08.17,1018,1,0,11,320,27,-293,B
Booyens 2009.08.17,933,1,1,9,186,22,-164,A
Booyens 2009.08.17,933,1,1,9,151,22,-129,B
AlfredJ 2009.08.23,1051,1,1,9,76,67,-9,A
AlfredJ 2009.08.23,1051,1,1,9,57,44,-13,B
joulu 2009.08.24,916,1,0,23,331,13,-318,A
joulu 2009.08.24,916,1,0,23,329,13,-316,B
terminatordude 2009.08.17,1034,1,0,6,283,17,-266,A
terminatordude 2009.08.17,1034,1,0,6,255,17,-238,B
reframed 2009.08.19,1069,1,0,17,167,29,-138,A
reframed 2009.08.19,1069,1,0,17,163,29,-134,B
telepathetic 2009.08.13,1000,1,0,17,349,18,-331,A
telepathetic 2009.08.13,1000,1,0,17,366,12,-354,B
zqnzt 2009.06.28,1017,1,0,20,154,30,-124,A
zqnzt 2009.06.28,1017,1,0,20,161,30,-131,B
LeyZ 2009.06.28,864,1,1,19,106,47,-59,A
LeyZ 2009.06.28,864,1,1,19,101,53,-48,B
reframed 2009.08.20,1066,1,0.5,12,277,33,-244,A
reframed 2009.08.20,1066,1,0.5,12,265,42,-223,B
Hazardo 2009.08.19,953,3,0,45,266,24,-242,A
Hazardo 2009.08.19,953,3,0,45,246,22,-224,B
gobemouche 2009.08.19,961,1,1,11,98,27,-71,A
gobemouche 2009.08.19,961,1,1,11,77,18,-59,B
gobemouche 2009.08.18,993,1,0,21,250,19,-231,A
gobemouche 2009.08.18,993,1,0,21,208,19,-189,B
Hazardo 2009.08.18,944,1,1,17,102,47,-55,A
Hazardo 2009.08.18,944,1,1,17,152,47,-105,B
franzgabo 2009.08.24,918,1,0,29,152,31,-121,A
franzgabo 2009.08.24,918,1,0,29,149,38,-111,B
Hazardo 2009.08.21,929,1,1,7,157,57,-100,A
Hazardo 2009.08.21,929,1,1,7,148,57,-91,B
smalldreams 2009.08.16,1084,1,0,12,206,8,-198,A
smalldreams 2009.08.16,1084,1,0,12,190,8,-182,B
TheDancingQueen 2009.08.12,867,2,0,28,451,18,-433,A
TheDancingQueen 2009.08.12,867,2,0,28,433,14,-419,B
EvilQueen 2009.08.12,1006,2,2,21,334,19,-315,A
EvilQueen 2009.08.12,1006,2,2,21,348,10,-338,B
sigggih 2009.08.22,1065,1,0,9,311,11,-300,A
sigggih 2009.08.22,1065,1,0,9,291,11,-280,B
brickell 2009.08.21,946,1,1,8,176,0,-176,A
brickell 2009.08.21,946,1,1,8,159,0,-159,B
ANDYTASTIC 2009.08.19,1012,2,2,28,211,14,-197,A
ANDYTASTIC 2009.08.19,1012,2,2,28,184,18,-166,B
lousychess 2009.08.17,1131,1,1,10,194,10,-184,A
lousychess 2009.08.17,1131,1,1,10,173,10,-163,B
DeanMartin 2009.08.18,1125,1,1,9,185,67,-118,A
DeanMartin 2009.08.18,1125,1,1,9,172,44,-128,B
TheDancingQueen 2009.08.14,781,2,0,16,416,6,-410,A
TheDancingQueen 2009.08.14,781,2,0,16,370,6,-364,B
JHennessey 2009.08.14,1208,1,1,3,211,0,-211,A
JHennessey 2009.08.14,1208,1,1,3,272,0,-272,B
Admirn 2009.08.16,967,1,0,9,263,11,-252,A
Admirn 2009.08.16,967,1,0,9,290,11,-279,B
jewhouse 2009.08.16,1001,1,1,8,184,38,-146,A
jewhouse 2009.08.16,1001,1,1,8,187,38,-149,B
smalldreams 2009.08.17,1087,1,0,11,508,9,-499,A
smalldreams 2009.08.17,1087,1,0,11,505,9,-496,B
MrFrogees 2009.08.12,1108,1,1,12,184,33,-151,A
MrFrogees 2009.08.12,1108,1,1,12,210,17,-193,B
chrcoluk 2009.08.12,868,1,0,13,333,38,-295,A
chrcoluk 2009.08.12,868,1,0,13,340,38,-302,B
Bhunt 2009.08.14,1009,1,1,28,278,43,-235,A
Bhunt 2009.08.14,1009,1,1,28,216,46,-170,B
Hazardo 2009.08.14,983,1,0,32,298,38,-260,A
Hazardo 2009.08.14,983,1,0,32,290,31,-259,B
Kleppi 2009.08.13,1034,1,0,8,237,25,-212,A
Kleppi 2009.08.13,1034,1,0,8,248,25,-223,B
aixrad 2009.08.13,939,1,1,7,98,29,-69,A
aixrad 2009.08.13,939,1,1,7,102,29,-73,B
rylruler 2009.08.13,957,1,0,23,165,39,-126,A
rylruler 2009.08.13,957,1,0,23,190,30,-160,B
ElevatorJoe 2009.08.13,998,2,1,62,168,39,-129,A
ElevatorJoe 2009.08.13,998,2,1,62,163,35,-128,B
lucasdawn 2009.08.16,906,1,0,12,239,33,-206,A
lucasdawn 2009.08.16,906,1,0,12,230,33,-197,B
ANDYTASTIC 2009.08.16,1017,1,1,7,179,29,-150,A
ANDYTASTIC 2009.08.16,1017,1,1,7,162,43,-119,B
EvilQueen 2009.08.14,1020,1,1,8,150,25,-125,A
EvilQueen 2009.08.14,1020,1,1,8,121,25,-96,B
HareBrain 2009.08.13,846,1,1,36,198,39,-159,A
HareBrain 2009.08.13,846,1,1,36,188,39,-149,B
