Name,Rating,Games,Moves,CPL,MM,Sort Score,Analysis
Michael B. Madsen,2011,1,8,96,50,-46,A
Michael B. Madsen,2011,1,8,111,50,-61,C
Michael B. Madsen,2011,1,8,102,50,-52,D
Evgeniy Najer,2606,1,9,15,78,63,B
Love Janse,2152,1,13,151,38,-113,D
Jan Plachetka,2420,1,13,153,38,-115,A
Jan Plachetka,2420,1,13,139,31,-108,C
Jan Plachetka,2420,1,13,122,38,-84,D
Love Janse,2152,1,14,162,36,-126,A
Anders Larsson,2257,1,14,22,71,49,B
Utut Adianto,2520,1,14,33,50,17,A
Utut Adianto,2520,1,14,28,71,43,B
Utut Adianto,2520,1,14,33,64,31,C
Utut Adianto,2520,1,14,43,64,21,D
Felix Nordstrom,2176,1,15,138,27,-111,B
Anneli Dalmau,2089,1,15,191,40,-151,B
Anneli Dalmau,2089,1,15,191,33,-158,C
Andreas Landgren,2164,1,16,80,50,-30,B
Haroon Azizi,2126,1,16,78,44,-34,B
Haroon Azizi,2126,1,16,75,38,-37,C
Niklas Hedlund,2037,1,16,55,50,-5,A
Niklas Hedlund,2037,1,16,66,56,-10,C
Niklas Hedlund,2037,1,16,65,56,-9,D
Vladimir Burmakin,2571,1,16,38,56,18,B
Oliver Brendel,2375,1,17,24,59,35,B
Ragnar Nystrom,2123,1,17,136,29,-107,A
Ragnar Nystrom,2123,1,17,104,29,-75,C
Ragnar Nystrom,2123,1,17,125,24,-101,D
Anders Loven,2151,1,17,71,47,-24,A
Anders Loven,2151,1,17,66,47,-19,D
Lucas Wickstrom,2115,1,17,84,53,-31,A
Lucas Wickstrom,2115,1,17,71,47,-24,C
Sergei Iskusnyh,2507,1,17,54,41,-13,B
Andrei Sokolov,2605,1,17,64,41,-23,A
Andrei Sokolov,2605,1,17,55,41,-14,B
Andrei Sokolov,2605,1,17,40,53,13,C
Andrei Sokolov,2605,1,17,40,41,1,D
Sergey Zagrebelny,2515,1,17,62,35,-27,A
Sergey Zagrebelny,2515,1,17,53,35,-18,B
Sergey Zagrebelny,2515,1,17,44,41,-3,C
Sergey Zagrebelny,2515,1,17,38,41,3,D
Vlastimil Babula,2515,1,17,102,53,-49,A
Vlastimil Babula,2515,1,17,78,53,-25,B
Vlastimil Babula,2515,1,17,86,53,-33,C
Vlastimil Babula,2515,1,17,68,53,-15,D
Tobias Lonngren,2122,1,18,100,33,-67,D
Lucas Wickstrom,2115,1,18,125,39,-86,D
John T. H. Van Der Wiel,2555,1,18,51,67,16,B
Loek Van Wely,2560,1,18,23,72,49,A
Loek Van Wely,2560,1,18,31,56,25,C
Loek Van Wely,2560,1,18,24,61,37,D
Inigo Argandona Riveiro,2396,1,18,46,44,-2,B
Joan Escofet Llongueras,1906,1,18,89,28,-61,A
Joan Escofet Llongueras,1906,1,18,115,28,-87,B
Joan Escofet Llongueras,1906,1,18,106,28,-78,C
Joan Escofet Llongueras,1906,1,18,109,33,-76,D
Thomas Ernst,2450,1,19,26,58,32,B
Tom Wedberg,2530,1,19,27,68,41,B
Tobias Lonngren,2122,1,19,69,32,-37,A
Antonio Lisarri Tomas,1961,1,19,65,53,-12,B
Kiko Sanchez Salazar,1906,1,19,108,37,-71,A
Kiko Sanchez Salazar,1906,1,19,92,32,-60,B
Kiko Sanchez Salazar,1906,1,19,100,32,-68,C
Kiko Sanchez Salazar,1906,1,19,104,32,-72,D
Diego Moral Barragan,1863,1,19,55,47,-8,A
Diego Moral Barragan,1863,1,19,53,47,-6,D
Ivo Timmermans,2178,1,20,29,75,46,B
Juan Dalmau,2059,1,20,107,20,-87,D
Santul Kosmo,2262,1,20,70,30,-40,A
Santul Kosmo,2262,1,20,75,25,-50,C
Santul Kosmo,2262,1,20,69,30,-39,D
Veselin Topalov,2645,1,20,53,55,2,B
Eduardas Rozentalis,2595,1,20,70,55,-15,A
Eduardas Rozentalis,2595,1,20,22,65,43,D
Mario Leon Fernandez,2064,1,20,84,45,-39,A
Mario Leon Fernandez,2064,1,20,90,45,-45,C
Mario Leon Fernandez,2064,1,20,104,40,-64,D
Juan Dalmau,2059,1,21,108,24,-84,A
Juan Dalmau,2059,1,21,93,19,-74,C
Erik Hedman,2336,1,21,112,48,-64,A
Erik Hedman,2336,1,21,117,67,-50,D
Gustavo Barrenechea Bahamonde,2191,1,21,49,57,8,B
Jose Miguel Ugalde Ezcurra,2215,1,21,40,62,22,B
Casimiro Ballina Amandi,2007,1,21,52,38,-14,B
Carlos Perez Marchal,2000,1,21,87,29,-58,A
Carlos Perez Marchal,2000,1,21,77,24,-53,C
Carlos Perez Marchal,2000,1,21,87,24,-63,D
Rikard Andersson,2175,1,22,85,36,-49,B
Ruslan Irzhanov,2430,1,22,35,59,24,A
Ruslan Irzhanov,2430,1,22,25,59,34,B
Ruslan Irzhanov,2430,1,22,23,59,36,C
Ruslan Irzhanov,2430,1,22,25,54,29,D
Julian M Hodgson,2590,1,22,42,54,12,A
Julian M Hodgson,2590,1,22,34,54,20,B
Julian M Hodgson,2590,1,22,28,46,18,C
Julian M Hodgson,2590,1,22,20,54,34,D
Jacek Gdanski,2505,1,22,46,50,4,A
Jacek Gdanski,2505,1,22,27,46,19,B
Jacek Gdanski,2505,1,22,27,54,27,C
Jacek Gdanski,2505,1,22,25,46,21,D
Yasser Seirawan,2585,1,22,34,54,20,A
Yasser Seirawan,2585,1,22,24,68,44,B
Yasser Seirawan,2585,1,22,27,68,41,C
Yasser Seirawan,2585,1,22,24,73,49,D
Peter Leko,2555,1,22,12,73,61,A
Peter Leko,2555,1,22,18,64,46,B
Peter Leko,2555,1,22,18,77,59,C
Peter Leko,2555,1,22,19,77,58,D
Viktor Korchnoi,2615,1,22,53,59,6,A
Viktor Korchnoi,2615,1,22,77,54,-23,B
Viktor Korchnoi,2615,1,22,71,64,-7,C
Viktor Korchnoi,2615,1,22,76,59,-17,D
Robert Kuczynski,2515,1,22,64,41,-23,B
Ian Rogers,2560,1,22,42,46,4,A
Ian Rogers,2560,1,22,40,41,1,C
Ian Rogers,2560,1,22,29,50,21,D
Ljubomir Ljubojevic,2580,1,22,26,64,38,B
Jonathan D Tisdall,2465,1,22,90,27,-63,A
Jonathan D Tisdall,2465,1,22,56,46,-10,B
Jonathan D Tisdall,2465,1,22,75,32,-43,C
Jonathan D Tisdall,2465,1,22,50,46,-4,D
Iraitz Mauleon Gutierrez,1863,1,22,136,36,-100,D
Joseba Otano Villanueva,1877,1,22,91,27,-64,C
Joseba Otano Villanueva,1877,1,22,80,23,-57,D
Ignacio Eguia Cambero,1913,1,22,50,32,-18,A
Ignacio Eguia Cambero,1913,1,22,44,32,-12,C
Ignacio Eguia Cambero,1913,1,22,52,36,-16,D
Tatiana Shumiakina,2364,1,23,70,26,-44,B
Mark E Taimanov,2406,1,23,96,48,-48,B
Maxim Kulagin,2032,1,23,85,39,-46,C
Jacob Henriksson,2161,1,23,107,26,-81,C
Per Isaksson,2106,1,23,78,48,-30,A
Per Isaksson,2106,1,23,75,48,-27,B
Per Isaksson,2106,1,23,74,48,-26,C
Per Isaksson,2106,1,23,77,48,-29,D
Valerij Popov,2547,2,23,34,57,23,C
Viacheslav Dydyshko,2510,1,23,23,65,42,B
Emir Dizdarevic,2495,1,23,49,61,12,B
Emir Dizdarevic,2495,1,23,74,61,-13,C
Emir Dizdarevic,2495,1,23,70,52,-18,D
Federico Manca,2375,1,23,90,44,-46,A
Federico Manca,2375,1,23,89,48,-41,B
Federico Manca,2375,1,23,130,39,-91,C
Federico Manca,2375,1,23,122,39,-83,D
Jiangchuan Ye,2575,1,23,72,56,-16,A
Jiangchuan Ye,2575,1,23,85,39,-46,C
Jiangchuan Ye,2575,1,23,92,39,-53,D
Spyridon Skembris,2525,1,23,52,52,0,A
Spyridon Skembris,2525,1,23,46,61,15,D
Ilia Smirin,2615,1,23,50,52,2,A
Ilia Smirin,2615,1,23,36,56,20,B
Ilia Smirin,2615,1,23,38,52,14,C
Ilia Smirin,2615,1,23,34,52,18,D
Iraitz Mauleon Gutierrez,1863,1,23,122,39,-83,A
Iraitz Mauleon Gutierrez,1863,1,23,146,39,-107,B
Iraitz Mauleon Gutierrez,1863,1,23,114,44,-70,C
Joseba Otano Villanueva,1877,1,23,119,17,-102,A
Joseba Otano Villanueva,1877,1,23,104,22,-82,B
Emilio Duran Fernandez,1799,1,23,50,48,-2,A
Emilio Duran Fernandez,1799,1,23,62,44,-18,C
Emilio Duran Fernandez,1799,1,23,52,48,-4,D
Josef Ask,2128,1,24,106,17,-89,C
Olli Sisatto,2207,1,24,46,62,16,A
Olli Sisatto,2207,1,24,55,50,-5,B
Olli Sisatto,2207,1,24,45,46,1,C
Olli Sisatto,2207,1,24,48,50,2,D
Ruslan Shcherbakov,2564,1,24,36,67,31,B
Miguel Illescas Cordoba,2590,1,24,28,62,34,B
Emir Dizdarevic,2495,1,24,64,54,-10,A
Constantin Ionescu,2465,1,24,46,50,4,A
Constantin Ionescu,2465,1,24,32,58,26,B
Constantin Ionescu,2465,1,24,38,46,8,C
Constantin Ionescu,2465,1,24,42,46,4,D
Eric Prie,2516,1,24,32,42,10,B
Irina Tetenkina,2292,1,25,60,56,-4,B
Lars Persson,2108,1,25,28,64,36,B
Hakan Hansson,2163,1,25,125,32,-93,A
Hakan Hansson,2163,1,25,113,44,-69,D
Mikael Naslund,2310,1,25,39,56,17,B
David Nygren,2158,1,25,93,36,-57,A
David Nygren,2158,1,25,84,36,-48,D
Einar Gausel,2505,1,25,29,68,39,A
Einar Gausel,2505,1,25,24,64,40,C
Einar Gausel,2505,1,25,25,64,39,D
Julio E Granda Zuniga,2620,1,25,58,48,-10,A
Julio E Granda Zuniga,2620,1,25,42,60,18,C
Julio E Granda Zuniga,2620,1,25,42,64,22,D
Petar Popovic,2530,1,25,27,68,41,B
Axel Roviralta Montero,2061,1,25,80,32,-48,D
Michael De Verdier,2147,1,26,93,50,-43,B
Pablo San Segundo Carrillo,2485,1,26,48,69,21,A
Pablo San Segundo Carrillo,2485,1,26,34,65,31,B
Pablo San Segundo Carrillo,2485,1,26,65,58,-7,C
Pablo San Segundo Carrillo,2485,1,26,75,50,-25,D
Alon Greenfeld,2610,1,26,36,69,33,A
Alon Greenfeld,2610,1,26,30,73,43,B
Alon Greenfeld,2610,1,26,32,65,33,C
Alon Greenfeld,2610,1,26,28,69,41,D
Valery A Loginov,2510,1,26,51,50,-1,D
Fernando Lopez Gracia,2348,2,26,29,58,29,B
Erik Norberg,2166,1,27,80,48,-32,A
Erik Norberg,2166,1,27,82,48,-34,B
Erik Norberg,2166,1,27,82,48,-34,C
Erik Norberg,2166,1,27,85,48,-37,D
Emil Hermansson,2370,1,27,58,52,-6,C
Erik Alquist,2106,1,27,57,56,-1,C
Erik Alquist,2106,1,27,64,56,-8,D
Joel Akesson,2344,1,27,41,37,-4,B
Torbjorn Glimbrant,2275,1,27,84,30,-54,A
Torbjorn Glimbrant,2275,1,27,93,33,-60,B
Torbjorn Glimbrant,2275,1,27,75,37,-38,C
Torbjorn Glimbrant,2275,1,27,80,37,-43,D
Evgenij Gajsin,2404,1,27,24,67,43,B
Margeir Petursson,2540,1,27,24,70,46,A
Margeir Petursson,2540,1,27,32,56,24,B
Margeir Petursson,2540,1,27,32,59,27,C
Margeir Petursson,2540,1,27,34,56,22,D
Jan H Timman,2635,1,27,73,48,-25,B
Valery A Loginov,2510,1,27,64,44,-20,A
Valery A Loginov,2510,1,27,70,48,-22,C
Jordi Magem Badals,2520,1,27,20,59,39,A
Jordi Magem Badals,2520,1,27,33,56,23,B
Jordi Magem Badals,2520,1,27,33,59,26,C
Jordi Magem Badals,2520,1,27,29,56,27,D
Axel Roviralta Montero,2061,1,27,110,26,-84,A
Axel Roviralta Montero,2061,1,27,109,26,-83,B
Axel Roviralta Montero,2061,1,27,112,30,-82,C
Erik Alquist,2106,1,28,81,61,-20,A
Evgeny Gleizerov,2592,1,28,32,57,25,B
Dmitry Bocharov,2567,1,28,27,61,34,B
Evgeny E. Vorobiov,2552,2,28,61,43,-18,B
Michael Mattsson,2048,1,29,51,45,-6,A
Michael Mattsson,2048,1,29,60,48,-12,C
Michael Mattsson,2048,1,29,61,48,-13,D
Marek Matlak,2490,1,29,56,48,-8,A
Marek Matlak,2490,1,29,44,48,4,B
Marek Matlak,2490,1,29,43,45,2,C
Marek Matlak,2490,1,29,42,45,3,D
Raouf Gadjily,2260,1,29,61,41,-20,A
Raouf Gadjily,2260,1,29,50,48,-2,B
Raouf Gadjily,2260,1,29,49,41,-8,C
Raouf Gadjily,2260,1,29,54,38,-16,D
Walter Wittmann,2390,1,29,79,48,-31,B
Walter Wittmann,2390,1,29,93,52,-41,C
Walter Wittmann,2390,1,29,94,55,-39,D
Mikhail Rytshagov,2460,1,29,41,72,31,B
Mika Karttunen,2413,1,30,14,70,56,C
Armin Namini,2114,1,30,79,37,-42,B
Armin Namini,2114,1,30,83,43,-40,C
Armin Namini,2114,1,30,76,37,-39,D
Magnus Holm,2247,1,30,53,60,7,A
Magnus Holm,2247,1,30,62,50,-12,B
Magnus Holm,2247,1,30,65,57,-8,C
Magnus Holm,2247,1,30,76,57,-19,D
Inna Agrest,2121,1,30,73,60,-13,A
Inna Agrest,2121,1,30,108,60,-48,C
Inna Agrest,2121,1,30,97,63,-34,D
Love Janse,2127,1,30,38,47,9,A
Love Janse,2127,1,30,32,53,21,C
Love Janse,2127,1,30,35,50,15,D
Alexei Shirov,2710,2,30,45,43,-2,B
Darius Ruzele,2495,1,30,48,60,12,B
Walter Wittmann,2390,1,30,76,50,-26,A
Anh Dung Nguyen,2340,1,30,54,50,-4,A
Anh Dung Nguyen,2340,1,30,41,50,9,B
Anh Dung Nguyen,2340,1,30,46,50,4,C
Anh Dung Nguyen,2340,1,30,35,63,28,D
Andrei Istratescu,2515,1,30,55,57,2,B
Mariano De Pablos Fernandez,2025,1,30,116,33,-83,A
Mariano De Pablos Fernandez,2025,1,30,112,33,-79,B
Mariano De Pablos Fernandez,2025,1,30,108,40,-68,C
Mariano De Pablos Fernandez,2025,1,30,108,37,-71,D
Adrian Leranoz Zabalza,2061,1,30,88,50,-38,B
Axel Ornstein,2426,1,31,40,48,8,B
Armin Namini,2114,1,31,99,36,-63,A
Robin Edlund,2174,1,31,39,48,9,A
Robin Edlund,2174,1,31,55,39,-16,D
Vladislav Tkachiev,2645,2,31,59,55,-4,C
Vladislav Tkachiev,2645,2,31,53,55,2,D
Boris Gelfand,2685,1,31,38,48,10,B
Lubomir Ftacnik,2570,1,31,29,52,23,A
Lubomir Ftacnik,2570,1,31,26,52,26,D
Gennadi Zaichik,2530,1,31,50,45,-5,A
Gennadi Zaichik,2530,1,31,40,55,15,B
Gennadi Zaichik,2530,1,31,42,45,3,C
Gennadi Zaichik,2530,1,31,42,48,6,D
Valerij Popov,2568,1,32,38,62,24,B
Johan Norberg,2153,1,32,134,47,-87,B
Mikko Niemi,2178,1,32,56,53,-3,B
Amir Tadjerbashi,2184,1,32,56,44,-12,A
Amir Tadjerbashi,2184,1,32,52,41,-11,C
Amir Tadjerbashi,2184,1,32,54,38,-16,D
Vladislav Tkachiev,2645,2,32,79,47,-32,A
Vladislav Tkachiev,2645,2,32,92,44,-48,B
Reynaldo Vera Gonzalez-Quevedo,2485,1,32,58,50,-8,A
Reynaldo Vera Gonzalez-Quevedo,2485,1,32,47,53,6,C
Reynaldo Vera Gonzalez-Quevedo,2485,1,32,53,56,3,D
Sergei Tiviakov,2480,1,32,27,62,35,B
Grigory Serper,2420,1,32,86,38,-48,A
Grigory Serper,2420,1,32,40,41,1,B
Grigory Serper,2420,1,32,52,38,-14,C
Grigory Serper,2420,1,32,47,38,-9,D
Vasily Yemelin,2520,1,32,77,50,-27,A
Vasily Yemelin,2520,1,32,80,47,-33,B
Vasily Yemelin,2520,1,32,94,44,-50,C
Vasily Yemelin,2520,1,32,96,47,-49,D
Peter Bjarnehag,2197,1,33,45,42,-3,A
Peter Bjarnehag,2197,1,33,49,42,-7,B
Peter Bjarnehag,2197,1,33,40,46,6,C
Peter Bjarnehag,2197,1,33,42,39,-3,D
Lasha Janjghava,2500,1,33,64,58,-6,B
Maxim Kulagin,2032,2,34,108,32,-76,A
Maxim Kulagin,2032,2,34,108,32,-76,D
Kezli Ong,2171,1,34,17,65,48,C
Evgeny Alekseev,2616,1,34,64,44,-20,B
Valeri Yandemirov,2494,1,34,86,41,-45,B
Ernesto Inarkiev,2595,1,34,14,53,39,B
Christopher Lutz,2580,1,34,63,47,-16,A
Christopher Lutz,2580,1,34,63,44,-19,B
Christopher Lutz,2580,1,34,67,47,-20,C
Christopher Lutz,2580,1,34,52,53,1,D
Hicham Hamdouchi,2530,1,34,56,53,-3,A
Hicham Hamdouchi,2530,1,34,52,59,7,D
Boris F Gulko,2590,1,34,78,47,-31,B
Oleg Korneev,2657,1,34,16,74,58,B
Alfonso Llorente Zaro,2419,1,34,20,65,45,B
Gregorio Sola Plaza,2102,1,34,75,44,-31,B
Elizabeth Riera Morilla,1983,1,34,50,41,-9,A
Elizabeth Riera Morilla,1983,1,34,56,44,-12,C
Elizabeth Riera Morilla,1983,1,34,58,41,-17,D
Mikael Naslund,2310,2,35,29,63,34,A
Mikael Naslund,2310,2,35,37,69,32,B
Mikael Naslund,2310,2,35,36,69,33,C
Mikael Naslund,2310,2,35,41,60,19,D
Henrik Lindberg,2218,1,35,35,63,28,B
Rasmus Holving,2210,1,35,46,43,-3,B
Juan Manuel Bellon Lopez,2455,1,35,38,46,8,B
Arto Satonen,2215,1,35,52,46,-6,A
Arto Satonen,2215,1,35,57,43,-14,C
Arto Satonen,2215,1,35,45,54,9,D
Viktoria Johansson,2203,1,35,40,40,0,D
Kent Angskog,2271,2,35,72,34,-38,B
Tatiana Kosintseva,2492,1,35,66,54,-12,B
Espen Agdestein,2330,1,35,51,54,3,D
Sune Berg Hansen,2440,1,35,69,43,-26,A
Sune Berg Hansen,2440,1,35,58,46,-12,B
Sune Berg Hansen,2440,1,35,73,43,-30,C
Sune Berg Hansen,2440,1,35,67,43,-24,D
Kevin Spraggett,2530,1,35,34,51,17,A
Kevin Spraggett,2530,1,35,31,57,26,C
Kevin Spraggett,2530,1,35,33,54,21,D
Vadim Zvjaginsev,2585,1,35,23,60,37,A
Vadim Zvjaginsev,2585,1,35,18,66,48,C
Vadim Zvjaginsev,2585,1,35,20,54,34,D
Edvins Kengis,2580,1,35,41,54,13,C
Edvins Kengis,2580,1,35,32,49,17,D
Antonio Lisarri Tomas,1961,2,35,76,37,-39,A
Antonio Lisarri Tomas,1961,2,35,71,43,-28,C
Antonio Lisarri Tomas,1961,2,35,68,46,-22,D
Sergio Anguas Fanlo,2048,1,35,46,49,3,A
Sergio Anguas Fanlo,2048,1,35,45,46,1,B
Sergio Anguas Fanlo,2048,1,35,51,51,0,C
Sergio Anguas Fanlo,2048,1,35,52,43,-9,D
Erno Dede,2275,1,36,145,56,-89,B
Viktoria Johansson,2203,1,36,46,42,-4,A
Viktoria Johansson,2203,1,36,35,50,15,B
Viktoria Johansson,2203,1,36,41,44,3,C
Espen Agdestein,2330,1,36,72,42,-30,A
Espen Agdestein,2330,1,36,57,44,-13,B
Espen Agdestein,2330,1,36,70,44,-26,C
Vadim Milov,2565,1,36,44,42,-2,A
Vadim Milov,2565,1,36,31,50,19,B
Vadim Milov,2565,1,36,36,58,22,C
Vadim Milov,2565,1,36,37,56,19,D
Edvins Kengis,2580,1,36,35,56,21,A
Smbat G Lputian,2590,1,36,68,39,-29,A
Smbat G Lputian,2590,1,36,58,39,-19,B
Smbat G Lputian,2590,1,36,54,44,-10,C
Smbat G Lputian,2590,1,36,54,42,-12,D
Viktoria Bashkite,2138,1,37,52,35,-17,A
Viktoria Bashkite,2138,1,37,53,38,-15,B
Viktoria Bashkite,2138,1,37,48,49,1,C
Viktoria Bashkite,2138,1,37,55,38,-17,D
Jan Peter Palmblad,2187,1,37,117,30,-87,B
Jesper Celander,2180,1,37,56,46,-10,B
Lennart Evertsson,2198,1,37,74,43,-31,B
Alexey Kuzmin,2567,1,37,39,57,18,B
Artur Yusupov,2655,2,37,77,38,-39,B
Leonid Yurtaev,2530,1,37,48,49,1,A
Leonid Yurtaev,2530,1,37,45,49,4,C
Leonid Yurtaev,2530,1,37,43,46,3,D
Lembit Oll,2475,1,37,25,70,45,B
Vladislav Nevednichy,2470,1,37,57,38,-19,A
Vladislav Nevednichy,2470,1,37,49,38,-11,B
Vladislav Nevednichy,2470,1,37,48,40,-8,C
Vladislav Nevednichy,2470,1,37,45,46,1,D
Miguel Illescas Cordoba,2620,2,37,48,65,17,B
Ahmed Tarek Fahmy Moursy,1883,1,37,54,43,-11,A
Ahmed Tarek Fahmy Moursy,1883,1,37,62,51,-11,C
Ahmed Tarek Fahmy Moursy,1883,1,37,67,51,-16,D
Tomi Nyback,2458,1,38,125,47,-78,B
Jacob Henriksson,2161,2,38,69,53,-16,A
Jacob Henriksson,2161,2,38,71,42,-29,D
Bo Adler,2208,1,38,54,55,1,B
Jon L Arnason,2525,1,38,25,63,38,B
Vidmantas Malisauskas,2510,1,38,16,63,47,A
Vidmantas Malisauskas,2510,1,38,20,58,38,B
Vidmantas Malisauskas,2510,1,38,15,66,51,C
Vidmantas Malisauskas,2510,1,38,12,68,56,D
Joel Lautier,2645,2,38,27,58,31,B
Amador Rodriguez Cepedes,2515,1,38,19,71,52,A
Amador Rodriguez Cepedes,2515,1,38,19,68,49,B
Amador Rodriguez Cepedes,2515,1,38,21,71,50,C
Amador Rodriguez Cepedes,2515,1,38,22,63,41,D
Viktor Bologan,2600,1,38,20,58,38,A
Viktor Bologan,2600,1,38,22,60,38,B
Viktor Bologan,2600,1,38,28,53,25,C
Viktor Bologan,2600,1,38,27,58,31,D
Igor Miladinovic,2350,1,38,39,53,14,A
Igor Miladinovic,2350,1,38,37,50,13,B
Igor Miladinovic,2350,1,38,35,50,15,C
Igor Miladinovic,2350,1,38,42,47,5,D
Javier Ignacio Esparza Martinez,2047,1,38,36,63,27,A
Javier Ignacio Esparza Martinez,2047,1,38,44,60,16,C
Javier Ignacio Esparza Martinez,2047,1,38,51,55,4,D
Felix Nordstrom,2176,2,39,79,36,-43,A
Felix Nordstrom,2176,2,39,71,46,-25,C
Felix Nordstrom,2176,2,39,64,49,-15,D
Pontus Carlsson,2501,2,39,60,41,-19,B
Erling Mortensen,2500,1,39,48,56,8,B
Iker Iraneta Unzue,1812,1,39,29,59,30,B
Viktoria Johansson,2142,1,40,60,52,-8,B
Peter Carlsten,2159,1,40,69,32,-37,B
Peter Carlsten,2159,1,40,80,25,-55,C
Olav Sepp,2470,1,40,81,40,-41,A
Olav Sepp,2470,1,40,72,38,-34,B
Olav Sepp,2470,1,40,67,35,-32,C
Olav Sepp,2470,1,40,67,40,-27,D
Jamshed Isaev,2380,1,40,66,40,-26,A
Jamshed Isaev,2380,1,40,50,40,-10,B
Jamshed Isaev,2380,1,40,44,38,-6,C
Jamshed Isaev,2380,1,40,44,38,-6,D
Alejandra Porras Mateo,1875,2,40,142,35,-107,A
Alejandra Porras Mateo,1875,2,40,116,37,-79,B
Alejandra Porras Mateo,1875,2,40,112,45,-67,C
Alejandra Porras Mateo,1875,2,40,116,48,-68,D
Antonio Labena Bernal,2003,1,40,45,50,5,B
Christian Bauer,2585,1,40,15,65,50,C
Lars Persson,2108,2,41,78,51,-27,A
Lars Persson,2108,2,41,78,49,-29,C
Lars Persson,2108,2,41,70,54,-16,D
Anneli Dalmau,2089,2,41,108,49,-59,A
Anneli Dalmau,2089,2,41,98,51,-47,D
Terry Toh,2300,1,41,57,37,-20,D
Nasib Ginting,2395,1,41,58,51,-7,D
David Arjol Echeverria,2073,1,41,74,51,-23,B
Denis Khismatullin,2537,1,42,55,74,19,B
Sergey Ivanov,2546,1,42,34,36,2,B
Vladimir Dimitrov,2475,1,42,26,64,38,A
Vladimir Dimitrov,2475,1,42,42,60,18,B
Vladimir Dimitrov,2475,1,42,40,67,27,C
Vladimir Dimitrov,2475,1,42,41,67,26,D
Nasib Ginting,2395,1,42,64,50,-14,B
Nasib Ginting,2395,1,42,59,64,5,C
Jonas Barkhagen,2458,2,43,26,67,41,B
Haroon Azizi,2126,2,43,86,46,-40,D
Alain Spielmann,2308,1,43,24,67,43,B
Terry Toh,2300,1,43,42,54,12,A
Terry Toh,2300,1,43,42,44,2,B
Terry Toh,2300,1,43,47,49,2,C
Pablo Ricardi,2495,1,43,29,46,17,A
Pablo Ricardi,2495,1,43,27,54,27,B
Pablo Ricardi,2495,1,43,26,63,37,C
Pablo Ricardi,2495,1,43,30,56,26,D
Nasib Ginting,2395,1,43,81,51,-30,A
Ivan Salgado Lopez,2425,1,43,24,63,39,B
Alexander Morozevich,2747,2,43,35,63,28,B
Aleksa Strikovic,2535,2,43,37,49,12,B
Ralph Hallerod,2105,2,44,109,34,-75,A
Ralph Hallerod,2105,2,44,120,30,-90,B
Ralph Hallerod,2105,2,44,112,30,-82,C
Ralph Hallerod,2105,2,44,116,36,-80,D
Christopher Lissang,2080,1,44,36,52,16,B
Denis Yevseev,2580,1,44,32,54,22,B
Andrei Belozerov,2552,1,44,24,54,30,B
Valery A Loginov,2516,1,44,27,57,30,B
Joel Benjamin,2610,1,44,46,54,8,D
Haroon Azizi,2126,2,45,91,33,-58,A
Hannes Stefansson,2566,2,45,16,67,51,C
Mikael Jonsson,2290,1,45,89,51,-38,D
Evgenij Agrest,2535,3,45,36,40,4,B
Erik Blomqvist,2302,2,45,37,60,23,B
Johan Furhoff,2392,1,45,59,44,-15,B
Joel Benjamin,2610,1,45,49,51,2,A
Joel Benjamin,2610,1,45,55,44,-11,C
Daniel H. Campora,2560,1,45,26,62,36,D
Heikki M. J. Westerinen,2370,1,45,27,51,24,C
Heikki M. J. Westerinen,2370,1,45,25,49,24,D
Alex Yermolinsky,2590,1,45,17,53,36,C
Alex Yermolinsky,2590,1,45,17,60,43,D
Mikael Jonsson,2290,1,46,94,46,-48,A
Kevin Ong,2076,1,46,39,56,17,C
Kevin Ong,2076,1,46,44,54,10,D
Alexander Riazantsev,2556,1,46,38,56,18,B
Daniel H. Campora,2560,1,46,32,59,27,C
Alex Yermolinsky,2590,1,46,13,65,52,B
Walter Arencibia Rodriguez,2480,1,46,19,59,40,A
Walter Arencibia Rodriguez,2480,1,46,21,54,33,B
Walter Arencibia Rodriguez,2480,1,46,23,61,38,C
Walter Arencibia Rodriguez,2480,1,46,23,59,36,D
Mikel Huerga Leache,2315,2,46,52,63,11,B
Harriet V Hunt,2389,1,47,20,64,44,C
Kevin Ong,2076,1,47,73,45,-28,A
Fredrik Andersson,2229,2,47,101,32,-69,B
Simon Hanninger,2129,1,47,30,49,19,B
Vladimir P Malaniuk,2610,2,47,71,47,-24,A
Vladimir P Malaniuk,2610,2,47,70,49,-21,B
Vladimir P Malaniuk,2610,2,47,74,47,-27,C
Vladimir P Malaniuk,2610,2,47,71,47,-24,D
Lars Bo Hansen,2545,2,47,36,51,15,B
Alexander Morozevich,2575,2,47,43,60,17,C
Vladimir Kramnik,2725,1,47,21,64,43,B
Daniel H. Campora,2560,1,47,39,55,16,A
Heikki M. J. Westerinen,2370,1,47,33,43,10,A
Heikki M. J. Westerinen,2370,1,47,27,40,13,B
Alex Yermolinsky,2590,1,47,17,62,45,A
Pontus Carlsson,2501,3,48,48,56,8,C
Teodor Hellborg,2240,1,49,32,59,27,B
Tomi Nyback,2579,1,49,24,55,31,B
Marc Santo-Roman,2420,2,49,62,59,-3,A
Marc Santo-Roman,2420,2,49,49,61,12,B
Marc Santo-Roman,2420,2,49,69,55,-14,C
Marc Santo-Roman,2420,2,49,69,59,-10,D
Andrei Istratescu,2515,2,49,50,59,9,A
Andrei Istratescu,2515,2,49,40,55,15,C
Andrei Istratescu,2515,2,49,36,57,21,D
Josef Ask,2128,2,50,80,36,-44,D
Jonas Lundvik,2270,1,50,45,58,13,B
Jesper Celander,2180,2,50,87,40,-47,D
Ellinor Frisk,2109,1,50,112,36,-76,D
Lev Psakhis,2615,1,50,49,42,-7,A
Lev Psakhis,2615,1,50,49,42,-7,B
Lev Psakhis,2615,1,50,44,42,-2,C
Lev Psakhis,2615,1,50,43,50,7,D
Casimiro Ballina Amandi,2007,2,50,63,32,-31,A
Casimiro Ballina Amandi,2007,2,50,42,42,0,C
Casimiro Ballina Amandi,2007,2,50,47,44,-3,D
Pedro Vinal Gutierrez,2165,2,50,55,46,-9,A
Pedro Vinal Gutierrez,2165,2,50,65,38,-27,B
Pedro Vinal Gutierrez,2165,2,50,67,46,-21,C
Pedro Vinal Gutierrez,2165,2,50,68,42,-26,D
Daniel Zamarbide Inarrea,2015,1,50,40,30,-10,B
Thomas Ernst,2450,2,51,25,61,36,C
Mark E Taimanov,2406,2,51,47,57,10,C
Ellinor Frisk,2109,1,51,107,43,-64,A
Michael De Verdier,2147,2,51,100,41,-59,A
Michael De Verdier,2147,2,51,100,41,-59,C
Michael De Verdier,2147,2,51,100,43,-57,D
Alexander Lastin,2622,2,51,75,55,-20,C
Jon L Arnason,2525,2,51,31,61,30,A
Jon L Arnason,2525,2,51,20,71,51,C
Jon L Arnason,2525,2,51,22,69,47,D
Zbynek Hracek,2530,1,51,31,53,22,A
Zbynek Hracek,2530,1,51,35,49,14,B
Zbynek Hracek,2530,1,51,38,41,3,C
Zbynek Hracek,2530,1,51,35,41,6,D
John T. H. Van Der Wiel,2555,2,51,37,59,22,D
Jacob Aagaard,2355,1,52,27,62,35,C
Josef Ask,2128,2,52,104,37,-67,A
Jesper Celander,2180,2,52,79,40,-39,C
Josef Ask,2235,2,52,57,54,-3,C
Valerij Filippov,2639,1,52,31,58,27,B
Viacheslav Dydyshko,2510,2,52,50,40,-10,A
Viacheslav Dydyshko,2510,2,52,35,48,13,C
Viacheslav Dydyshko,2510,2,52,32,46,14,D
Robert Huebner,2605,1,52,8,69,61,D
John T. H. Van Der Wiel,2555,2,52,43,56,13,C
Peter Carlsten,2159,2,53,90,34,-56,A
Peter Carlsten,2159,2,53,84,26,-58,D
Gustavo Luna,2143,1,53,54,43,-11,D
Per Soderberg,2205,1,53,47,55,8,C
Tobias Pettersson,2159,1,53,45,45,0,A
Tobias Pettersson,2159,1,53,45,51,6,B
Tobias Pettersson,2159,1,53,40,51,11,C
Tobias Pettersson,2159,1,53,37,55,18,D
Alberto David,2425,1,53,56,49,-7,D
Robert Huebner,2605,1,53,13,68,55,A
Robert Huebner,2605,1,53,13,68,55,B
Robert Huebner,2605,1,53,12,74,62,C
Zigurds Lanka,2540,2,53,74,34,-40,A
Zigurds Lanka,2540,2,53,41,40,-1,B
Zigurds Lanka,2540,2,53,42,42,0,C
Zigurds Lanka,2540,2,53,34,43,9,D
John T. H. Van Der Wiel,2555,2,53,49,51,2,A
Nikolay Nazarov,2256,1,54,44,39,-5,B
Alberto David,2425,1,54,44,59,15,B
Alberto David,2425,1,54,56,52,-4,C
Branko Damljanovic,2505,1,54,59,48,-11,B
Lajos Portisch,2610,1,54,37,57,20,A
Lajos Portisch,2610,1,54,26,57,31,B
Lajos Portisch,2610,1,54,28,57,29,C
Lajos Portisch,2610,1,54,32,59,27,D
Juan Mario Gomez Esteban,2486,1,54,42,54,12,B
Jesper Celander,2180,2,55,64,47,-17,A
Alberto David,2425,1,55,55,47,-8,A
Johann Hjartarson,2585,1,55,44,54,10,B
Javier B. Campos Moreno,2445,1,55,19,67,48,D
Vasil Spasov,2525,2,55,33,65,32,B
Gustavo Luna,2143,1,56,46,39,-7,C
Sergei Yudin,2425,3,56,47,59,12,C
Javier B. Campos Moreno,2445,1,56,17,73,56,C
Manuel Perez Candelario,2496,2,56,63,46,-17,B
Johan Furhoff,2302,2,57,65,58,-7,B
Henrik Lindberg,2218,2,57,48,53,5,A
Henrik Lindberg,2218,2,57,42,60,18,C
Henrik Lindberg,2218,2,57,44,61,17,D
Giorgi Giorgadze,2565,2,57,66,56,-10,A
Giorgi Giorgadze,2565,2,57,51,51,0,B
Giorgi Giorgadze,2565,2,57,48,54,6,C
Giorgi Giorgadze,2565,2,57,49,53,4,D
Javier B. Campos Moreno,2445,1,57,19,68,49,A
Inigo Montoya Irigoyen,2064,2,57,59,44,-15,A
Inigo Montoya Irigoyen,2064,2,57,51,40,-11,B
Inigo Montoya Irigoyen,2064,2,57,55,44,-11,C
Inigo Montoya Irigoyen,2064,2,57,54,44,-10,D
Imanol Martinez Salas,1956,2,57,68,46,-22,C
Gustavo Luna,2143,1,58,35,52,17,A
Gustavo Luna,2143,1,58,38,48,10,B
Artur Yusupov,2655,3,58,58,34,-24,C
Robert Kuczynski,2515,2,58,48,41,-7,C
Vassily Ivanchuk,2695,3,58,28,59,31,C
Bogdan Lalic,2500,1,58,44,57,13,C
Imanol Martinez Salas,1956,2,58,72,48,-24,B
Johan Henriksson,2197,2,59,65,49,-16,B
Carlo Marzano,2213,2,59,98,37,-61,A
Carlo Marzano,2213,2,59,88,41,-47,C
Carlo Marzano,2213,2,59,86,44,-42,D
Rikard Andersson,2175,2,60,56,50,-6,D
Tamas Ruck,2343,1,60,38,55,17,B
Dmitry Jakovenko,2582,1,60,25,63,38,B
Eric Lobron,2580,2,60,44,43,-1,A
Eric Lobron,2580,2,60,36,52,16,B
Eric Lobron,2580,2,60,39,50,11,C
Eric Lobron,2580,2,60,36,57,21,D
Dorian Rogozenco,2557,2,60,37,68,31,C
Dorian Rogozenco,2557,2,60,40,67,27,D
Santiago Gonzalez De La Torre,2357,2,60,85,43,-42,B
Claude Landenbergue,2446,1,60,20,50,30,B
Mikael Aroven,2201,2,61,60,43,-17,C
Sergey I. Solovjov,2458,1,61,32,54,22,B
Dorian Rogozenco,2557,2,61,40,67,27,A
Dorian Rogozenco,2557,2,61,36,64,28,B
Dmitry Jakovenko,2671,1,61,18,64,46,C
Gregorio Sola Plaza,2102,2,61,59,43,-16,D
Alexander Rustemov,2593,2,62,50,42,-8,B
Jun Xu,2560,2,62,38,58,20,D
Sergei Tiviakov,2480,2,62,49,63,14,D
Gregorio Sola Plaza,2102,2,62,67,44,-23,A
Gregorio Sola Plaza,2102,2,62,71,47,-24,C
Rikard Andersson,2175,2,63,62,46,-16,C
Tommi Luukkonen,2081,2,63,47,49,2,B
Pia Cramling,2524,2,63,23,54,31,B
Radoslaw Wojtaszek,2614,2,63,28,54,26,B
Evgenia Hansen,2159,1,63,47,48,1,B
Jun Xu,2560,2,63,52,56,4,A
Jun Xu,2560,2,63,45,59,14,B
Jun Xu,2560,2,63,43,59,16,C
Sergei Tiviakov,2480,2,63,43,60,17,A
Sergei Tiviakov,2480,2,63,37,62,25,C
Mikhail Rytshagov,2460,2,63,44,57,13,A
Mikhail Rytshagov,2460,2,63,46,54,8,C
Mikhail Rytshagov,2460,2,63,42,51,9,D
Jordi Magem Badals,2487,2,63,32,60,28,B
Rikard Andersson,2175,2,64,59,47,-12,A
Eric Lobron,2500,2,64,73,53,-20,B
Kent Angskog,2271,3,64,77,48,-29,C
Anthony J Miles,2570,2,64,60,59,-1,A
Anthony J Miles,2570,2,64,46,56,10,B
Anthony J Miles,2570,2,64,48,55,7,C
Anthony J Miles,2570,2,64,42,56,14,D
Ljubomir Ljubojevic,2580,3,64,35,45,10,A
Ljubomir Ljubojevic,2580,3,64,31,47,16,C
Ljubomir Ljubojevic,2580,3,64,26,50,24,D
Dara Akdag,2083,2,65,18,68,50,C
Christopher Lissang,2080,2,65,56,52,-4,C
Christopher Lissang,2080,2,65,58,55,-3,D
Oleg Loskutov,2433,2,65,27,68,41,B
Ivan Sokolov,2625,2,65,32,57,25,D
Jeroen Piket,2640,2,65,44,62,18,A
Jeroen Piket,2640,2,65,25,62,37,B
Jeroen Piket,2640,2,65,26,63,37,C
Jeroen Piket,2640,2,65,24,63,39,D
Luis Couso,2355,2,66,61,53,-8,B
Christopher Lissang,2080,2,66,57,47,-10,A
Predrag Nikolic,2655,2,66,32,61,29,A
Predrag Nikolic,2655,2,66,26,65,39,B
Predrag Nikolic,2655,2,66,25,62,37,C
Predrag Nikolic,2655,2,66,22,61,39,D
Ivan Sokolov,2625,2,66,29,55,26,A
Ivan Sokolov,2625,2,66,27,59,32,C
Judit Polgar,2630,2,66,32,56,24,C
Lasha Janjghava,2500,2,66,61,56,-5,D
Kim Nygren,2202,2,67,71,51,-20,B
Vladimir Dobrov,2477,2,67,58,58,0,B
Sergey Volkov,2629,1,67,34,43,9,B
Ivan Sokolov,2625,2,67,30,58,28,B
Jens Ove Fries-Nielsen,2444,2,68,52,38,-14,B
Joseph G. Gallagher,2526,2,68,30,60,30,B
Simon Hanninger,2129,2,68,38,49,11,D
Petar Popovic,2530,2,68,49,53,4,D
Stuart C Conquest,2530,2,68,39,54,15,B
Azer Mirzoev,2543,1,68,35,53,18,B
Christian Hess,2281,2,69,72,46,-26,D
Erik Hedman,2396,2,69,31,57,26,B
Bo Adler,2208,3,69,55,49,-6,D
Ulf Nyberg,2146,1,69,28,65,37,C
Lasha Janjghava,2500,2,69,68,49,-19,C
Petar Popovic,2530,2,69,41,54,13,A
Petar Popovic,2530,2,69,41,61,20,C
Iker Iraneta Unzue,1812,2,69,69,46,-23,D
Ivan Farago,2475,3,70,37,41,4,B
Simon Hanninger,2129,2,70,39,50,11,C
Leonid Yudasin,2625,2,70,52,54,2,D
Mikhail Ulibin,2510,2,70,24,66,42,A
Mikhail Ulibin,2510,2,70,33,54,21,B
Mikhail Ulibin,2510,2,70,24,56,32,C
Mikhail Ulibin,2510,2,70,27,53,26,D
Lasha Janjghava,2500,2,70,69,44,-25,A
Iker Iraneta Unzue,1812,2,70,61,53,-8,A
Iker Iraneta Unzue,1812,2,70,81,44,-37,C
Stefan Winge,2262,3,71,85,44,-41,B
Stefan Winge,2262,3,71,73,46,-27,C
Tomas Karlsson,2249,1,71,28,55,27,B
Bo Adler,2208,3,71,56,51,-5,C
Simon Hanninger,2129,2,71,31,58,27,A
Igor Kurnosov,2543,2,71,22,59,37,B
Leonid Yudasin,2625,2,71,51,52,1,B
Leonid Yudasin,2625,2,71,57,51,-6,C
Miguel Argaya Urdaniz,2054,3,71,96,30,-66,D
Christian Hess,2281,2,72,63,43,-20,A
Bo Adler,2208,3,72,68,50,-18,A
Konstantin Landa,2550,4,72,59,46,-13,C
Leonid Yudasin,2625,2,72,50,54,4,A
Miguel Argaya Urdaniz,2054,3,72,88,36,-52,B
Aitor Alcaide Luque,2100,2,72,42,47,5,B
Sampsa Nyysti,2445,3,73,66,44,-22,B
Sampsa Nyysti,2363,1,73,29,40,11,B
Olga Girya,2338,2,73,44,48,4,B
Alexey Dreev,2650,2,73,48,42,-6,D
Erling Mortensen,2500,2,73,48,45,-3,A
Erling Mortensen,2500,2,73,46,47,1,C
Erling Mortensen,2500,2,73,44,51,7,D
Vasilios Kotronias,2570,2,73,40,48,8,A
Vasilios Kotronias,2570,2,73,38,49,11,B
Vasilios Kotronias,2570,2,73,36,52,16,C
Vasilios Kotronias,2570,2,73,37,49,12,D
Goran Dizdar,2465,1,73,38,44,6,A
Goran Dizdar,2465,1,73,32,44,12,B
Goran Dizdar,2465,1,73,33,41,8,C
Goran Dizdar,2465,1,73,33,36,3,D
Alexey Dreev,2650,2,74,51,47,-4,A
Alexey Dreev,2650,2,74,51,42,-9,B
Alexey Dreev,2650,2,74,47,45,-2,C
Viktor D Kupreichik,2545,2,74,30,65,35,A
Viktor D Kupreichik,2545,2,74,33,66,33,C
Viktor D Kupreichik,2545,2,74,30,66,36,D
Artashes Minasian,2525,1,74,34,47,13,A
Artashes Minasian,2525,1,74,34,43,9,B
Artashes Minasian,2525,1,74,32,43,11,C
Artashes Minasian,2525,1,74,32,45,13,D
Miguel Argaya Urdaniz,2054,3,74,105,30,-75,C
Peder Berkell,2310,2,75,36,55,19,B
Jan Peter Palmblad,2187,2,75,65,47,-18,D
Jon S Speelman,2605,2,75,14,71,57,A
Jon S Speelman,2605,2,75,16,67,51,B
Jon S Speelman,2605,2,75,15,72,57,C
Jon S Speelman,2605,2,75,9,73,64,D
Janne Mertanen,2241,2,76,44,57,13,B
Jan Peter Palmblad,2187,2,76,61,39,-22,A
Nils Grandelius,2371,3,76,40,50,10,B
Alexander Galkin,2602,3,76,24,61,37,C
Evgeny Bareev,2675,3,76,19,70,51,A
Evgeny Bareev,2675,3,76,18,71,53,B
Evgeny Bareev,2675,3,76,19,72,53,C
Evgeny Bareev,2675,3,76,22,68,46,D
Jan Peter Palmblad,2187,2,77,77,40,-37,C
Joel Lautier,2645,4,77,36,51,15,A
Joel Lautier,2645,4,77,33,58,25,C
Joel Lautier,2645,4,77,30,58,28,D
Peter Svidler,2550,2,77,39,49,10,B
Miguel Argaya Urdaniz,2054,3,77,91,38,-53,A
Svetlana Matveeva,2434,2,78,44,51,7,B
Mihail Marin,2520,2,78,38,59,21,B
Mihail Marin,2520,2,78,24,59,35,C
Jan H Timman,2635,3,78,52,54,2,A
Jan H Timman,2635,3,78,50,59,9,C
Jan H Timman,2635,3,78,47,58,11,D
Bogdan Lalic,2500,2,78,48,59,11,A
Bogdan Lalic,2500,2,78,29,65,36,D
Olga Alexandrova,2371,3,78,35,59,24,B
Eduardo Burguete Archel,2151,1,78,42,49,7,B
Ivo Timmermans,2178,3,80,43,54,11,A
Ivo Timmermans,2178,3,80,42,58,16,C
Ivo Timmermans,2178,3,80,42,54,12,D
Lennart Evertsson,2226,2,80,82,46,-36,C
Lennart Evertsson,2226,2,80,79,43,-36,D
Natalija Pogonina,2462,2,80,32,61,29,B
Lennart Evertsson,2226,2,81,86,41,-45,B
Emanuel Berg,2535,2,82,28,62,34,B
Nikita Meskovs,2124,3,82,54,46,-8,B
Kaido Kulaots,2533,2,82,50,51,1,B
Slavko Cicak,2574,2,82,48,50,2,B
Lennart Evertsson,2226,2,83,89,41,-48,A
Aurelio Vila Dupla,2208,3,83,104,51,-53,B
Per Soderberg,2205,2,84,56,49,-7,D
Tatiana Shadrina,2379,2,84,35,61,26,B
Oleg M Romanishin,2605,3,84,33,57,24,A
Oleg M Romanishin,2605,3,84,34,58,24,B
Oleg M Romanishin,2605,3,84,36,58,22,C
Oleg M Romanishin,2605,3,84,32,57,25,D
Lars Bo Hansen,2545,3,84,34,57,23,D
Ekaterina Korbut,2443,2,85,32,56,24,B
Alexander Grischuk,2704,3,85,31,53,22,B
Tommi Luukkonen,2081,3,86,41,53,12,C
Tommi Luukkonen,2081,3,86,47,50,3,D
Lars Bo Hansen,2545,3,86,52,53,1,A
Lars Bo Hansen,2545,3,86,35,55,20,C
Boris F Gulko,2590,3,86,45,52,7,C
Imanol Martinez Salas,1956,3,86,58,45,-13,A
Imanol Martinez Salas,1956,3,86,68,45,-23,D
Kristian Trygstad,2299,2,87,31,60,29,C
Tommi Luukkonen,2081,3,87,50,54,4,A
Evgenia Hansen,2159,2,87,59,49,-10,D
Branko Damljanovic,2505,2,87,48,47,-1,A
Branko Damljanovic,2505,2,87,43,52,9,C
Branko Damljanovic,2505,2,87,44,46,2,D
Santiago Arjona Martinez,1985,3,88,29,60,31,B
Per Soderberg,2205,2,89,52,51,-1,A
Evgenia Hansen,2159,2,89,61,48,-13,C
Eugenio Torre,2535,3,90,44,61,17,A
Eugenio Torre,2535,3,90,28,69,41,B
Eugenio Torre,2535,3,90,29,67,38,C
Eugenio Torre,2535,3,90,30,71,41,D
Anton Frisk Kockum,2206,2,91,35,54,19,B
Evgenia Hansen,2159,2,91,65,46,-19,A
Elena Tairova,2391,2,91,41,64,23,B
David Monell Camarasa,2212,3,91,36,49,13,B
Kezli Ong,2171,2,92,39,50,11,A
Kezli Ong,2171,2,92,30,47,17,D
Andreas Landgren,2164,4,93,63,52,-11,D
Kiril Georgiev,2615,2,93,20,71,51,D
Vasil Spasov,2525,3,93,47,63,16,C
Vasil Spasov,2525,3,93,43,65,22,D
Adrian Leranoz Zabalza,2061,4,93,60,46,-14,D
Kiril Georgiev,2615,2,94,17,69,52,C
Vasil Spasov,2525,3,94,58,56,-2,A
Adrian Leranoz Zabalza,2061,4,94,63,50,-13,C
Ilja Vovk,2295,2,95,36,45,9,C
Ildar Khairullin,2481,3,95,44,55,11,C
Zurab Azmaiparashvili,2575,2,95,31,52,21,B
Kiril Georgiev,2615,2,95,14,65,51,A
Kiril Georgiev,2615,2,95,12,71,59,B
Andreas Landgren,2164,4,96,64,55,-9,C
Ilja Vovk,2295,2,96,36,49,13,B
Mikhail Kobalia,2630,2,96,34,43,9,B
Adrian Leranoz Zabalza,2061,4,96,63,56,-7,A
Andreas Landgren,2164,4,97,79,43,-36,A
Artur Yusupov,2655,4,97,59,44,-15,A
Artur Yusupov,2655,4,97,53,46,-7,D
Nigel D Short,2665,3,97,46,53,7,B
Nigel D Short,2665,3,97,51,54,3,C
Nigel D Short,2665,3,97,53,49,-4,D
Darius Ruzele,2495,3,97,46,57,11,A
Viktor Laznicka,2596,2,97,21,67,46,B
Peder Berkell,2310,3,98,38,54,16,D
Ekaterina Kovalevskaya,2448,2,98,46,49,3,B
Vladimir Belov,2543,3,98,42,57,15,C
Maxim Novikov,2426,4,98,60,45,-15,C
Darius Ruzele,2495,3,98,45,58,13,C
Darius Ruzele,2495,3,98,45,59,14,D
Stellan Brynell,2524,3,99,23,56,33,C
Janne Mertanen,2241,3,99,43,58,15,C
Peder Berkell,2310,3,99,36,53,17,C
Luis Couso,2355,3,99,62,58,-4,A
Luis Couso,2355,3,99,53,54,1,C
Luis Couso,2355,3,99,53,57,4,D
Evgeny Alekseev,2616,3,99,46,50,4,C
Vladimir Akopian,2630,3,99,51,60,9,A
Vladimir Akopian,2630,3,99,46,60,14,B
Vladimir Akopian,2630,3,99,36,61,25,C
Vladimir Akopian,2630,3,99,37,61,24,D
Peder Berkell,2310,3,100,31,54,23,A
Robert Kuczynski,2515,3,100,45,53,8,A
Robert Kuczynski,2515,3,100,55,44,-11,D
Nigel D Short,2665,3,100,60,49,-11,A
Ralf Akesson,2470,3,101,39,55,16,B
Yuri Yakovich,2596,3,101,23,65,42,C
Fredrik Andersson,2229,5,102,82,45,-37,A
Fredrik Andersson,2229,5,102,88,40,-48,C
Fredrik Andersson,2229,5,102,79,41,-38,D
Henrik Lindberg,2254,3,103,65,45,-20,B
Sergej Silivanov,2291,3,103,55,51,-4,B
Daniel Moreno Gracia,2176,3,103,65,40,-25,B
Jasmin Bejtovic,2353,3,104,35,52,17,B
Pavel Maletin,2423,4,104,42,54,12,C
Paul Van Der Sterren,2605,3,104,28,62,34,A
Paul Van Der Sterren,2605,3,104,26,65,39,B
Paul Van Der Sterren,2605,3,104,22,63,41,C
Paul Van Der Sterren,2605,3,104,23,62,39,D
Peter Svidler,2550,3,105,38,50,12,A
Peter Svidler,2550,3,105,38,52,14,C
Peter Svidler,2550,3,105,41,48,7,D
Jonas Lundvik,2270,2,106,41,56,15,C
Pavel V. Tregubov,2636,3,106,37,57,20,C
Rafael Ruiz Escobar,1975,2,106,65,38,-27,D
Lennart Evertsson,2198,3,107,77,41,-36,D
Rafael Ruiz Escobar,1975,2,107,66,38,-28,C
Juan Carlos Lakunza Oyarbide,2175,4,107,46,50,4,B
Anders Livner,2281,2,108,29,56,27,B
Evgeny Gleizerov,2592,6,108,73,49,-24,C
Rafael Ruiz Escobar,1975,2,108,65,41,-24,B
Lars Karlsson,2488,3,110,41,55,14,B
Kim Nygren,2202,4,111,78,46,-32,C
Rafael Ruiz Escobar,1975,2,111,65,42,-23,A
Lennart Evertsson,2198,3,112,65,43,-22,C
Kent Angskog,2271,4,112,64,52,-12,D
Dmitry Andreikin,2418,3,112,28,53,25,C
Mikael Aroven,2201,3,113,59,49,-10,A
Mikael Aroven,2201,3,113,67,46,-21,D
Kent Angskog,2271,4,113,62,51,-11,A
Raul Garcia,2233,3,113,51,57,6,C
Lennart Evertsson,2198,3,114,80,44,-36,A
Alexei Shirov,2720,4,114,51,61,10,B
Heikki Lehtinen,2332,3,115,30,55,25,C
Johan Norberg,2153,3,115,69,45,-24,D
Juan Carlos Lakunza Oyarbide,2175,5,115,41,53,12,D
Tom Wedberg,2530,4,116,32,55,23,C
Johan Norberg,2153,3,116,74,42,-32,C
Csaba Berczes,2420,3,116,39,49,10,B
Thomas Marttala,2253,3,116,50,45,-5,A
Thomas Marttala,2253,3,116,55,44,-11,C
Thomas Marttala,2253,3,116,60,41,-19,D
Vladimir Kramnik,2725,3,116,22,59,37,A
Vladimir Kramnik,2725,3,116,23,65,42,C
Vladimir Kramnik,2725,3,116,24,59,35,D
Juan Carlos Lakunza Oyarbide,2175,5,116,43,52,9,C
Ian Nepomniachtchi,2445,3,117,25,54,29,C
Radoslaw Wojtaszek,2630,4,117,28,55,27,B
Radoslaw Wojtaszek,2630,4,117,24,55,31,C
Stefan Winge,2262,5,118,83,47,-36,D
Juan Manuel Bellon Lopez,2428,3,118,34,60,26,B
Stefan Winge,2262,5,119,81,48,-33,A
Johan Norberg,2153,3,119,58,49,-9,A
Vassily Ivanchuk,2695,5,119,28,62,34,A
Vassily Ivanchuk,2695,5,119,24,65,41,D
Juan Carlos Lakunza Oyarbide,2175,5,120,50,50,0,A
Lembit Oll,2475,4,122,42,55,13,D
Alexander Morozevich,2758,4,123,30,59,29,B
Mihail Marin,2520,3,123,31,56,25,D
Lembit Oll,2475,4,123,43,54,11,C
Irina Tetenkina,2292,5,124,53,49,-4,C
Jorgen Eriksson,2238,3,124,56,42,-14,C
Jorgen Eriksson,2238,3,124,58,39,-19,D
Semen I. Dvoirys,2612,4,124,42,54,12,C
Alexander Morozevich,2575,4,124,37,58,21,D
Evgenija Ovod,2386,2,125,25,53,28,B
Vladimir Kosyrev,2529,5,125,35,56,21,A
Vladimir Kosyrev,2529,5,125,31,56,25,C
Vladimir Kosyrev,2529,5,125,28,56,28,D
Mihail Marin,2520,3,125,50,56,6,A
Lembit Oll,2475,4,125,50,56,6,A
Jorgen Eriksson,2238,3,126,55,42,-13,A
Olga Stjazhkina,2325,3,126,33,47,14,B
Sampsa Nyysti,2445,5,127,55,43,-12,C
Sampsa Nyysti,2445,5,127,52,41,-11,D
Pia Cramling,2508,3,127,54,45,-9,B
Erno Dede,2275,3,127,58,53,-5,C
Erno Dede,2275,3,127,65,50,-15,D
Sampsa Nyysti,2445,5,128,51,41,-10,A
Henrik Lindberg,2254,4,128,56,49,-7,C
Tatiana Stepovaia,2375,2,128,40,51,11,B
Miguel Illescas Cordoba,2590,5,128,28,60,32,C
Miguel Illescas Cordoba,2590,5,128,31,59,28,D
Alexander Morozevich,2575,4,128,54,52,-2,A
Terje Johansen,2267,4,129,59,50,-9,C
Terje Johansen,2267,4,129,57,49,-8,D
Ulf Nyberg,2146,2,129,36,63,27,D
Miguel Illescas Cordoba,2590,5,129,39,54,15,A
Eduardo Ros Octavio De Toledo,2166,4,129,47,52,5,C
Terje Johansen,2267,4,130,49,55,6,A
Terje Johansen,2267,4,130,57,52,-5,B
Ulf Nyberg,2146,2,130,31,58,27,A
Janne Mertanen,2241,4,131,46,52,6,D
Kalle Kiik,2445,3,131,57,40,-17,B
Mika Karttunen,2413,5,131,32,54,22,D
Viktoria Johansson,2142,4,131,56,47,-9,A
Viktoria Johansson,2142,4,131,45,50,5,C
Viktoria Johansson,2142,4,131,47,50,3,D
Dara Akdag,2083,4,131,42,63,21,D
Erno Dede,2275,3,131,63,48,-15,A
Eduardo Burguete Archel,2151,3,131,51,50,-1,C
Alfonso Llorente Zaro,2419,4,131,26,57,31,C
Alfonso Llorente Zaro,2419,4,131,28,55,27,D
Janne Mertanen,2241,4,132,52,49,-3,A
Mika Karttunen,2413,5,132,31,53,22,A
Fernando Lopez Gracia,2348,7,133,47,52,5,A
Fernando Lopez Gracia,2348,7,133,44,54,10,C
Fernando Lopez Gracia,2348,7,133,47,56,9,D
Daniel Gomez Anadon,2268,4,133,46,54,8,B
Dara Akdag,2083,4,134,47,61,14,A
Alfonso Llorente Zaro,2419,4,134,30,48,18,A
David Arjol Echeverria,2073,4,134,51,57,6,C
David Arjol Echeverria,2073,4,134,55,54,-1,D
Jacob Aagaard,2355,5,135,33,59,26,D
David Arjol Echeverria,2073,4,135,61,47,-14,A
Jacob Aagaard,2355,5,136,34,55,21,A
Tatiana Shumiakina,2364,5,138,41,51,10,C
Teodor Hellborg,2240,4,139,46,52,6,A
Teodor Hellborg,2240,4,139,46,56,10,C
Teodor Hellborg,2240,4,139,45,53,8,D
Petr Kiriakov,2568,4,139,50,50,0,C
Alexei Kornev,2582,3,139,43,54,11,C
Boris F Gulko,2590,4,140,48,54,6,A
Boris F Gulko,2590,4,140,39,57,18,D
Sergey Ivanov,2561,3,142,39,62,23,C
Olga Stjazhkina,2325,4,142,45,50,5,C
Jens Ove Fries-Nielsen,2444,4,143,45,44,-1,C
Robert Fontaine,2572,4,143,34,54,20,B
Henrik Lindberg,2254,5,143,54,48,-6,A
Henrik Lindberg,2254,5,143,51,52,1,D
Maxim Sorokin,2554,3,143,23,62,39,C
Ekaterina Kovalevskaya,2452,5,144,37,55,18,C
Alexei Shirov,2720,5,144,31,69,38,C
Olli Sisatto,2285,2,145,34,57,23,B
Erik Blomqvist,2302,6,145,50,54,4,C
Andrei Kharlov,2593,3,145,29,55,26,C
Johann Hjartarson,2585,3,146,35,58,23,C
Johann Hjartarson,2585,3,146,42,57,15,D
Hannes Stefansson,2566,6,147,44,59,15,A
Hannes Stefansson,2566,6,147,47,58,11,D
Sergey Ivanov,2541,3,147,27,57,30,B
Sergei Rublevsky,2671,5,147,36,59,23,C
Miguel Illescas Cordoba,2620,5,147,45,52,7,C
Thomas Ernst,2448,4,148,47,55,8,C
Johann Hjartarson,2585,3,148,49,51,2,A
Ralf Akesson,2440,4,149,44,57,13,B
Mikael Naslund,2310,4,149,55,51,-4,D
Kim Nygren,2202,5,150,62,53,-9,D
Sergei Iskusnyh,2507,5,150,54,55,1,C
Michael Adams,2640,4,150,27,55,28,A
Michael Adams,2640,4,150,24,55,31,B
Michael Adams,2640,4,150,24,55,31,C
Michael Adams,2640,4,150,20,59,39,D
Oliver Brendel,2375,5,151,36,59,23,C
Miguel Navarro Cia,2297,3,151,38,55,17,B
Oliver Brendel,2375,5,152,36,61,25,D
Mikael Naslund,2310,4,152,56,51,-5,C
Vadim Zvjaginsev,2654,6,152,35,54,19,A
Vadim Zvjaginsev,2654,6,152,26,66,40,C
Vadim Zvjaginsev,2654,6,152,24,65,41,D
Alexandre Danin,2332,4,152,55,51,-4,C
Mikael Naslund,2310,4,153,53,50,-3,A
Jonas Lundvik,2270,3,154,40,58,18,D
Ilja Vovk,2295,3,154,39,54,15,D
Oliver Brendel,2375,5,156,44,58,14,A
Boris Gelfand,2685,4,156,32,62,30,A
Boris Gelfand,2685,4,156,30,60,30,C
Boris Gelfand,2685,4,156,29,63,34,D
Kim Nygren,2202,5,157,68,45,-23,A
Daniel Zamarbide Inarrea,2015,4,157,54,47,-7,C
Daniel Zamarbide Inarrea,2015,4,157,54,46,-8,D
Ilja Vovk,2295,3,158,30,52,22,A
Valeri Yandemirov,2494,6,158,45,57,12,C
Daniel Zamarbide Inarrea,2015,4,158,55,44,-11,A
Zurab Azmaiparashvili,2575,4,159,48,50,2,A
Zurab Azmaiparashvili,2575,4,159,40,48,8,C
Zurab Azmaiparashvili,2575,4,159,43,52,9,D
Raul Garcia,2233,5,159,49,57,8,D
Jonas Lundvik,2270,3,160,41,49,8,A
Daniel Moreno Gracia,2176,5,160,78,37,-41,D
Mark E Taimanov,2406,6,162,44,47,3,D
Daniel Moreno Gracia,2176,5,162,81,36,-45,C
Raul Garcia,2233,5,162,51,56,5,A
Mark E Taimanov,2406,6,163,49,48,-1,A
Antonio Labena Bernal,2003,5,165,43,50,7,D
Daniel Moreno Gracia,2176,5,166,83,36,-47,A
Antonio Labena Bernal,2003,5,167,48,49,1,C
Maksim Shapovalenko,2230,5,168,60,52,-8,B
Aitor Alcaide Luque,2100,6,169,62,45,-17,D
Santiago Arjona Martinez,1985,5,169,54,44,-10,D
Oskar Von Bahr,2320,6,170,49,55,6,D
Kalle Kiik,2445,4,170,53,46,-7,A
Kalle Kiik,2445,4,170,55,40,-15,C
Kalle Kiik,2445,4,170,51,43,-8,D
Eva Jiretorn,2122,4,170,38,55,17,B
Axel Smith,2458,5,170,42,51,9,B
Jordi Magem Badals,2487,8,170,32,59,27,A
Jordi Magem Badals,2487,8,170,31,59,28,C
Jordi Magem Badals,2487,8,170,30,59,29,D
Antonio Labena Bernal,2003,5,170,42,53,11,A
Santiago Arjona Martinez,1985,5,170,48,49,1,C
Oskar Von Bahr,2320,6,171,56,54,-2,C
Aitor Alcaide Luque,2100,6,171,51,46,-5,C
Oskar Von Bahr,2320,6,173,51,56,5,B
Konstantin Sakaev,2665,5,173,31,58,27,C
Santiago Arjona Martinez,1985,5,173,59,49,-10,A
Florian Handke,2504,5,174,49,55,6,B
Tomas Karlsson,2249,5,174,37,56,19,D
Mikko Niemi,2178,5,174,36,51,15,C
Erik Blomqvist,2302,8,175,56,53,-3,D
Alexander Morozevich,2747,5,175,26,63,37,C
Tomas Karlsson,2249,5,176,39,55,16,C
Aitor Alcaide Luque,2100,6,176,62,42,-20,A
Erik Blomqvist,2302,8,177,66,49,-17,A
Oskar Von Bahr,2320,6,178,52,55,3,A
Tomas Karlsson,2249,5,178,38,53,15,A
Nikita Meskovs,2124,6,179,64,46,-18,C
Garry Kasparov,2813,4,179,21,61,40,B
Evgeny E. Vorobiov,2552,8,179,41,53,12,C
Evgeny Romanov,2392,6,180,36,53,17,C
Evgeny E. Vorobiov,2552,8,180,41,56,15,D
Evgeny E. Vorobiov,2552,8,181,49,52,3,A
Daniel Gomez Anadon,2268,5,182,52,50,-2,D
Adrian Villuendas Valero,2176,6,183,41,55,14,B
Pontus Carlsson,2501,7,184,37,54,17,D
Ekaterina Kovalevskaya,2452,7,185,39,54,15,D
Daniel Gomez Anadon,2268,5,185,56,51,-5,C
Ekaterina Kovalevskaya,2452,7,187,40,53,13,A
Mikel Huerga Leache,2315,7,187,38,52,14,D
Daniel Gomez Anadon,2268,5,187,56,50,-6,A
Manuel Perez Candelario,2496,7,188,46,48,2,C
Alexander Khalifman,2668,6,189,38,48,10,A
Alexander Khalifman,2668,6,189,36,51,15,C
Alexander Khalifman,2668,6,189,35,53,18,D
Alexander Galkin,2602,7,189,34,58,24,A
Alexander Galkin,2602,7,189,29,61,32,D
Alexei Shirov,2710,7,189,46,50,4,A
Alexei Shirov,2710,7,189,34,56,22,C
Alexei Shirov,2710,7,189,32,56,24,D
Mikel Huerga Leache,2315,7,189,42,51,9,C
Eduardo Burguete Archel,2151,4,189,48,52,4,D
Pontus Carlsson,2501,7,190,43,52,9,A
Olga Stjazhkina,2325,5,190,47,47,0,A
Olga Stjazhkina,2325,5,190,42,50,8,D
Alexander Khalifman,2668,6,190,35,50,15,B
Konstantin Landa,2550,6,190,39,47,8,A
Konstantin Landa,2550,6,190,33,54,21,D
Eduardo Ros Octavio De Toledo,2166,5,191,37,48,11,D
Krisztian Szabo,2500,3,192,48,51,3,B
Josef Ask,2235,6,192,44,56,12,D
Mikel Huerga Leache,2315,7,192,43,49,6,A
Eduardo Ros Octavio De Toledo,2166,5,192,45,48,3,A
Anders Livner,2281,5,193,35,51,16,C
Sergey Dolmatov,2573,7,193,36,46,10,A
Sergey Dolmatov,2573,7,193,38,51,13,C
Sergey Dolmatov,2573,7,193,39,49,10,D
Rodrigo Vasquez Schroeder,2481,4,194,38,51,13,B
Radoslaw Wojtaszek,2614,8,195,38,57,19,A
Radoslaw Wojtaszek,2614,8,195,30,60,30,C
Radoslaw Wojtaszek,2614,8,195,31,61,30,D
Alain Spielmann,2308,6,196,40,53,13,D
Gustavo Barrenechea Bahamonde,2191,7,196,43,55,12,D
Alain Spielmann,2308,6,197,49,53,4,A
Alain Spielmann,2308,6,197,42,53,11,C
Vitaly Tseshkovsky,2577,6,197,49,51,2,B
Josef Ask,2235,6,198,54,51,-3,A
Gustavo Barrenechea Bahamonde,2191,7,198,43,56,13,C
Veselin Topalov,2645,6,199,38,60,22,C
Veselin Topalov,2645,6,199,34,65,31,D
Gustavo Barrenechea Bahamonde,2191,7,199,48,52,4,A
Eduardo Burguete Archel,2151,4,199,40,49,9,A
Harriet V Hunt,2389,5,201,42,54,12,A
Harriet V Hunt,2389,5,201,37,54,17,D
Juan Manuel Bellon Lopez,2455,5,201,32,59,27,C
Tatiana Shumiakina,2364,6,202,60,41,-19,D
Veselin Topalov,2645,6,202,43,58,15,A
Tatiana Shumiakina,2364,6,203,69,35,-34,A
Evgeny Gleizerov,2592,9,203,54,56,2,D
Radoslaw Wojtaszek,2630,6,204,35,55,20,D
Vladimir Epishin,2599,6,206,31,53,22,B
Evgeny Gleizerov,2592,9,206,59,52,-7,A
Radoslaw Wojtaszek,2630,6,206,40,54,14,A
Nikita Meskovs,2124,7,207,69,44,-25,D
Vladimir Dobrov,2477,7,207,50,52,2,C
Ralf Akesson,2440,6,208,42,52,10,C
Alexander Lastin,2622,6,208,35,58,23,D
Jens Ove Fries-Nielsen,2444,7,209,45,47,2,D
Alexander Lastin,2622,6,210,45,48,3,A
Miguel Illescas Cordoba,2620,7,210,41,55,14,D
Jens Ove Fries-Nielsen,2444,7,211,46,47,1,A
Kristian Trygstad,2299,6,212,44,57,13,A
Kristian Trygstad,2299,6,212,41,57,16,D
Miguel Illescas Cordoba,2620,7,212,50,55,5,A
Evgeny Romanov,2392,9,214,39,53,14,A
Evgeny Romanov,2392,9,214,34,53,19,D
Valeri Yandemirov,2494,9,214,43,53,10,D
Andrei Kharlov,2593,5,215,29,56,27,D
Manuel Perez Candelario,2496,8,215,50,48,-2,D
Nikita Meskovs,2124,7,216,63,46,-17,A
Joel Akesson,2344,7,216,40,57,17,D
Maksim Shapovalenko,2230,7,216,63,49,-14,C
Valeri Yandemirov,2494,9,216,46,55,9,A
Alexei Shirov,2720,7,216,24,68,44,D
Manuel Perez Candelario,2496,8,216,58,49,-9,A
Heikki Lehtinen,2332,6,217,33,53,20,A
Heikki Lehtinen,2332,6,217,33,54,21,D
Evgenij Agrest,2535,8,217,42,50,8,A
Evgenij Agrest,2535,8,217,33,53,20,C
Evgenij Agrest,2535,8,217,37,53,16,D
Joel Akesson,2344,7,217,48,52,4,A
Joel Akesson,2344,7,217,41,55,14,C
Jonas Barkhagen,2458,7,218,28,56,28,D
Anders Larsson,2257,8,218,44,47,3,A
Anders Larsson,2257,8,218,36,51,15,C
Anders Larsson,2257,8,218,36,50,14,D
Andrei Kharlov,2593,5,218,37,53,16,A
Dmitry Andreikin,2418,8,218,37,53,16,A
Dmitry Andreikin,2418,8,218,32,55,23,D
Igor Yagupov,2441,5,218,34,59,25,C
Inigo Argandona Riveiro,2396,7,218,38,56,18,C
Alexei Shirov,2720,7,218,33,61,28,A
Viktor Laznicka,2596,5,218,24,60,36,C
Jonas Barkhagen,2458,7,220,27,60,33,C
Jonas Barkhagen,2458,7,221,34,56,22,A
Tom Wedberg,2530,8,222,30,53,23,D
Tom Wedberg,2530,8,223,41,56,15,A
Valerij Popov,2568,6,223,32,53,21,D
Lluis Oms Fuentes,2327,6,224,44,54,10,B
Olga Alexandrova,2371,9,224,42,50,8,A
Olga Alexandrova,2371,9,224,34,56,22,C
Olga Alexandrova,2371,9,224,39,53,14,D
Aleksa Strikovic,2535,8,224,36,56,20,A
Aleksa Strikovic,2535,8,224,29,58,29,C
Aleksa Strikovic,2535,8,224,27,61,34,D
Artur Yusupov,2592,8,225,26,58,32,C
Artur Yusupov,2592,8,225,28,58,30,D
Valerij Popov,2568,6,225,33,54,21,C
Pablo Glavina,2418,7,225,36,57,21,A
Pablo Glavina,2418,7,225,39,54,15,B
Pablo Glavina,2418,7,225,39,54,15,C
Pablo Glavina,2418,7,225,39,56,17,D
Evgeny Gleizerov,2579,8,227,44,59,15,A
Evgeny Gleizerov,2579,8,227,38,65,27,C
Evgeny Gleizerov,2579,8,227,39,66,27,D
Petr Kiriakov,2568,8,227,44,46,2,A
Petr Kiriakov,2568,8,227,43,49,6,D
Evgeny Gleizerov,2579,8,228,37,63,26,B
Artur Yusupov,2592,8,228,34,57,23,A
Dmitry Bocharov,2567,9,228,45,56,11,D
Jesus Javier Cortes Bueno,2314,7,228,39,57,18,A
Jesus Javier Cortes Bueno,2314,7,228,37,55,18,B
Jesus Javier Cortes Bueno,2314,7,228,38,54,16,C
Jesus Javier Cortes Bueno,2314,7,228,39,53,14,D
Valerij Popov,2568,6,229,37,53,16,A
Anders Livner,2281,6,229,31,54,23,D
Tomi Nyback,2579,8,229,26,61,35,D
Alexey Korotylev,2596,6,229,44,52,8,B
Dmitry Bocharov,2567,9,229,41,59,18,C
Stuart C Conquest,2530,7,229,41,53,12,C
Stuart C Conquest,2530,7,229,41,55,14,D
Anders Livner,2281,6,230,34,55,21,A
Tomi Nyback,2579,8,231,26,61,35,C
Pia Cramling,2524,9,233,22,65,43,D
Evgeniy Najer,2606,7,233,40,54,14,C
Evgeniy Najer,2606,7,233,39,53,14,D
Dmitry Bocharov,2567,9,233,51,55,4,A
Tomi Nyback,2579,8,234,35,59,24,A
Sergey Ionov,2538,7,234,55,49,-6,C
Evgeniy Najer,2606,7,234,46,52,6,A
Stuart C Conquest,2530,7,234,46,53,7,A
Tomi Nyback,2458,7,236,46,61,15,D
Jose Miguel Ugalde Ezcurra,2215,9,236,37,55,18,C
Jose Miguel Ugalde Ezcurra,2215,9,236,38,53,15,D
Johan Furhoff,2302,6,237,43,53,10,A
Johan Furhoff,2302,6,237,36,57,21,C
Johan Furhoff,2302,6,237,31,61,30,D
Tomi Nyback,2458,7,237,48,60,12,C
Pia Cramling,2524,9,237,28,60,32,A
Pia Cramling,2524,9,237,22,67,45,C
Nils Grandelius,2371,7,237,34,54,20,D
Denis Yevseev,2580,9,237,39,48,9,A
Denis Yevseev,2580,9,237,36,53,17,C
Denis Yevseev,2580,9,237,35,54,19,D
Sergei Yudin,2425,8,237,30,58,28,D
Jose Miguel Ugalde Ezcurra,2215,9,237,39,55,16,A
Jesus Cortes Lizano,2270,8,238,58,51,-7,D
Irina Tetenkina,2292,7,239,38,48,10,D
Jesus Cortes Lizano,2270,8,239,59,49,-10,C
Nils Grandelius,2371,7,240,42,53,11,A
Nils Grandelius,2371,7,240,35,53,18,C
Sergei Yudin,2425,8,240,36,54,18,A
Jesus Cortes Lizano,2270,8,240,57,50,-7,B
Joseph G. Gallagher,2526,7,241,40,55,15,D
Irina Tetenkina,2292,7,241,34,48,14,A
Rodrigo Vasquez Schroeder,2481,5,241,36,51,15,C
Ruslan Shcherbakov,2564,9,241,37,56,19,C
Ruslan Shcherbakov,2564,9,241,36,55,19,D
Jesus Cortes Lizano,2270,8,241,60,47,-13,A
Tomi Nyback,2458,7,242,50,58,8,A
Joseph G. Gallagher,2526,7,243,40,58,18,C
Ruslan Shcherbakov,2564,9,243,38,56,18,A
Adrian Villuendas Valero,2176,7,243,44,56,12,A
Joseph G. Gallagher,2526,7,244,42,55,13,A
Yuri Yakovich,2596,8,244,31,53,22,A
Yuri Yakovich,2596,8,244,30,53,23,D
Adrian Villuendas Valero,2176,7,244,37,57,20,C
Adrian Villuendas Valero,2176,7,244,38,57,19,D
Eric Lobron,2500,7,245,39,56,17,C
David Berczes,2429,9,247,30,59,29,D
Garry Kasparov,2815,9,247,34,56,22,C
Garry Kasparov,2815,9,247,35,54,19,D
Axel Ornstein,2426,7,248,28,57,29,C
Axel Ornstein,2426,7,248,31,56,25,D
Igor Kurnosov,2543,7,249,36,53,17,C
Garry Kasparov,2815,9,249,44,52,8,B
Stellan Brynell,2524,8,250,26,56,30,A
Stellan Brynell,2524,8,250,25,55,30,D
Axel Ornstein,2426,7,250,33,53,20,A
David Berczes,2429,9,250,30,60,30,C
Borja Zamarbide Inarrea,2202,8,250,71,42,-29,D
Garry Kasparov,2815,9,251,46,52,6,A
Jasmin Bejtovic,2353,7,252,41,51,10,C
Jasmin Bejtovic,2353,7,252,42,50,8,D
David Berczes,2429,9,252,35,56,21,A
David Berczes,2429,9,252,31,58,27,B
Maxim Novikov,2426,8,252,47,53,6,D
Borja Zamarbide Inarrea,2202,8,252,69,41,-28,A
Borja Zamarbide Inarrea,2202,8,252,68,42,-26,B
Borja Zamarbide Inarrea,2202,8,252,70,41,-29,C
Florian Handke,2504,8,253,47,55,8,D
Florian Handke,2504,8,254,44,57,13,C
Jasmin Bejtovic,2353,7,255,44,50,6,A
Pavel Maletin,2423,8,255,28,58,30,D
Florian Handke,2504,8,256,50,51,1,A
Pavel Maletin,2423,8,256,34,54,20,A
Lars Karlsson,2488,7,257,36,54,18,D
Semen I. Dvoirys,2612,8,257,36,54,18,D
Semen I. Dvoirys,2612,8,258,41,55,14,A
Judit Polgar,2630,7,258,38,59,21,A
Judit Polgar,2630,7,258,33,64,31,D
Anton Frisk Kockum,2206,6,259,38,53,15,D
Lars Karlsson,2488,7,259,35,56,21,C
Sergej Silivanov,2291,8,259,53,50,-3,C
Pia Cramling,2508,6,260,41,49,8,C
Emanuel Berg,2535,8,260,24,66,42,C
Emanuel Berg,2535,8,260,27,64,37,D
Anton Frisk Kockum,2206,6,260,38,52,14,A
Anton Frisk Kockum,2206,6,260,36,55,19,C
Lars Karlsson,2488,7,260,38,56,18,A
Andrey Shariyazdanov,2575,8,260,27,57,30,D
Alexander Motylev,2651,5,260,25,58,33,B
Sergei Rublevsky,2671,8,260,33,56,23,A
Sergei Rublevsky,2671,8,260,28,60,32,D
Lluis Oms Fuentes,2327,7,260,45,55,10,D
Emanuel Berg,2535,8,261,28,64,36,A
Maxim Novikov,2426,8,261,56,47,-9,A
Mikhail Ulibin,2581,9,262,35,62,27,D
Eva Jiretorn,2122,7,262,49,53,4,D
Axel Smith,2458,7,262,41,49,8,C
Andrey Shariyazdanov,2575,8,262,31,53,22,C
Ralf Akesson,2440,8,263,44,49,5,D
Andrey Shariyazdanov,2575,8,263,30,58,28,B
Olli Sisatto,2285,6,264,42,55,13,C
Olli Sisatto,2285,6,264,45,53,8,D
Andrey Shariyazdanov,2575,8,264,33,53,20,A
Mikhail Ulibin,2581,9,265,39,60,21,C
Olli Sisatto,2285,6,265,46,52,6,A
Eva Jiretorn,2122,7,265,45,53,8,C
Ralf Akesson,2440,8,266,51,50,-1,A
Radmilo Dimitrijevic,2093,8,266,45,48,3,C
Radmilo Dimitrijevic,2093,8,266,46,50,4,D
Maksim Shapovalenko,2230,9,266,62,50,-12,D
Lluis Oms Fuentes,2327,7,266,46,56,10,C
Thomas Ernst,2448,9,268,44,54,10,D
Erik Hedman,2396,7,268,29,55,26,D
Sergej Silivanov,2291,9,268,58,47,-11,D
Mikhail Ulibin,2581,9,269,38,60,22,B
Erik Hedman,2396,7,269,31,55,24,C
Mikhail Ulibin,2581,9,270,41,59,18,A
Radmilo Dimitrijevic,2093,8,270,46,46,0,B
Eva Jiretorn,2122,7,270,52,52,0,A
Radmilo Dimitrijevic,2093,8,271,45,47,2,A
Erik Hedman,2396,7,271,36,54,18,A
Sergej Silivanov,2291,9,271,55,49,-6,A
Evgeny Shaposhnikov,2559,8,273,32,58,26,A
Evgeny Shaposhnikov,2559,8,273,32,57,25,C
Evgeny Shaposhnikov,2559,8,273,29,60,31,D
Maksim Shapovalenko,2230,9,273,67,48,-19,A
Sergey Ionov,2538,9,274,49,51,2,D
Inigo Argandona Riveiro,2396,9,275,36,57,21,D
Azer Mirzoev,2543,8,275,33,52,19,D
Bengt Lindberg,2382,8,276,43,52,9,C
Bengt Lindberg,2382,8,276,43,51,8,D
Thomas Ernst,2448,9,276,40,52,12,A
Mikhail Ulibin,2579,5,276,24,57,33,C
Ildar Khairullin,2481,9,276,38,56,18,A
Ildar Khairullin,2481,9,276,35,59,24,D
Azer Mirzoev,2543,8,276,35,50,15,C
Bengt Lindberg,2439,9,277,37,51,14,D
Lluis Oms Fuentes,2327,7,277,46,51,5,A
Bengt Lindberg,2382,8,278,46,53,7,B
Bengt Lindberg,2439,9,278,38,51,13,C
Sergey Ionov,2538,9,278,56,48,-8,A
Bengt Lindberg,2439,9,279,43,48,5,A
Bengt Lindberg,2439,9,280,36,51,15,B
Bengt Lindberg,2382,8,281,51,48,-3,A
Alexander Grischuk,2704,9,281,37,47,10,C
Alexander Grischuk,2704,9,281,36,49,13,D
Azer Mirzoev,2543,8,281,38,47,9,A
Rasmus Holving,2210,7,282,42,54,12,C
Rasmus Holving,2210,7,282,44,51,7,D
Slavko Cicak,2574,8,282,34,57,23,C
Slavko Cicak,2574,8,282,32,57,25,D
Evgeny Alekseev,2616,9,282,42,54,12,D
Axel Smith,2458,8,283,41,51,10,D
Evgeny Alekseev,2616,9,283,39,54,15,A
Sergei Iskusnyh,2507,9,283,48,58,10,D
Alexander Grischuk,2704,9,283,45,45,0,A
Inigo Argandona Riveiro,2396,9,283,47,47,0,A
Rasmus Holving,2210,7,285,42,51,9,A
Sergei Iskusnyh,2507,9,285,50,53,3,A
Vladimir Belov,2543,8,285,40,54,14,A
Vladimir Belov,2543,8,285,29,56,27,D
Valerij Filippov,2639,8,285,36,52,16,D
Emanuel Berg,2583,9,286,39,53,14,C
Emanuel Berg,2583,9,286,39,54,15,D
Sergey Ivanov,2546,8,286,34,50,16,C
Sergey Ivanov,2546,8,286,33,52,19,D
Dmitry Jakovenko,2582,8,286,34,61,27,C
Dmitry Jakovenko,2582,8,286,31,62,31,D
Slavko Cicak,2574,8,287,39,56,17,A
Sergey Ivanov,2546,8,287,38,47,9,A
Valerij Filippov,2639,8,287,41,53,12,C
Emanuel Berg,2583,9,288,41,54,13,A
Emanuel Berg,2583,9,288,38,55,17,B
Viktor Laznicka,2596,7,289,32,58,26,D
Alexey Kuzmin,2567,8,290,26,63,37,D
Dmitry Jakovenko,2582,8,290,40,56,16,A
Nikolay Nazarov,2256,9,290,46,49,3,D
Axel Smith,2458,8,291,43,51,8,A
Konstantin Sakaev,2665,9,291,27,57,30,D
Alexey Kuzmin,2567,8,291,25,64,39,C
Nikolay Nazarov,2256,9,291,44,51,7,C
Valerij Filippov,2639,8,291,39,55,16,A
Christian Bauer,2585,7,291,29,64,35,D
Oleg Nikolenko,2520,7,292,33,57,24,D
Alexey Kuzmin,2567,8,292,32,59,27,A
Viktor Laznicka,2596,7,292,41,56,15,A
Oleg Nikolenko,2520,7,293,31,58,27,C
Eric Lobron,2500,9,294,37,56,19,D
Alexander Morozevich,2747,7,294,23,64,41,D
Oleg Nikolenko,2520,7,295,32,56,24,A
Oleg Nikolenko,2520,7,295,31,57,26,B
Nikolay Nazarov,2256,9,295,55,47,-8,A
Eric Lobron,2500,9,296,41,50,9,A
Mikko Niemi,2178,8,296,38,50,12,D
Konstantin Sakaev,2665,9,296,30,50,20,A
Pia Cramling,2508,7,298,43,50,7,D
Johan Henriksson,2197,7,298,41,53,12,D
Mikko Niemi,2178,8,298,44,52,8,A
Denis Frolov,2401,9,298,39,46,7,A
Denis Frolov,2401,9,298,37,51,14,B
Denis Frolov,2401,9,298,36,51,15,C
Denis Frolov,2401,9,298,36,51,15,D
Santiago Gonzalez De La Torre,2357,8,298,57,48,-9,C
Dmitry Jakovenko,2671,7,298,27,60,33,D
Johan Henriksson,2197,7,299,42,51,9,C
Christian Bauer,2585,7,299,35,61,26,A
Pia Cramling,2508,7,300,50,48,-2,A
Johan Furhoff,2392,9,300,52,53,1,D
Johan Henriksson,2197,7,300,43,53,10,A
Johan Furhoff,2392,9,301,50,54,4,C
Alexander Morozevich,2747,7,301,35,55,20,A
Tommi Luukkonen,2244,8,303,48,55,7,C
Tommi Luukkonen,2244,8,303,49,55,6,D
Claude Landenbergue,2446,9,303,47,54,7,C
Claude Landenbergue,2446,9,303,46,50,4,D
Eric Prie,2516,9,304,47,53,6,D
Csaba Berczes,2420,9,305,37,49,12,C
Csaba Berczes,2420,9,305,36,51,15,D
Robert Fontaine,2572,9,305,41,59,18,D
Tommi Luukkonen,2244,8,305,54,52,-2,A
Tommi Luukkonen,2244,8,305,46,56,10,B
Johan Furhoff,2392,9,305,55,49,-6,A
Valerij Popov,2547,8,305,26,61,35,D
Pavel V. Tregubov,2636,8,305,27,60,33,D
Eric Prie,2516,9,305,45,54,9,C
Csaba Berczes,2420,9,306,45,48,3,A
Pavel V. Tregubov,2636,8,306,29,58,29,A
Evgenij Gajsin,2404,9,306,36,59,23,D
Claude Landenbergue,2446,9,306,44,48,4,A
Eric Prie,2516,9,306,48,52,4,A
Valerij Popov,2547,8,307,32,57,25,A
Ernesto Inarkiev,2595,9,308,29,56,27,C
Oleg Loskutov,2433,9,309,35,58,23,C
Ernesto Inarkiev,2595,9,309,31,55,24,D
Dmitry Jakovenko,2671,7,309,41,55,14,A
Robert Fontaine,2572,9,310,39,59,20,C
Sampsa Nyysti,2363,8,310,33,55,22,D
Oleg Loskutov,2433,9,310,34,59,25,D
Evgenij Gajsin,2404,9,310,38,57,19,C
Ernesto Inarkiev,2595,9,310,34,51,17,A
Oleg Loskutov,2433,9,311,38,57,19,A
Kaido Kulaots,2533,8,312,28,62,34,D
Sampsa Nyysti,2363,8,312,35,54,19,C
Evgenij Gajsin,2404,9,312,40,58,18,A
Rodrigo Vasquez Schroeder,2481,7,313,37,50,13,D
Vladimir Dobrov,2477,9,313,45,52,7,D
Rodrigo Vasquez Schroeder,2481,7,314,43,50,7,A
Tiger Hillarp Persson,2535,9,314,41,48,7,D
Sampsa Nyysti,2363,8,314,40,52,12,A
Kaido Kulaots,2533,8,315,36,59,23,C
Tiger Hillarp Persson,2535,9,315,49,44,-5,A
Tiger Hillarp Persson,2535,9,315,45,46,1,B
Tiger Hillarp Persson,2535,9,315,43,49,6,C
Robert Fontaine,2572,9,316,46,52,6,A
Kjetil Stokke,2372,8,316,36,53,17,D
Vladimir Dobrov,2477,9,316,52,51,-1,A
Kjetil Stokke,2372,8,318,34,56,22,B
Kjetil Stokke,2372,8,318,38,52,14,C
Victor Nithander,2339,8,318,36,49,13,D
Kaido Kulaots,2533,8,318,37,57,20,A
Kjetil Stokke,2372,8,319,37,54,17,A
Juan Manuel Bellon Lopez,2455,9,319,41,60,19,D
Evgeny Bareev,2715,10,319,29,56,27,C
Evgeny Bareev,2715,10,319,30,57,27,D
Victor Nithander,2339,8,320,33,51,18,C
Juan Manuel Bellon Lopez,2455,9,320,41,57,16,A
Victor Nithander,2339,8,321,36,49,13,A
Victor Nithander,2339,8,321,31,53,22,B
Ralf Akesson,2470,9,321,46,53,7,D
Emil Hermansson,2370,9,322,30,53,23,D
Juan Manuel Bellon Lopez,2428,8,323,35,59,24,C
Juan Manuel Bellon Lopez,2428,8,323,36,58,22,D
Evgeny Bareev,2715,10,323,31,55,24,B
Ralf Akesson,2470,9,324,43,53,10,C
Evgeny Bareev,2715,10,324,35,53,18,A
Ivan Salgado Lopez,2425,9,324,53,55,2,D
Ralf Akesson,2470,9,325,49,50,1,A
Alexander Rustemov,2593,9,325,30,54,24,C
Alexander Rustemov,2593,9,325,28,54,26,D
Ivan Salgado Lopez,2425,9,325,53,54,1,C
Emil Hermansson,2370,9,326,30,54,24,A
Alexei Kornev,2582,8,327,34,56,22,A
Alexei Kornev,2582,8,327,33,56,23,D
David Monell Camarasa,2212,9,327,39,55,16,C
David Monell Camarasa,2212,9,327,38,54,16,D
Juan Manuel Bellon Lopez,2428,8,328,42,54,12,A
Alexander Rustemov,2593,9,328,38,50,12,A
David Monell Camarasa,2212,9,328,41,52,11,A
Aurelio Vila Dupla,2208,9,329,62,47,-15,A
Aurelio Vila Dupla,2208,9,329,59,49,-10,C
Aurelio Vila Dupla,2208,9,329,57,50,-7,D
Ivan Salgado Lopez,2425,9,329,50,50,0,A
Rune Djurhuus,2479,8,330,28,58,30,C
Rune Djurhuus,2479,8,330,30,58,28,D
Rune Djurhuus,2479,8,331,33,56,23,A
Rune Djurhuus,2479,8,331,30,58,28,B
Tamas Ruck,2343,7,332,46,52,6,A
Tamas Ruck,2343,7,332,44,52,8,C
Tamas Ruck,2343,7,332,46,50,4,D
Denis Khismatullin,2537,9,334,55,56,1,D
Santiago Gonzalez De La Torre,2357,9,334,57,49,-8,D
Denis Khismatullin,2537,9,336,56,57,1,C
Ian Nepomniachtchi,2445,9,336,38,54,16,D
Santiago Gonzalez De La Torre,2357,9,336,51,48,-3,A
Igor Yagupov,2441,8,337,36,59,23,A
Igor Yagupov,2441,8,337,32,58,26,D
Ian Nepomniachtchi,2445,9,339,41,52,11,A
Peter Svidler,2735,10,340,28,60,32,D
Denis Khismatullin,2537,9,340,61,54,-7,A
Peter Svidler,2735,10,341,29,57,28,B
Peter Svidler,2735,10,341,31,55,24,C
Ivan Farago,2475,9,343,32,54,22,A
Ivan Farago,2475,9,343,29,54,25,C
Ivan Farago,2475,9,343,28,55,27,D
Peter Svidler,2735,10,343,33,54,21,A
Maxim Sorokin,2554,8,344,27,58,31,D
Maxim Sorokin,2554,8,347,30,54,24,A
Krisztian Szabo,2500,8,351,52,50,-2,D
Andrei Belozerov,2552,8,351,27,49,22,A
Andrei Belozerov,2552,8,351,25,53,28,C
Andrei Belozerov,2552,8,351,25,54,29,D
Thomas Ernst,2450,8,353,29,51,22,D
Krisztian Szabo,2500,8,355,51,49,-2,C
Thomas Ernst,2450,8,357,33,48,15,A
Sergey Ivanov,2541,9,358,35,54,19,C
Sergey Ivanov,2541,9,358,34,54,20,D
Igor Kurnosov,2543,9,359,33,56,23,D
Miguel Navarro Cia,2297,8,359,41,57,16,D
Sergey Ivanov,2561,9,360,30,62,32,D
Vladimir Burmakin,2571,9,360,39,50,11,A
Pavel Smirnov,2601,8,361,25,61,36,D
Krisztian Szabo,2500,8,362,59,48,-11,A
Sergey Ivanov,2541,9,362,45,48,3,A
Pavel Smirnov,2601,8,362,30,61,31,A
Pavel Smirnov,2601,8,362,29,62,33,C
Sergey Volkov,2629,9,363,41,50,9,D
Vladimir Burmakin,2571,9,363,35,59,24,D
Miguel Navarro Cia,2297,8,363,40,57,17,C
Sergey Ivanov,2561,9,364,33,58,25,A
Sergey I. Solovjov,2458,9,364,40,58,18,D
Igor Kurnosov,2543,9,364,39,52,13,A
Sergey Volkov,2629,9,364,40,52,12,C
Vladimir Burmakin,2571,9,364,36,56,20,C
Sergey I. Solovjov,2458,9,365,40,56,16,C
Miguel Navarro Cia,2297,8,365,40,52,12,A
Alexander Riazantsev,2556,8,368,32,53,21,D
Sergey I. Solovjov,2458,9,368,44,55,11,A
Sergey Volkov,2629,9,369,43,48,5,A
Alexander Riazantsev,2556,8,372,31,53,22,C
Lars Bo Hansen,2576,9,375,27,57,30,D
Alexander Riazantsev,2556,8,377,35,50,15,A
Mikhail Kobalia,2630,8,377,41,50,9,D
Lars Bo Hansen,2576,9,378,28,56,28,C
Lars Bo Hansen,2576,9,380,32,52,20,B
Mikhail Kobalia,2630,8,380,38,52,14,C
Lars Bo Hansen,2576,9,382,34,55,21,A
Mikhail Kobalia,2630,8,384,44,50,6,A
Alexandre Danin,2332,9,385,40,55,15,D
Valery A Loginov,2516,9,387,31,58,27,D
Alexandre Danin,2332,9,388,47,53,6,A
Valery A Loginov,2516,9,390,37,56,19,A
Valery A Loginov,2516,9,391,37,55,18,C
Alexander Morozevich,2758,10,394,25,62,37,C
Alexander Morozevich,2758,10,394,25,65,40,D
Alexander Morozevich,2758,10,397,27,63,36,A
Tatiana Kosintseva,2492,10,401,34,56,22,D
Tatiana Kosintseva,2492,10,404,33,56,23,C
Tatiana Kosintseva,2492,10,405,40,54,14,A
Garry Kasparov,2813,10,411,27,62,35,D
Garry Kasparov,2813,10,412,32,60,28,A
Garry Kasparov,2813,10,412,27,59,32,C
Mikhail Ulibin,2579,9,424,29,55,26,D
Mikhail Ulibin,2579,9,430,34,53,19,A
Juan Mario Gomez Esteban,2486,9,432,37,55,18,D
Juan Mario Gomez Esteban,2486,9,436,36,54,18,C
Juan Mario Gomez Esteban,2486,9,442,39,55,16,A
Olga Girya,2338,11,460,37,56,19,D
Olga Girya,2338,11,462,37,57,20,C
Olga Girya,2338,11,466,41,52,11,A
Oleg Korneev,2657,15,467,35,57,22,D
Vasilios Kotronias,2628,9,468,28,61,33,D
Oleg Korneev,2657,15,470,36,56,20,C
Vasilios Kotronias,2628,9,471,32,59,27,C
Vasilios Kotronias,2628,9,474,32,58,26,B
Valentina Gunina,2359,11,474,49,52,3,D
Vasilios Kotronias,2628,9,475,35,56,21,A
Ekaterina Korbut,2443,11,476,34,54,20,D
Ekaterina Korbut,2443,11,477,34,53,19,C
Oleg Korneev,2657,15,478,38,55,17,A
Valentina Gunina,2359,11,479,48,53,5,C
Ekaterina Korbut,2443,11,483,40,51,11,A
Valentina Gunina,2359,11,487,50,54,4,B
Valentina Gunina,2359,11,488,55,54,-1,A
Evgenija Ovod,2386,11,492,29,58,29,D
Nadezhda Kosintseva,2469,10,494,33,54,21,D
Evgenija Ovod,2386,11,494,32,56,24,C
Nadezhda Kosintseva,2469,10,495,35,54,19,C
Nadezhda Kosintseva,2469,10,496,34,53,19,B
Tatiana Shadrina,2379,11,498,34,55,21,D
Evgenija Ovod,2386,11,498,40,54,14,A
Tatiana Shadrina,2379,11,500,34,56,22,C
Nadezhda Kosintseva,2469,10,502,40,48,8,A
Ekaterina Kovalevskaya,2448,11,506,38,54,16,D
Ekaterina Kovalevskaya,2448,11,507,37,55,18,C
Alexey Dreev,2698,15,508,26,60,34,D
Tatiana Shadrina,2379,11,509,38,54,16,A
Alexey Dreev,2698,15,510,27,58,31,C
Alexey Dreev,2698,15,511,35,55,20,A
Alexey Dreev,2698,15,511,31,56,25,B
Ekaterina Kovalevskaya,2448,11,512,37,54,17,A
Svetlana Matveeva,2434,11,516,38,54,16,D
Natalija Pogonina,2462,11,517,37,57,20,D
Svetlana Matveeva,2434,11,519,37,53,16,C
Natalija Pogonina,2462,11,523,37,55,18,C
Natalija Pogonina,2462,11,525,38,51,13,A
Svetlana Matveeva,2434,11,525,40,51,11,A
Elena Tairova,2391,11,561,43,54,11,D
Elena Tairova,2391,11,564,44,54,10,C
Elena Tairova,2391,11,569,45,50,5,A
Tatiana Kononenko,2375,17,569,41,50,9,C
Tatiana Kononenko,2375,17,570,42,51,9,D
Tatiana Kononenko,2375,17,572,42,49,7,B
Tatiana Kononenko,2375,17,573,45,50,5,A
Tatiana Stepovaia,2375,11,593,42,53,11,D
Artyom Timofeev,2611,17,595,28,59,31,D
Artyom Timofeev,2611,17,596,29,59,30,C
Tatiana Stepovaia,2375,11,596,42,54,12,C
Artyom Timofeev,2611,17,598,32,56,24,B
Artyom Timofeev,2611,17,599,34,56,22,A
Tatiana Stepovaia,2375,11,600,44,53,9,A
Vladimir Epishin,2599,18,644,30,54,24,D
Vladimir Epishin,2599,18,646,31,52,21,C
Vladimir Epishin,2599,18,650,37,51,14,A
Alexey Korotylev,2596,19,652,37,53,16,D
Alexey Korotylev,2596,19,655,35,54,19,C
Alexey Korotylev,2596,19,662,40,53,13,A
Vitaly Tseshkovsky,2577,19,731,33,56,23,D
Vitaly Tseshkovsky,2577,19,733,35,55,20,C
Vitaly Tseshkovsky,2577,19,737,39,52,13,A
Alexander Motylev,2651,16,774,25,59,34,D
Alexander Motylev,2651,16,776,26,58,32,C
Alexander Motylev,2651,16,780,29,57,28,A
