Name,Rating,Games,Result,Moves,CPL,MM,Sort Score,Analysis
Terje Johansen,2267,4,1.5,129,49,55,6,A
Terje Johansen,2267,4,1.5,129,57,52,-5,B
Terje Johansen,2267,4,1.5,129,59,50,-9,C
Terje Johansen,2267,4,1.5,129,57,49,-8,D
Rune Djurhuus,2479,8,5.5,330,33,56,23,A
Rune Djurhuus,2479,8,5.5,330,30,58,28,B
Rune Djurhuus,2479,8,5.5,330,28,58,30,C
Rune Djurhuus,2479,8,5.5,330,30,58,28,D
Bengt Lindberg,2382,8,4.5,276,52,49,-3,A
Bengt Lindberg,2382,8,4.5,276,47,53,6,B
Bengt Lindberg,2382,8,4.5,276,43,52,9,C
Bengt Lindberg,2382,8,4.5,276,43,51,8,D
Mikhail Ulibin,2581,9,5.5,262,42,60,18,A
Mikhail Ulibin,2581,9,5.5,262,39,61,22,B
Mikhail Ulibin,2581,9,5.5,262,40,61,21,C
Mikhail Ulibin,2581,9,5.5,262,35,62,27,D
Rikard Andersson,2175,2,0,60,63,50,-13,A
Rikard Andersson,2175,2,0,60,65,48,-17,C
Rikard Andersson,2175,2,0,60,56,50,-6,D
Oskar Von Bahr,2320,7,3.5,176,53,58,5,A
Oskar Von Bahr,2320,7,3.5,176,51,55,4,B
Oskar Von Bahr,2320,7,3.5,176,56,54,-2,C
Oskar Von Bahr,2320,7,3.5,176,48,56,8,D
Kim Nygren,2202,5,1,150,71,47,-24,A
Kim Nygren,2202,5,1,150,62,53,-9,D
Evgeny Gleizerov,2579,9,6.5,232,44,58,14,A
Evgeny Gleizerov,2579,9,6.5,232,38,63,25,B
Evgeny Gleizerov,2579,9,6.5,232,38,64,26,C
Evgeny Gleizerov,2579,9,6.5,232,40,65,25,D
Sampsa Nyysti,2445,5,2,127,52,42,-10,A
Sampsa Nyysti,2445,5,2,127,55,43,-12,C
Sampsa Nyysti,2445,5,2,127,52,41,-11,D
Erik Norberg,2166,1,0,27,80,48,-32,A
Erik Norberg,2166,1,0,27,82,48,-34,B
Erik Norberg,2166,1,0,27,82,48,-34,C
Erik Norberg,2166,1,0,27,85,48,-37,D
Ivo Timmermans,2178,3,0.5,80,43,54,11,A
Ivo Timmermans,2178,3,0.5,80,42,58,16,C
Ivo Timmermans,2178,3,0.5,80,42,54,12,D
Sergey Ivanov,2561,9,6,360,33,59,26,A
Sergey Ivanov,2561,9,6,360,30,62,32,D
Tatiana Shumiakina,2364,6,2.5,202,70,35,-35,A
Tatiana Shumiakina,2364,6,2.5,202,60,41,-19,D
Kristian Trygstad,2299,6,3,212,44,57,13,A
Kristian Trygstad,2299,6,3,212,41,57,16,D
Jonas Barkhagen,2458,8,6.5,223,35,57,22,A
Jonas Barkhagen,2458,8,6.5,223,27,61,34,C
Jonas Barkhagen,2458,8,6.5,223,28,56,28,D
Johan Furhoff,2302,7,3,244,43,52,9,A
Johan Furhoff,2302,7,3,244,36,57,21,C
Johan Furhoff,2302,7,3,244,31,62,31,D
Stefan Winge,2262,5,2,118,81,48,-33,A
Stefan Winge,2262,5,2,118,83,47,-36,D
Ralph Hallerod,2105,2,0,44,109,34,-75,A
Ralph Hallerod,2105,2,0,44,120,30,-90,B
Ralph Hallerod,2105,2,0,44,112,30,-82,C
Ralph Hallerod,2105,2,0,44,116,36,-80,D
Rodrigo Vasquez Schroeder,2481,8,5,320,44,49,5,A
Rodrigo Vasquez Schroeder,2481,8,5,320,37,49,12,D
Joseph G. Gallagher,2526,8,5,247,44,54,10,A
Joseph G. Gallagher,2526,8,5,247,41,58,17,C
Joseph G. Gallagher,2526,8,5,247,40,55,15,D
Emil Hermansson,2370,9,5,322,31,54,23,A
Emil Hermansson,2370,9,5,322,30,53,23,D
Stellan Brynell,2524,8,5.5,250,26,56,30,A
Stellan Brynell,2524,8,5.5,250,25,55,30,D
Oliver Brendel,2375,5,3.5,152,46,60,14,A
Oliver Brendel,2375,5,3.5,152,35,59,24,C
Oliver Brendel,2375,5,3.5,152,36,61,25,D
Andreas Landgren,2164,4,0,93,83,45,-38,A
Andreas Landgren,2164,4,0,93,66,57,-9,C
Andreas Landgren,2164,4,0,93,63,52,-11,D
Jacob Aagaard,2355,5,2.5,135,35,56,21,A
Jacob Aagaard,2355,5,2.5,135,33,59,26,D
Josef Ask,2128,2,0,50,108,38,-70,A
Josef Ask,2128,2,0,50,80,36,-44,D
Janne Mertanen,2241,4,1.5,131,53,50,-3,A
Janne Mertanen,2241,4,1.5,131,46,52,6,D
Ralf Akesson,2440,8,4.5,263,51,51,0,A
Ralf Akesson,2440,8,4.5,263,44,49,5,D
Pia Cramling,2508,7,4,298,50,48,-2,A
Pia Cramling,2508,7,4,298,43,50,7,D
Jens Ove Fries-Nielsen,2444,7,4,209,46,47,1,A
Jens Ove Fries-Nielsen,2444,7,4,209,45,47,2,D
Florian Handke,2504,8,5,253,51,52,1,A
Florian Handke,2504,8,5,253,44,58,14,C
Florian Handke,2504,8,5,253,47,55,8,D
Axel Ornstein,2426,7,4,248,33,54,21,A
Axel Ornstein,2426,7,4,248,28,57,29,C
Axel Ornstein,2426,7,4,248,31,56,25,D
Juan Manuel Bellon Lopez,2428,8,5.5,323,43,54,11,A
Juan Manuel Bellon Lopez,2428,8,5.5,323,35,59,24,C
Juan Manuel Bellon Lopez,2428,8,5.5,323,36,58,22,D
Peder Berkell,2310,3,1,98,31,55,24,A
Peder Berkell,2310,3,1,98,37,53,16,C
Peder Berkell,2310,3,1,98,38,54,16,D
Felix Nordstrom,2176,2,0.5,39,79,36,-43,A
Felix Nordstrom,2176,2,0.5,39,71,46,-25,C
Felix Nordstrom,2176,2,0.5,39,64,49,-15,D
Kalle Kiik,2445,5,3,174,53,47,-6,A
Kalle Kiik,2445,5,3,174,55,40,-15,C
Kalle Kiik,2445,5,3,174,51,43,-8,D
Peter Bjarnehag,2197,2,0,40,54,40,-14,A
Peter Bjarnehag,2197,2,0,40,57,40,-17,B
Peter Bjarnehag,2197,2,0,40,47,43,-4,C
Peter Bjarnehag,2197,2,0,40,47,40,-7,D
Artur Yusupov,2592,9,7,229,34,58,24,A
Artur Yusupov,2592,9,7,229,26,58,32,C
Artur Yusupov,2592,9,7,229,28,58,30,D
Luis Couso,2355,3,1,99,62,58,-4,A
Luis Couso,2355,3,1,99,53,54,1,C
Luis Couso,2355,3,1,99,53,57,4,D
Harriet V Hunt,2389,5,4,201,42,54,12,A
Harriet V Hunt,2389,5,4,201,37,54,17,D
Haroon Azizi,2126,2,1,43,95,35,-60,A
Haroon Azizi,2126,2,1,43,86,46,-40,D
Thomas Ernst,2450,8,4.5,353,34,49,15,A
Thomas Ernst,2450,8,4.5,353,29,51,22,D
Mikael Naslund,2310,2,1,35,29,63,34,A
Mikael Naslund,2310,2,1,35,37,69,32,B
Mikael Naslund,2310,2,1,35,36,69,33,C
Mikael Naslund,2310,2,1,35,41,60,19,D
Erik Alquist,2106,1,0,27,84,63,-21,A
Erik Alquist,2106,1,0,27,57,56,-1,C
Erik Alquist,2106,1,0,27,64,56,-8,D
Mika Karttunen,2413,6,3.5,136,31,53,22,A
Mika Karttunen,2413,6,3.5,136,33,53,20,D
Juan Dalmau,2059,1,0,20,114,25,-89,A
Juan Dalmau,2059,1,0,20,98,20,-78,C
Juan Dalmau,2059,1,0,20,107,20,-87,D
Irina Tetenkina,2292,7,3.5,239,34,49,15,A
Irina Tetenkina,2292,7,3.5,239,38,48,10,D
Eric Lobron,2500,9,5,294,41,51,10,A
Eric Lobron,2500,9,5,294,37,56,19,D
Ekaterina Kovalevskaya,2452,8,6.5,193,41,53,12,A
Ekaterina Kovalevskaya,2452,8,6.5,193,40,53,13,D
Tom Wedberg,2530,9,7,226,41,57,16,A
Tom Wedberg,2530,9,7,226,30,53,23,D
Mark E Taimanov,2406,6,3,162,50,49,-1,A
Mark E Taimanov,2406,6,3,162,44,47,3,D
Jonas Lundvik,2270,3,0.5,154,43,51,8,A
Jonas Lundvik,2270,3,0.5,154,40,58,18,D
Viktoria Johansson,2142,4,1.5,131,56,47,-9,A
Viktoria Johansson,2142,4,1.5,131,45,50,5,C
Viktoria Johansson,2142,4,1.5,131,47,50,3,D
Tomi Nyback,2458,7,5,236,52,60,8,A
Tomi Nyback,2458,7,5,236,48,61,13,C
Tomi Nyback,2458,7,5,236,46,61,15,D
Hannes Stefansson,2566,6,4,147,44,59,15,A
Hannes Stefansson,2566,6,4,147,47,58,11,D
Peter Carlsten,2159,2,0,53,90,34,-56,A
Peter Carlsten,2159,2,0,53,84,26,-58,D
Lars Persson,2108,2,0.5,41,78,51,-27,A
Lars Persson,2108,2,0.5,41,78,49,-29,C
Lars Persson,2108,2,0.5,41,70,54,-16,D
Lennart Evertsson,2226,2,0,80,92,43,-49,A
Lennart Evertsson,2226,2,0,80,87,41,-46,B
Lennart Evertsson,2226,2,0,80,82,46,-36,C
Lennart Evertsson,2226,2,0,80,79,43,-36,D
Heikki Lehtinen,2332,7,3.5,222,33,53,20,A
Heikki Lehtinen,2332,7,3.5,222,33,53,20,D
Henrik Lindberg,2218,2,0.5,57,48,53,5,A
Henrik Lindberg,2218,2,0.5,57,42,60,18,C
Henrik Lindberg,2218,2,0.5,57,44,61,17,D
Valerij Popov,2568,7,4.5,229,37,55,18,A
Valerij Popov,2568,7,4.5,229,33,55,22,C
Valerij Popov,2568,7,4.5,229,31,54,23,D
Maxim Kulagin,2032,2,0,34,108,32,-76,A
Maxim Kulagin,2032,2,0,34,108,32,-76,D
Niklas Hedlund,2037,1,0,16,55,50,-5,A
Niklas Hedlund,2037,1,0,16,66,56,-10,C
Niklas Hedlund,2037,1,0,16,65,56,-9,D
Jacob Henriksson,2161,2,0.5,38,69,53,-16,A
Jacob Henriksson,2161,2,0.5,38,71,42,-29,D
Kezli Ong,2171,2,0.5,92,39,50,11,A
Kezli Ong,2171,2,0.5,92,30,47,17,D
Emanuel Berg,2535,8,6,260,28,65,37,A
Emanuel Berg,2535,8,6,260,24,66,42,C
Emanuel Berg,2535,8,6,260,27,64,37,D
Teodor Hellborg,2240,4,1.5,139,46,52,6,A
Teodor Hellborg,2240,4,1.5,139,46,56,10,C
Teodor Hellborg,2240,4,1.5,139,45,53,8,D
Erik Hedman,2336,1,0,21,112,48,-64,A
Erik Hedman,2336,1,0,21,117,67,-50,D
Alain Spielmann,2308,6,2.5,196,49,53,4,A
Alain Spielmann,2308,6,2.5,196,42,54,12,C
Alain Spielmann,2308,6,2.5,196,40,53,13,D
Mikael Jonsson,2290,1,0,45,96,47,-49,A
Mikael Jonsson,2290,1,0,45,89,51,-38,D
Johan Norberg,2153,3,0,115,61,50,-11,A
Johan Norberg,2153,3,0,115,74,43,-31,C
Johan Norberg,2153,3,0,115,69,45,-24,D
Viktoria Bashkite,2138,1,0,37,52,35,-17,A
Viktoria Bashkite,2138,1,0,37,53,38,-15,B
Viktoria Bashkite,2138,1,0,37,48,49,1,C
Viktoria Bashkite,2138,1,0,37,55,38,-17,D
Gustavo Luna,2143,1,0,53,38,57,19,A
Gustavo Luna,2143,1,0,53,41,53,12,B
Gustavo Luna,2143,1,0,53,49,42,-7,C
Gustavo Luna,2143,1,0,53,54,43,-11,D
Anneli Dalmau,2089,2,0,41,108,49,-59,A
Anneli Dalmau,2089,2,0,41,98,51,-47,D
Ragnar Nystrom,2123,1,0,17,136,29,-107,A
Ragnar Nystrom,2123,1,0,17,104,29,-75,C
Ragnar Nystrom,2123,1,0,17,125,24,-101,D
Jan Peter Palmblad,2187,2,0,75,62,40,-22,A
Jan Peter Palmblad,2187,2,0,75,79,41,-38,C
Jan Peter Palmblad,2187,2,0,75,65,47,-18,D
Hakan Hansson,2163,1,0,25,125,32,-93,A
Hakan Hansson,2163,1,0,25,113,44,-69,D
Tobias Lonngren,2122,1,0,18,73,33,-40,A
Tobias Lonngren,2122,1,0,18,100,33,-67,D
Armin Namini,2114,1,0,30,102,37,-65,A
Armin Namini,2114,1,0,30,79,37,-42,B
Armin Namini,2114,1,0,30,83,43,-40,C
Armin Namini,2114,1,0,30,76,37,-39,D
Jesper Celander,2180,2,0,50,71,52,-19,A
Jesper Celander,2180,2,0,50,82,42,-40,C
Jesper Celander,2180,2,0,50,87,40,-47,D
Anders Loven,2151,1,0,17,71,47,-24,A
Anders Loven,2151,1,0,17,66,47,-19,D
Magnus Holm,2247,1,0,30,53,60,7,A
Magnus Holm,2247,1,0,30,62,50,-12,B
Magnus Holm,2247,1,0,30,65,57,-8,C
Magnus Holm,2247,1,0,30,76,57,-19,D
Tommi Luukkonen,2081,3,1,86,51,55,4,A
Tommi Luukkonen,2081,3,1,86,41,53,12,C
Tommi Luukkonen,2081,3,1,86,47,50,3,D
Olli Sisatto,2207,1,0,24,46,62,16,A
Olli Sisatto,2207,1,0,24,55,50,-5,B
Olli Sisatto,2207,1,0,24,45,46,1,C
Olli Sisatto,2207,1,0,24,48,50,2,D
Kevin Ong,2076,1,0,46,75,46,-29,A
Kevin Ong,2076,1,0,46,39,56,17,C
Kevin Ong,2076,1,0,46,44,54,10,D
Love Janse,2152,1,0,13,174,38,-136,A
Love Janse,2152,1,0,13,151,38,-113,D
Per Isaksson,2106,1,0,23,78,48,-30,A
Per Isaksson,2106,1,0,23,75,48,-27,B
Per Isaksson,2106,1,0,23,74,48,-26,C
Per Isaksson,2106,1,0,23,77,48,-29,D
Robin Edlund,2174,1,0,31,39,48,9,A
Robin Edlund,2174,1,0,31,55,39,-16,D
Csaba Berczes,2420,9,5,305,45,49,4,A
Csaba Berczes,2420,9,5,305,37,49,12,C
Csaba Berczes,2420,9,5,305,36,51,15,D
Robert Fontaine,2572,9,6,305,47,54,7,A
Robert Fontaine,2572,9,6,305,39,60,21,C
Robert Fontaine,2572,9,6,305,41,59,18,D
Krisztian Szabo,2500,8,5,351,61,49,-12,A
Krisztian Szabo,2500,8,5,351,51,49,-2,C
Krisztian Szabo,2500,8,5,351,52,50,-2,D
Nikita Meskovs,2124,7,3.5,207,66,48,-18,A
Nikita Meskovs,2124,7,3.5,207,69,44,-25,D
Henrik Lindberg,2254,5,1.5,143,54,48,-6,A
Henrik Lindberg,2254,5,1.5,143,51,52,1,D
Radmilo Dimitrijevic,2093,8,4,266,46,48,2,A
Radmilo Dimitrijevic,2093,8,4,266,47,47,0,B
Radmilo Dimitrijevic,2093,8,4,266,45,48,3,C
Radmilo Dimitrijevic,2093,8,4,266,46,50,4,D
Evgenij Agrest,2535,9,6.5,223,42,50,8,A
Evgenij Agrest,2535,9,6.5,223,33,53,20,C
Evgenij Agrest,2535,9,6.5,223,37,52,15,D
Emanuel Berg,2583,9,6,286,41,55,14,A
Emanuel Berg,2583,9,6,286,38,55,17,B
Emanuel Berg,2583,9,6,286,39,53,14,C
Emanuel Berg,2583,9,6,286,39,54,15,D
Vasilios Kotronias,2628,9,6.5,468,36,57,21,A
Vasilios Kotronias,2628,9,6.5,468,32,59,27,B
Vasilios Kotronias,2628,9,6.5,468,32,59,27,C
Vasilios Kotronias,2628,9,6.5,468,28,61,33,D
Bengt Lindberg,2439,9,6.5,277,44,48,4,A
Bengt Lindberg,2439,9,6.5,277,37,52,15,B
Bengt Lindberg,2439,9,6.5,277,38,51,13,C
Bengt Lindberg,2439,9,6.5,277,37,51,14,D
Dara Akdag,2083,4,2,131,48,63,15,A
Dara Akdag,2083,4,2,131,42,63,21,D
Kjetil Stokke,2372,8,4.5,316,37,55,18,A
Kjetil Stokke,2372,8,4.5,316,34,56,22,B
Kjetil Stokke,2372,8,4.5,316,38,53,15,C
Kjetil Stokke,2372,8,4.5,316,36,53,17,D
Tommi Luukkonen,2244,8,3,303,54,53,-1,A
Tommi Luukkonen,2244,8,3,303,46,56,10,B
Tommi Luukkonen,2244,8,3,303,48,55,7,C
Tommi Luukkonen,2244,8,3,303,49,55,6,D
Jasmin Bejtovic,2353,7,3,252,45,50,5,A
Jasmin Bejtovic,2353,7,3,252,41,51,10,C
Jasmin Bejtovic,2353,7,3,252,42,50,8,D
Anton Frisk Kockum,2206,6,1.5,259,38,53,15,A
Anton Frisk Kockum,2206,6,1.5,259,36,55,19,C
Anton Frisk Kockum,2206,6,1.5,259,38,53,15,D
Anders Livner,2281,6,4,229,34,55,21,A
Anders Livner,2281,6,4,229,31,54,23,D
Pia Cramling,2524,9,6.5,233,28,61,33,A
Pia Cramling,2524,9,6.5,233,23,68,45,C
Pia Cramling,2524,9,6.5,233,22,65,43,D
David Berczes,2429,9,6.5,247,36,57,21,A
David Berczes,2429,9,6.5,247,31,59,28,B
David Berczes,2429,9,6.5,247,30,61,31,C
David Berczes,2429,9,6.5,247,30,59,29,D
Lars Bo Hansen,2576,9,5.5,375,35,56,21,A
Lars Bo Hansen,2576,9,5.5,375,33,53,20,B
Lars Bo Hansen,2576,9,5.5,375,28,56,28,C
Lars Bo Hansen,2576,9,5.5,375,27,57,30,D
Victor Nithander,2339,8,4,318,37,50,13,A
Victor Nithander,2339,8,4,318,31,53,22,B
Victor Nithander,2339,8,4,318,34,51,17,C
Victor Nithander,2339,8,4,318,36,49,13,D
Mikael Naslund,2310,4,1,149,54,52,-2,A
Mikael Naslund,2310,4,1,149,57,52,-5,C
Mikael Naslund,2310,4,1,149,55,51,-4,D
Rasmus Holving,2210,7,1.5,282,43,52,9,A
Rasmus Holving,2210,7,1.5,282,42,54,12,C
Rasmus Holving,2210,7,1.5,282,44,51,7,D
Lars Karlsson,2488,7,5,257,39,56,17,A
Lars Karlsson,2488,7,5,257,36,56,20,C
Lars Karlsson,2488,7,5,257,36,54,18,D
Jorgen Eriksson,2238,3,0,124,56,43,-13,A
Jorgen Eriksson,2238,3,0,124,56,42,-14,C
Jorgen Eriksson,2238,3,0,124,58,39,-19,D
Kaido Kulaots,2533,8,5.5,312,38,58,20,A
Kaido Kulaots,2533,8,5.5,312,36,60,24,C
Kaido Kulaots,2533,8,5.5,312,28,62,34,D
Joel Akesson,2344,7,2.5,216,48,52,4,A
Joel Akesson,2344,7,2.5,216,41,56,15,C
Joel Akesson,2344,7,2.5,216,40,57,17,D
Nils Grandelius,2371,8,5,244,43,53,10,A
Nils Grandelius,2371,8,5,244,37,52,15,C
Nils Grandelius,2371,8,5,244,34,53,19,D
Tiger Hillarp Persson,2535,9,5,314,49,45,-4,A
Tiger Hillarp Persson,2535,9,5,314,45,46,1,B
Tiger Hillarp Persson,2535,9,5,314,43,49,6,C
Tiger Hillarp Persson,2535,9,5,314,41,48,7,D
Sergey Ivanov,2541,10,7.5,363,46,48,2,A
Sergey Ivanov,2541,10,7.5,363,35,54,19,C
Sergey Ivanov,2541,10,7.5,363,34,55,21,D
Thomas Ernst,2448,9,5,268,41,54,13,A
Thomas Ernst,2448,9,5,268,44,54,10,D
Pontus Carlsson,2501,9,5.5,198,45,53,8,A
Pontus Carlsson,2501,9,5.5,198,37,54,17,D
Tomas Karlsson,2249,6,2,180,39,54,15,A
Tomas Karlsson,2249,6,2,180,39,56,17,C
Tomas Karlsson,2249,6,2,180,38,56,18,D
Sampsa Nyysti,2363,8,4.5,310,41,53,12,A
Sampsa Nyysti,2363,8,4.5,310,35,55,20,C
Sampsa Nyysti,2363,8,4.5,310,33,55,22,D
Olli Sisatto,2285,6,1.5,264,47,52,5,A
Olli Sisatto,2285,6,1.5,264,42,55,13,C
Olli Sisatto,2285,6,1.5,264,45,53,8,D
Juan Manuel Bellon Lopez,2455,9,5,319,41,58,17,A
Juan Manuel Bellon Lopez,2455,9,5,319,41,60,19,D
Erik Blomqvist,2302,8,4,175,67,49,-18,A
Erik Blomqvist,2302,8,4,175,56,53,-3,D
Fredrik Andersson,2229,6,1.5,106,82,44,-38,A
Fredrik Andersson,2229,6,1.5,106,86,41,-45,C
Fredrik Andersson,2229,6,1.5,106,76,42,-34,D
Johan Furhoff,2392,9,5.5,300,56,50,-6,A
Johan Furhoff,2392,9,5.5,300,51,54,3,C
Johan Furhoff,2392,9,5.5,300,52,53,1,D
Tomi Nyback,2579,9,6.5,235,36,60,24,A
Tomi Nyback,2579,9,6.5,235,27,61,34,C
Tomi Nyback,2579,9,6.5,235,26,61,35,D
Radoslaw Wojtaszek,2614,9,6.5,202,39,57,18,A
Radoslaw Wojtaszek,2614,9,6.5,202,31,59,28,C
Radoslaw Wojtaszek,2614,9,6.5,202,31,61,30,D
Ralf Akesson,2470,9,4.5,321,50,51,1,A
Ralf Akesson,2470,9,4.5,321,43,54,11,C
Ralf Akesson,2470,9,4.5,321,46,53,7,D
Ivan Farago,2475,9,6,343,32,54,22,A
Ivan Farago,2475,9,6,343,29,54,25,C
Ivan Farago,2475,9,6,343,28,55,27,D
Eva Jiretorn,2122,7,3.5,262,53,54,1,A
Eva Jiretorn,2122,7,3.5,262,45,53,8,C
Eva Jiretorn,2122,7,3.5,262,49,53,4,D
Anders Larsson,2257,8,4.5,218,44,47,3,A
Anders Larsson,2257,8,4.5,218,36,51,15,C
Anders Larsson,2257,8,4.5,218,36,50,14,D
Axel Smith,2458,8,5,283,44,52,8,A
Axel Smith,2458,8,5,283,41,51,10,D
Johan Henriksson,2197,7,3,298,44,53,9,A
Johan Henriksson,2197,7,3,298,42,51,9,C
Johan Henriksson,2197,7,3,298,41,53,12,D
Josef Ask,2235,6,3.5,192,55,52,-3,A
Josef Ask,2235,6,3.5,192,44,56,12,D
Olga Stjazhkina,2325,5,1.5,190,47,47,0,A
Olga Stjazhkina,2325,5,1.5,190,42,50,8,D
Mikko Niemi,2178,9,4,301,43,52,9,A
Mikko Niemi,2178,9,4,301,37,51,14,D
Slavko Cicak,2574,9,5.5,290,40,56,16,A
Slavko Cicak,2574,9,5.5,290,34,57,23,C
Slavko Cicak,2574,9,5.5,290,33,56,23,D
Christian Hess,2281,2,0,69,65,45,-20,A
Christian Hess,2281,2,0,69,72,46,-26,D
Tamas Ruck,2343,8,3.5,337,46,53,7,A
Tamas Ruck,2343,8,3.5,337,44,52,8,C
Tamas Ruck,2343,8,3.5,337,46,50,4,D
Michael Mattsson,2048,1,0,29,51,45,-6,A
Michael Mattsson,2048,1,0,29,60,48,-12,C
Michael Mattsson,2048,1,0,29,61,48,-13,D
Erik Hedman,2396,7,3,268,37,55,18,A
Erik Hedman,2396,7,3,268,31,56,25,C
Erik Hedman,2396,7,3,268,29,55,26,D
Bo Adler,2208,3,0,69,71,52,-19,A
Bo Adler,2208,3,0,69,57,52,-5,C
Bo Adler,2208,3,0,69,55,49,-6,D
Mikael Aroven,2201,3,1,113,59,49,-10,A
Mikael Aroven,2201,3,1,113,67,46,-21,D
Lucas Wickstrom,2115,1,0,18,79,50,-29,A
Lucas Wickstrom,2115,1,0,18,67,44,-23,C
Lucas Wickstrom,2115,1,0,18,125,39,-86,D
Erno Dede,2275,5,1.5,139,63,50,-13,A
Erno Dede,2275,5,1.5,139,65,48,-17,D
Ilja Vovk,2295,3,1,154,30,53,23,A
Ilja Vovk,2295,3,1,154,39,54,15,D
Christopher Lissang,2080,2,0.5,65,58,48,-10,A
Christopher Lissang,2080,2,0.5,65,56,52,-4,C
Christopher Lissang,2080,2,0.5,65,58,55,-3,D
Michael B. Madsen,2011,1,0,8,96,50,-46,A
Michael B. Madsen,2011,1,0,8,111,50,-61,C
Michael B. Madsen,2011,1,0,8,102,50,-52,D
Carlo Marzano,2213,2,0,59,98,37,-61,A
Carlo Marzano,2213,2,0,59,88,41,-47,C
Carlo Marzano,2213,2,0,59,86,44,-42,D
David Nygren,2158,1,0,25,93,36,-57,A
David Nygren,2158,1,0,25,84,36,-48,D
Inna Agrest,2121,1,0,30,73,60,-13,A
Inna Agrest,2121,1,0,30,108,60,-48,C
Inna Agrest,2121,1,0,30,97,63,-34,D
Arto Satonen,2215,1,0,35,52,46,-6,A
Arto Satonen,2215,1,0,35,57,43,-14,C
Arto Satonen,2215,1,0,35,45,54,9,D
Simon Hanninger,2129,2,0.5,68,33,60,27,A
Simon Hanninger,2129,2,0.5,68,40,51,11,C
Simon Hanninger,2129,2,0.5,68,38,49,11,D
Thomas Marttala,2253,3,0.5,116,50,45,-5,A
Thomas Marttala,2253,3,0.5,116,55,44,-11,C
Thomas Marttala,2253,3,0.5,116,60,41,-19,D
Ellinor Frisk,2109,1,0,50,109,44,-65,A
Ellinor Frisk,2109,1,0,50,112,36,-76,D
Lennart Evertsson,2198,3,0,107,86,47,-39,A
Lennart Evertsson,2198,3,0,107,68,45,-23,C
Lennart Evertsson,2198,3,0,107,77,41,-36,D
Michael De Verdier,2147,2,0,51,100,41,-59,A
Michael De Verdier,2147,2,0,51,100,41,-59,C
Michael De Verdier,2147,2,0,51,100,43,-57,D
Per Soderberg,2205,2,0,84,55,54,-1,A
Per Soderberg,2205,2,0,84,56,49,-7,D
Ulf Nyberg,2146,2,1,129,31,59,28,A
Ulf Nyberg,2146,2,1,129,36,63,27,D
Evgenia Hansen,2159,2,0,87,68,48,-20,A
Evgenia Hansen,2159,2,0,87,63,49,-14,C
Evgenia Hansen,2159,2,0,87,59,49,-10,D
Torbjorn Glimbrant,2275,1,0,27,84,30,-54,A
Torbjorn Glimbrant,2275,1,0,27,93,33,-60,B
Torbjorn Glimbrant,2275,1,0,27,75,37,-38,C
Torbjorn Glimbrant,2275,1,0,27,80,37,-43,D
Tobias Pettersson,2159,1,0,53,45,45,0,A
Tobias Pettersson,2159,1,0,53,45,51,6,B
Tobias Pettersson,2159,1,0,53,40,51,11,C
Tobias Pettersson,2159,1,0,53,37,55,18,D
Amir Tadjerbashi,2184,1,0,32,56,44,-12,A
Amir Tadjerbashi,2184,1,0,32,52,41,-11,C
Amir Tadjerbashi,2184,1,0,32,54,38,-16,D
Santul Kosmo,2262,1,0,20,70,30,-40,A
Santul Kosmo,2262,1,0,20,75,25,-50,C
Santul Kosmo,2262,1,0,20,69,30,-39,D
Viktoria Johansson,2203,1,0,35,48,43,-5,A
Viktoria Johansson,2203,1,0,35,36,51,15,B
Viktoria Johansson,2203,1,0,35,42,46,4,C
Viktoria Johansson,2203,1,0,35,40,40,0,D
Kent Angskog,2271,4,1,112,63,52,-11,A
Kent Angskog,2271,4,1,112,64,52,-12,D
Love Janse,2127,1,0,30,38,47,9,A
Love Janse,2127,1,0,30,32,53,21,C
Love Janse,2127,1,0,30,35,50,15,D
Konstantin Sakaev,2665,9,5.5,291,30,51,21,A
Konstantin Sakaev,2665,9,5.5,291,27,57,30,D
Alexander Riazantsev,2556,9,5.5,375,36,52,16,A
Alexander Riazantsev,2556,9,5.5,375,32,54,22,C
Alexander Riazantsev,2556,9,5.5,375,32,53,21,D
Oleg Nikolenko,2520,9,4.5,305,32,57,25,A
Oleg Nikolenko,2520,9,4.5,305,32,57,25,B
Oleg Nikolenko,2520,9,4.5,305,32,58,26,C
Oleg Nikolenko,2520,9,4.5,305,33,56,23,D
Alexander Khalifman,2668,9,5.5,205,38,47,9,A
Alexander Khalifman,2668,9,5.5,205,36,50,14,B
Alexander Khalifman,2668,9,5.5,205,36,51,15,C
Alexander Khalifman,2668,9,5.5,205,35,53,18,D
Valentina Gunina,2359,11,2.5,474,57,56,-1,A
Valentina Gunina,2359,11,2.5,474,51,55,4,B
Valentina Gunina,2359,11,2.5,474,48,54,6,C
Valentina Gunina,2359,11,2.5,474,49,52,3,D
Nadezhda Kosintseva,2469,10,5.5,494,40,49,9,A
Nadezhda Kosintseva,2469,10,5.5,494,35,53,18,B
Nadezhda Kosintseva,2469,10,5.5,494,35,54,19,C
Nadezhda Kosintseva,2469,10,5.5,494,33,54,21,D
Peter Svidler,2735,10,5,340,33,54,21,A
Peter Svidler,2735,10,5,340,29,57,28,B
Peter Svidler,2735,10,5,340,31,55,24,C
Peter Svidler,2735,10,5,340,28,60,32,D
Artyom Timofeev,2611,18,10,603,35,56,21,A
Artyom Timofeev,2611,18,10,603,33,57,24,B
Artyom Timofeev,2611,18,10,603,29,59,30,C
Artyom Timofeev,2611,18,10,603,28,59,31,D
Denis Frolov,2401,9,2.5,298,39,46,7,A
Denis Frolov,2401,9,2.5,298,37,51,14,B
Denis Frolov,2401,9,2.5,298,36,51,15,C
Denis Frolov,2401,9,2.5,298,36,51,15,D
Andrey Shariyazdanov,2575,9,4.5,267,34,54,20,A
Andrey Shariyazdanov,2575,9,4.5,267,31,58,27,B
Andrey Shariyazdanov,2575,9,4.5,267,32,53,21,C
Andrey Shariyazdanov,2575,9,4.5,267,28,57,29,D
Semen I. Dvoirys,2612,9,5,264,42,55,13,A
Semen I. Dvoirys,2612,9,5,264,36,54,18,D
Denis Khismatullin,2537,9,5,334,62,55,-7,A
Denis Khismatullin,2537,9,5,334,57,57,0,C
Denis Khismatullin,2537,9,5,334,55,56,1,D
Tatiana Shadrina,2379,11,5.5,498,39,56,17,A
Tatiana Shadrina,2379,11,5.5,498,34,56,22,C
Tatiana Shadrina,2379,11,5.5,498,34,55,21,D
Sergey I. Solovjov,2458,9,3.5,364,45,56,11,A
Sergey I. Solovjov,2458,9,3.5,364,41,56,15,C
Sergey I. Solovjov,2458,9,3.5,364,40,58,18,D
Evgeny Alekseev,2616,9,4.5,282,39,54,15,A
Evgeny Alekseev,2616,9,4.5,282,42,54,12,D
Vladimir Dobrov,2477,9,3.5,313,52,52,0,A
Vladimir Dobrov,2477,9,3.5,313,45,52,7,D
Yuri Yakovich,2596,9,5,251,32,53,21,A
Yuri Yakovich,2596,9,5,251,31,52,21,D
Konstantin Landa,2550,9,5,209,39,47,8,A
Konstantin Landa,2550,9,5,209,32,55,23,D
Evgeny Shaposhnikov,2559,9,4.5,280,33,57,24,A
Evgeny Shaposhnikov,2559,9,4.5,280,33,56,23,C
Evgeny Shaposhnikov,2559,9,4.5,280,30,60,30,D
Vitaly Tseshkovsky,2577,19,8.5,731,39,52,13,A
Vitaly Tseshkovsky,2577,19,8.5,731,35,55,20,C
Vitaly Tseshkovsky,2577,19,8.5,731,33,56,23,D
Pavel Smirnov,2601,8,5.5,361,31,61,30,A
Pavel Smirnov,2601,8,5.5,361,29,62,33,C
Pavel Smirnov,2601,8,5.5,361,25,61,36,D
Sergei Iskusnyh,2507,9,3.5,283,50,53,3,A
Sergei Iskusnyh,2507,9,3.5,283,48,58,10,D
Sergej Silivanov,2291,9,1,268,56,50,-6,A
Sergej Silivanov,2291,9,1,268,58,47,-11,D
Maksim Shapovalenko,2230,9,1,266,69,49,-20,A
Maksim Shapovalenko,2230,9,1,266,62,50,-12,D
Evgeny Bareev,2715,10,5,319,36,54,18,A
Evgeny Bareev,2715,10,5,319,32,56,24,B
Evgeny Bareev,2715,10,5,319,29,56,27,C
Evgeny Bareev,2715,10,5,319,30,57,27,D
Alexey Dreev,2698,17,11,519,36,55,19,A
Alexey Dreev,2698,17,11,519,32,56,24,B
Alexey Dreev,2698,17,11,519,28,58,30,C
Alexey Dreev,2698,17,11,519,27,60,33,D
Valerij Popov,2547,9,5.5,313,32,58,26,A
Valerij Popov,2547,9,5.5,313,26,62,36,D
Pavel V. Tregubov,2636,9,5,310,30,57,27,A
Pavel V. Tregubov,2636,9,5,310,28,59,31,D
Oleg Loskutov,2433,9,2.5,310,38,57,19,A
Oleg Loskutov,2433,9,2.5,310,35,57,22,C
Oleg Loskutov,2433,9,2.5,310,34,59,25,D
Alexander Morozevich,2758,10,5,394,28,64,36,A
Alexander Morozevich,2758,10,5,394,25,62,37,C
Alexander Morozevich,2758,10,5,394,25,65,40,D
Alexander Motylev,2651,18,11,788,30,57,27,A
Alexander Motylev,2651,18,11,788,26,59,33,C
Alexander Motylev,2651,18,11,788,25,59,34,D
Ian Nepomniachtchi,2445,9,4,336,42,52,10,A
Ian Nepomniachtchi,2445,9,4,336,38,54,16,D
Denis Yevseev,2580,9,4.5,237,39,48,9,A
Denis Yevseev,2580,9,4.5,237,36,53,17,C
Denis Yevseev,2580,9,4.5,237,35,54,19,D
Evgenija Ovod,2386,11,7,492,41,55,14,A
Evgenija Ovod,2386,11,7,492,32,56,24,C
Evgenija Ovod,2386,11,7,492,29,58,29,D
Mikhail Ulibin,2579,9,4,424,34,54,20,A
Mikhail Ulibin,2579,9,4,424,29,55,26,D
Evgenij Gajsin,2404,9,4.5,306,40,59,19,A
Evgenij Gajsin,2404,9,4.5,306,38,58,20,C
Evgenij Gajsin,2404,9,4.5,306,36,59,23,D
Sergey Ionov,2538,9,4.5,274,57,49,-8,A
Sergey Ionov,2538,9,4.5,274,49,51,2,D
Sergey Dolmatov,2573,8,3.5,198,36,46,10,A
Sergey Dolmatov,2573,8,3.5,198,38,51,13,C
Sergey Dolmatov,2573,8,3.5,198,39,49,10,D
Ekaterina Korbut,2443,11,7,476,41,52,11,A
Ekaterina Korbut,2443,11,7,476,34,53,19,C
Ekaterina Korbut,2443,11,7,476,34,54,20,D
Ekaterina Kovalevskaya,2448,11,3.5,506,38,55,17,A
Ekaterina Kovalevskaya,2448,11,3.5,506,37,56,19,C
Ekaterina Kovalevskaya,2448,11,3.5,506,38,54,16,D
Andrei Kharlov,2593,7,4,224,37,54,17,A
Andrei Kharlov,2593,7,4,224,28,57,29,D
Ildar Khairullin,2481,9,4,276,38,56,18,A
Ildar Khairullin,2481,9,4,276,35,59,24,D
Vladimir Epishin,2599,19,10.5,650,37,51,14,A
Vladimir Epishin,2599,19,10.5,650,31,53,22,C
Vladimir Epishin,2599,19,10.5,650,30,54,24,D
Natalija Pogonina,2462,11,6,517,39,52,13,A
Natalija Pogonina,2462,11,6,517,37,56,19,C
Natalija Pogonina,2462,11,6,517,37,57,20,D
Vladimir Belov,2543,9,4.5,293,40,54,14,A
Vladimir Belov,2543,9,4.5,293,30,55,25,D
Tatiana Stepovaia,2375,11,5,593,44,54,10,A
Tatiana Stepovaia,2375,11,5,593,42,54,12,C
Tatiana Stepovaia,2375,11,5,593,42,53,11,D
Elena Tairova,2391,11,7,561,45,50,5,A
Elena Tairova,2391,11,7,561,44,54,10,C
Elena Tairova,2391,11,7,561,43,54,11,D
Mikhail Kobalia,2630,9,5,384,45,51,6,A
Mikhail Kobalia,2630,9,5,384,39,52,13,C
Mikhail Kobalia,2630,9,5,384,41,50,9,D
Andrei Belozerov,2552,9,5,357,27,50,23,A
Andrei Belozerov,2552,9,5,357,24,53,29,C
Andrei Belozerov,2552,9,5,357,25,55,30,D
Sergey Ivanov,2546,8,5,286,38,48,10,A
Sergey Ivanov,2546,8,5,286,34,50,16,C
Sergey Ivanov,2546,8,5,286,33,52,19,D
Alexey Kuzmin,2567,8,3.5,290,32,59,27,A
Alexey Kuzmin,2567,8,3.5,290,25,64,39,C
Alexey Kuzmin,2567,8,3.5,290,26,63,37,D
Maxim Novikov,2426,9,3,258,57,48,-9,A
Maxim Novikov,2426,9,3,258,48,53,5,D
Maxim Sorokin,2554,9,5,352,31,55,24,A
Maxim Sorokin,2554,9,5,352,27,58,31,D
Evgeny Romanov,2392,9,5,214,39,53,14,A
Evgeny Romanov,2392,9,5,214,34,53,19,D
Ruslan Shcherbakov,2564,9,4,241,39,56,17,A
Ruslan Shcherbakov,2564,9,4,241,37,56,19,C
Ruslan Shcherbakov,2564,9,4,241,36,55,19,D
Igor Kurnosov,2543,9,4,359,40,52,12,A
Igor Kurnosov,2543,9,4,359,33,56,23,D
Sergey Volkov,2629,9,4.5,363,43,48,5,A
Sergey Volkov,2629,9,4.5,363,40,52,12,C
Sergey Volkov,2629,9,4.5,363,41,50,9,D
Igor Yagupov,2441,9,4,344,36,59,23,A
Igor Yagupov,2441,9,4,344,32,58,26,D
Svetlana Matveeva,2434,11,5.5,516,40,52,12,A
Svetlana Matveeva,2434,11,5.5,516,37,53,16,C
Svetlana Matveeva,2434,11,5.5,516,38,54,16,D
Tatiana Kosintseva,2492,10,6.5,401,41,55,14,A
Tatiana Kosintseva,2492,10,6.5,401,34,57,23,C
Tatiana Kosintseva,2492,10,6.5,401,34,56,22,D
Vladimir Kosyrev,2529,9,5,148,36,56,20,A
Vladimir Kosyrev,2529,9,5,148,30,58,28,C
Vladimir Kosyrev,2529,9,5,148,28,56,28,D
Alexander Galkin,2602,8,4,194,35,57,22,A
Alexander Galkin,2602,8,4,194,29,60,31,D
Alexander Grischuk,2704,9,5.5,281,45,45,0,A
Alexander Grischuk,2704,9,5.5,281,37,47,10,C
Alexander Grischuk,2704,9,5.5,281,36,49,13,D
Dmitry Jakovenko,2582,8,5.5,286,40,56,16,A
Dmitry Jakovenko,2582,8,5.5,286,34,61,27,C
Dmitry Jakovenko,2582,8,5.5,286,31,62,31,D
Valeri Yandemirov,2494,9,3.5,214,47,56,9,A
Valeri Yandemirov,2494,9,3.5,214,43,53,10,D
Ernesto Inarkiev,2595,9,6,309,34,51,17,A
Ernesto Inarkiev,2595,9,6,309,29,56,27,C
Ernesto Inarkiev,2595,9,6,309,31,55,24,D
Evgeniy Najer,2606,9,5.5,246,45,53,8,A
Evgeniy Najer,2606,9,5.5,246,39,55,16,C
Evgeniy Najer,2606,9,5.5,246,38,54,16,D
Sergei Yudin,2425,8,3.5,237,36,55,19,A
Sergei Yudin,2425,8,3.5,237,30,58,28,D
Alexey Korotylev,2596,19,10.5,652,40,53,13,A
Alexey Korotylev,2596,19,10.5,652,35,54,19,C
Alexey Korotylev,2596,19,10.5,652,37,53,16,D
Olga Girya,2338,11,4,460,42,53,11,A
Olga Girya,2338,11,4,460,38,57,19,C
Olga Girya,2338,11,4,460,37,56,19,D
Vladimir Burmakin,2571,9,4,363,39,49,10,A
Vladimir Burmakin,2571,9,4,363,36,56,20,C
Vladimir Burmakin,2571,9,4,363,35,59,24,D
Garry Kasparov,2813,10,7.5,411,32,60,28,A
Garry Kasparov,2813,10,7.5,411,27,59,32,C
Garry Kasparov,2813,10,7.5,411,27,62,35,D
Dmitry Andreikin,2418,9,5,224,37,53,16,A
Dmitry Andreikin,2418,9,5,224,32,54,22,D
Petr Kiriakov,2568,8,3.5,227,44,46,2,A
Petr Kiriakov,2568,8,3.5,227,43,49,6,D
Nikolay Nazarov,2256,9,0.5,290,56,48,-8,A
Nikolay Nazarov,2256,9,0.5,290,44,51,7,C
Nikolay Nazarov,2256,9,0.5,290,46,49,3,D
Vadim Zvjaginsev,2654,9,5.5,167,36,53,17,A
Vadim Zvjaginsev,2654,9,5.5,167,27,64,37,C
Vadim Zvjaginsev,2654,9,5.5,167,25,64,39,D
Alexander Rustemov,2593,9,5.5,325,39,50,11,A
Alexander Rustemov,2593,9,5.5,325,30,54,24,C
Alexander Rustemov,2593,9,5.5,325,28,54,26,D
Evgeny Gleizerov,2592,9,2.5,203,60,53,-7,A
Evgeny Gleizerov,2592,9,2.5,203,54,56,2,D
Alexei Kornev,2582,9,4,335,34,56,22,A
Alexei Kornev,2582,9,4,335,33,56,23,D
Valerij Filippov,2639,9,5,289,40,56,16,A
Valerij Filippov,2639,9,5,289,41,54,13,C
Valerij Filippov,2639,9,5,289,35,52,17,D
Alexandre Danin,2332,9,4,385,47,53,6,A
Alexandre Danin,2332,9,4,385,40,55,15,D
Valery A Loginov,2516,9,4,387,38,56,18,A
Valery A Loginov,2516,9,4,387,37,56,19,C
Valery A Loginov,2516,9,4,387,31,58,27,D
Dmitry Bocharov,2567,9,5.5,228,53,57,4,A
Dmitry Bocharov,2567,9,5.5,228,41,59,18,C
Dmitry Bocharov,2567,9,5.5,228,45,56,11,D
Alexander Lastin,2622,7,3.5,215,45,48,3,A
Alexander Lastin,2622,7,3.5,215,35,58,23,D
Sergei Rublevsky,2671,8,4.5,260,33,56,23,A
Sergei Rublevsky,2671,8,4.5,260,28,60,32,D
Pavel Maletin,2423,8,4,255,35,55,20,A
Pavel Maletin,2423,8,4,255,28,58,30,D
Evgeny E. Vorobiov,2552,8,3,180,49,52,3,A
Evgeny E. Vorobiov,2552,8,3,180,41,53,12,C
Evgeny E. Vorobiov,2552,8,3,180,41,56,15,D
Oleg M Romanishin,2605,3,2,84,33,57,24,A
Oleg M Romanishin,2605,3,2,84,34,58,24,B
Oleg M Romanishin,2605,3,2,84,36,58,22,C
Oleg M Romanishin,2605,3,2,84,32,57,25,D
Margeir Petursson,2540,1,0.5,27,24,70,46,A
Margeir Petursson,2540,1,0.5,27,32,56,24,B
Margeir Petursson,2540,1,0.5,27,32,59,27,C
Margeir Petursson,2540,1,0.5,27,34,56,22,D
Alberto David,2425,1,1,53,57,49,-8,A
Alberto David,2425,1,1,53,45,60,15,B
Alberto David,2425,1,1,53,57,53,-4,C
Alberto David,2425,1,1,53,56,49,-7,D
Leonid Yudasin,2625,2,0.5,70,51,56,5,A
Leonid Yudasin,2625,2,0.5,70,51,53,2,B
Leonid Yudasin,2625,2,0.5,70,58,51,-7,C
Leonid Yudasin,2625,2,0.5,70,52,54,2,D
Ruslan Irzhanov,2430,1,0.5,22,35,59,24,A
Ruslan Irzhanov,2430,1,0.5,22,25,59,34,B
Ruslan Irzhanov,2430,1,0.5,22,23,59,36,C
Ruslan Irzhanov,2430,1,0.5,22,25,54,29,D
Julian M Hodgson,2590,1,0.5,22,42,54,12,A
Julian M Hodgson,2590,1,0.5,22,34,54,20,B
Julian M Hodgson,2590,1,0.5,22,28,46,18,C
Julian M Hodgson,2590,1,0.5,22,20,54,34,D
Artur Yusupov,2655,4,2,97,59,44,-15,A
Artur Yusupov,2655,4,2,97,53,46,-7,D
Eugenio Torre,2535,3,1.5,90,44,61,17,A
Eugenio Torre,2535,3,1.5,90,28,69,41,B
Eugenio Torre,2535,3,1.5,90,29,67,38,C
Eugenio Torre,2535,3,1.5,90,30,71,41,D
Evgeny Bareev,2675,3,2,76,19,70,51,A
Evgeny Bareev,2675,3,2,76,18,71,53,B
Evgeny Bareev,2675,3,2,76,19,72,53,C
Evgeny Bareev,2675,3,2,76,22,68,46,D
Giorgi Giorgadze,2565,2,1,57,66,56,-10,A
Giorgi Giorgadze,2565,2,1,57,51,51,0,B
Giorgi Giorgadze,2565,2,1,57,48,54,6,C
Giorgi Giorgadze,2565,2,1,57,49,53,4,D
Marc Santo-Roman,2420,2,0.5,49,62,59,-3,A
Marc Santo-Roman,2420,2,0.5,49,49,61,12,B
Marc Santo-Roman,2420,2,0.5,49,69,55,-14,C
Marc Santo-Roman,2420,2,0.5,49,69,59,-10,D
Viacheslav Dydyshko,2510,2,1.5,52,50,40,-10,A
Viacheslav Dydyshko,2510,2,1.5,52,35,48,13,C
Viacheslav Dydyshko,2510,2,1.5,52,32,46,14,D
Jacek Gdanski,2505,1,0.5,22,46,50,4,A
Jacek Gdanski,2505,1,0.5,22,27,46,19,B
Jacek Gdanski,2505,1,0.5,22,27,54,27,C
Jacek Gdanski,2505,1,0.5,22,25,46,21,D
Yasser Seirawan,2585,1,0.5,22,34,54,20,A
Yasser Seirawan,2585,1,0.5,22,24,68,44,B
Yasser Seirawan,2585,1,0.5,22,27,68,41,C
Yasser Seirawan,2585,1,0.5,22,24,73,49,D
Peter Leko,2555,1,0.5,22,12,73,61,A
Peter Leko,2555,1,0.5,22,18,64,46,B
Peter Leko,2555,1,0.5,22,18,77,59,C
Peter Leko,2555,1,0.5,22,19,77,58,D
Espen Agdestein,2330,1,0.5,35,74,43,-31,A
Espen Agdestein,2330,1,0.5,35,59,46,-13,B
Espen Agdestein,2330,1,0.5,35,71,46,-25,C
Espen Agdestein,2330,1,0.5,35,51,54,3,D
Sune Berg Hansen,2440,1,0.5,35,69,43,-26,A
Sune Berg Hansen,2440,1,0.5,35,58,46,-12,B
Sune Berg Hansen,2440,1,0.5,35,73,43,-30,C
Sune Berg Hansen,2440,1,0.5,35,67,43,-24,D
Paul Van Der Sterren,2605,3,1.5,104,28,62,34,A
Paul Van Der Sterren,2605,3,1.5,104,26,65,39,B
Paul Van Der Sterren,2605,3,1.5,104,22,63,41,C
Paul Van Der Sterren,2605,3,1.5,104,23,62,39,D
Jon S Speelman,2605,2,1.5,75,14,71,57,A
Jon S Speelman,2605,2,1.5,75,16,67,51,B
Jon S Speelman,2605,2,1.5,75,15,72,57,C
Jon S Speelman,2605,2,1.5,75,9,73,64,D
Olav Sepp,2470,1,0,40,81,40,-41,A
Olav Sepp,2470,1,0,40,72,38,-34,B
Olav Sepp,2470,1,0,40,67,35,-32,C
Olav Sepp,2470,1,0,40,67,40,-27,D
Garry Kasparov,2815,9,6,247,47,53,6,A
Garry Kasparov,2815,9,6,247,45,53,8,B
Garry Kasparov,2815,9,6,247,34,56,22,C
Garry Kasparov,2815,9,6,247,35,54,19,D
Zurab Azmaiparashvili,2575,4,1.5,159,48,50,2,A
Zurab Azmaiparashvili,2575,4,1.5,159,40,48,8,C
Zurab Azmaiparashvili,2575,4,1.5,159,43,52,9,D
Predrag Nikolic,2655,2,1,66,32,61,29,A
Predrag Nikolic,2655,2,1,66,26,65,39,B
Predrag Nikolic,2655,2,1,66,25,62,37,C
Predrag Nikolic,2655,2,1,66,22,61,39,D
Terry Toh,2300,1,0,41,44,56,12,A
Terry Toh,2300,1,0,41,44,46,2,B
Terry Toh,2300,1,0,41,49,51,2,C
Terry Toh,2300,1,0,41,57,37,-20,D
Alexey Dreev,2650,2,1,73,52,48,-4,A
Alexey Dreev,2650,2,1,73,52,42,-10,B
Alexey Dreev,2650,2,1,73,48,45,-3,C
Alexey Dreev,2650,2,1,73,48,42,-6,D
Ivan Sokolov,2625,2,1.5,65,29,55,26,A
Ivan Sokolov,2625,2,1.5,65,31,60,29,B
Ivan Sokolov,2625,2,1.5,65,27,60,33,C
Ivan Sokolov,2625,2,1.5,65,32,57,25,D
Vladimir P Malaniuk,2610,2,0.5,47,71,47,-24,A
Vladimir P Malaniuk,2610,2,0.5,47,70,49,-21,B
Vladimir P Malaniuk,2610,2,0.5,47,74,47,-27,C
Vladimir P Malaniuk,2610,2,0.5,47,71,47,-24,D
Viktor Korchnoi,2615,1,0,22,53,59,6,A
Viktor Korchnoi,2615,1,0,22,77,54,-23,B
Viktor Korchnoi,2615,1,0,22,71,64,-7,C
Viktor Korchnoi,2615,1,0,22,76,59,-17,D
Vladislav Tkachiev,2645,2,1.5,31,82,48,-34,A
Vladislav Tkachiev,2645,2,1.5,31,95,45,-50,B
Vladislav Tkachiev,2645,2,1.5,31,59,55,-4,C
Vladislav Tkachiev,2645,2,1.5,31,53,55,2,D
Vladimir Akopian,2630,3,1.5,99,51,60,9,A
Vladimir Akopian,2630,3,1.5,99,46,60,14,B
Vladimir Akopian,2630,3,1.5,99,36,61,25,C
Vladimir Akopian,2630,3,1.5,99,37,61,24,D
Mihail Marin,2520,3,1,123,51,57,6,A
Mihail Marin,2520,3,1,123,31,56,25,D
Jon L Arnason,2525,2,1.5,51,31,61,30,A
Jon L Arnason,2525,2,1.5,51,20,71,51,C
Jon L Arnason,2525,2,1.5,51,22,69,47,D
Robert Kuczynski,2515,3,1,100,45,53,8,A
Robert Kuczynski,2515,3,1,100,55,44,-11,D
Judit Polgar,2630,7,3.5,258,38,59,21,A
Judit Polgar,2630,7,3.5,258,33,64,31,D
Robert Huebner,2605,1,1,52,13,69,56,A
Robert Huebner,2605,1,1,52,13,69,56,B
Robert Huebner,2605,1,1,52,12,75,63,C
Robert Huebner,2605,1,1,52,8,69,61,D
Kiril Georgiev,2615,2,1,93,14,67,53,A
Kiril Georgiev,2615,2,1,93,13,72,59,B
Kiril Georgiev,2615,2,1,93,18,70,52,C
Kiril Georgiev,2615,2,1,93,20,71,51,D
Alexei Shirov,2710,7,4.5,189,46,50,4,A
Alexei Shirov,2710,7,4.5,189,34,56,22,C
Alexei Shirov,2710,7,4.5,189,32,56,24,D
Lars Bo Hansen,2545,3,1.5,84,53,55,2,A
Lars Bo Hansen,2545,3,1.5,84,36,56,20,C
Lars Bo Hansen,2545,3,1.5,84,34,57,23,D
Nigel D Short,2665,3,1.5,97,62,51,-11,A
Nigel D Short,2665,3,1.5,97,46,53,7,B
Nigel D Short,2665,3,1.5,97,51,54,3,C
Nigel D Short,2665,3,1.5,97,53,49,-4,D
Johann Hjartarson,2585,3,0.5,146,50,52,2,A
Johann Hjartarson,2585,3,0.5,146,35,58,23,C
Johann Hjartarson,2585,3,0.5,146,42,57,15,D
Jeroen Piket,2640,2,2,65,44,62,18,A
Jeroen Piket,2640,2,2,65,25,62,37,B
Jeroen Piket,2640,2,2,65,26,63,37,C
Jeroen Piket,2640,2,2,65,24,63,39,D
Jun Xu,2560,2,1,62,53,56,3,A
Jun Xu,2560,2,1,62,46,60,14,B
Jun Xu,2560,2,1,62,44,60,16,C
Jun Xu,2560,2,1,62,38,58,20,D
Andrei Sokolov,2605,1,0.5,17,64,41,-23,A
Andrei Sokolov,2605,1,0.5,17,55,41,-14,B
Andrei Sokolov,2605,1,0.5,17,40,53,13,C
Andrei Sokolov,2605,1,0.5,17,40,41,1,D
Sergey Zagrebelny,2515,1,0.5,17,62,35,-27,A
Sergey Zagrebelny,2515,1,0.5,17,53,35,-18,B
Sergey Zagrebelny,2515,1,0.5,17,44,41,-3,C
Sergey Zagrebelny,2515,1,0.5,17,38,41,3,D
Christopher Lutz,2580,1,0,34,63,47,-16,A
Christopher Lutz,2580,1,0,34,63,44,-19,B
Christopher Lutz,2580,1,0,34,67,47,-20,C
Christopher Lutz,2580,1,0,34,52,53,1,D
Pablo San Segundo Carrillo,2485,1,1,26,48,69,21,A
Pablo San Segundo Carrillo,2485,1,1,26,34,65,31,B
Pablo San Segundo Carrillo,2485,1,1,26,65,58,-7,C
Pablo San Segundo Carrillo,2485,1,1,26,75,50,-25,D
Vassily Ivanchuk,2695,5,2.5,119,28,62,34,A
Vassily Ivanchuk,2695,5,2.5,119,24,65,41,D
Miguel Illescas Cordoba,2590,5,3.5,128,39,55,16,A
Miguel Illescas Cordoba,2590,5,3.5,128,28,60,32,C
Miguel Illescas Cordoba,2590,5,3.5,128,31,59,28,D
Leonid Yurtaev,2530,1,1,37,48,49,1,A
Leonid Yurtaev,2530,1,1,37,45,49,4,C
Leonid Yurtaev,2530,1,1,37,43,46,3,D
Hicham Hamdouchi,2530,1,0,34,56,53,-3,A
Hicham Hamdouchi,2530,1,0,34,52,59,7,D
Mikhail Ulibin,2510,2,1.5,70,24,66,42,A
Mikhail Ulibin,2510,2,1.5,70,33,54,21,B
Mikhail Ulibin,2510,2,1.5,70,24,56,32,C
Mikhail Ulibin,2510,2,1.5,70,27,53,26,D
Michael Adams,2640,4,3,150,27,55,28,A
Michael Adams,2640,4,3,150,24,55,31,B
Michael Adams,2640,4,3,150,24,55,31,C
Michael Adams,2640,4,3,150,20,59,39,D
Pablo Ricardi,2495,1,0,43,29,46,17,A
Pablo Ricardi,2495,1,0,43,27,54,27,B
Pablo Ricardi,2495,1,0,43,26,63,37,C
Pablo Ricardi,2495,1,0,43,30,56,26,D
Jan H Timman,2635,3,0.5,78,52,54,2,A
Jan H Timman,2635,3,0.5,78,50,59,9,C
Jan H Timman,2635,3,0.5,78,47,58,11,D
Boris F Gulko,2590,4,2.5,140,48,54,6,A
Boris F Gulko,2590,4,2.5,140,39,57,18,D
Boris Gelfand,2685,4,1.5,156,32,62,30,A
Boris Gelfand,2685,4,1.5,156,30,60,30,C
Boris Gelfand,2685,4,1.5,156,29,63,34,D
Veselin Topalov,2645,6,5,199,43,59,16,A
Veselin Topalov,2645,6,5,199,38,60,22,C
Veselin Topalov,2645,6,5,199,34,65,31,D
Lasha Janjghava,2500,2,0,66,73,47,-26,A
Lasha Janjghava,2500,2,0,66,72,52,-20,C
Lasha Janjghava,2500,2,0,66,61,56,-5,D
Vidmantas Malisauskas,2510,1,0.5,38,16,63,47,A
Vidmantas Malisauskas,2510,1,0.5,38,20,58,38,B
Vidmantas Malisauskas,2510,1,0.5,38,15,66,51,C
Vidmantas Malisauskas,2510,1,0.5,38,12,68,56,D
Marek Matlak,2490,1,0.5,29,56,48,-8,A
Marek Matlak,2490,1,0.5,29,44,48,4,B
Marek Matlak,2490,1,0.5,29,43,45,2,C
Marek Matlak,2490,1,0.5,29,42,45,3,D
Raouf Gadjily,2260,1,0.5,29,61,41,-20,A
Raouf Gadjily,2260,1,0.5,29,50,48,-2,B
Raouf Gadjily,2260,1,0.5,29,49,41,-8,C
Raouf Gadjily,2260,1,0.5,29,54,38,-16,D
Joel Lautier,2645,4,1.5,77,36,51,15,A
Joel Lautier,2645,4,1.5,77,33,58,25,C
Joel Lautier,2645,4,1.5,77,30,58,28,D
Alon Greenfeld,2610,1,0,26,36,69,33,A
Alon Greenfeld,2610,1,0,26,30,73,43,B
Alon Greenfeld,2610,1,0,26,32,65,33,C
Alon Greenfeld,2610,1,0,26,28,69,41,D
Valery A Loginov,2510,1,0,26,67,46,-21,A
Valery A Loginov,2510,1,0,26,73,50,-23,C
Valery A Loginov,2510,1,0,26,51,50,-1,D
Ian Rogers,2560,1,0.5,22,42,46,4,A
Ian Rogers,2560,1,0.5,22,40,41,1,C
Ian Rogers,2560,1,0.5,22,29,50,21,D
Amador Rodriguez Cepedes,2515,1,0.5,38,19,71,52,A
Amador Rodriguez Cepedes,2515,1,0.5,38,19,68,49,B
Amador Rodriguez Cepedes,2515,1,0.5,38,21,71,50,C
Amador Rodriguez Cepedes,2515,1,0.5,38,22,63,41,D
Viktor Bologan,2600,1,0.5,38,20,58,38,A
Viktor Bologan,2600,1,0.5,38,22,60,38,B
Viktor Bologan,2600,1,0.5,38,28,53,25,C
Viktor Bologan,2600,1,0.5,38,27,58,31,D
Einar Gausel,2505,1,0.5,25,29,68,39,A
Einar Gausel,2505,1,0.5,25,24,64,40,C
Einar Gausel,2505,1,0.5,25,25,64,39,D
Emir Dizdarevic,2495,1,1,23,67,57,-10,A
Emir Dizdarevic,2495,1,1,23,49,61,12,B
Emir Dizdarevic,2495,1,1,23,74,61,-13,C
Emir Dizdarevic,2495,1,1,23,70,52,-18,D
Federico Manca,2375,1,0,23,90,44,-46,A
Federico Manca,2375,1,0,23,89,48,-41,B
Federico Manca,2375,1,0,23,130,39,-91,C
Federico Manca,2375,1,0,23,122,39,-83,D
Alexander Morozevich,2575,4,2,124,55,54,-1,A
Alexander Morozevich,2575,4,2,124,37,58,21,D
Igor Miladinovic,2350,1,0,38,39,53,14,A
Igor Miladinovic,2350,1,0,38,37,50,13,B
Igor Miladinovic,2350,1,0,38,35,50,15,C
Igor Miladinovic,2350,1,0,38,42,47,5,D
Vladimir Kramnik,2725,3,2.5,116,22,59,37,A
Vladimir Kramnik,2725,3,2.5,116,23,65,42,C
Vladimir Kramnik,2725,3,2.5,116,24,59,35,D
Branko Damljanovic,2505,2,0,87,48,47,-1,A
Branko Damljanovic,2505,2,0,87,43,52,9,C
Branko Damljanovic,2505,2,0,87,44,46,2,D
Vadim Milov,2565,1,0.5,36,44,42,-2,A
Vadim Milov,2565,1,0.5,36,31,50,19,B
Vadim Milov,2565,1,0.5,36,36,58,22,C
Vadim Milov,2565,1,0.5,36,37,56,19,D
Anthony J Miles,2570,2,0.5,64,60,59,-1,A
Anthony J Miles,2570,2,0.5,64,46,56,10,B
Anthony J Miles,2570,2,0.5,64,48,55,7,C
Anthony J Miles,2570,2,0.5,64,42,56,14,D
Kevin Spraggett,2530,1,1,35,34,51,17,A
Kevin Spraggett,2530,1,1,35,31,57,26,C
Kevin Spraggett,2530,1,1,35,33,54,21,D
Eric Lobron,2580,2,0.5,60,44,43,-1,A
Eric Lobron,2580,2,0.5,60,36,52,16,B
Eric Lobron,2580,2,0.5,60,39,50,11,C
Eric Lobron,2580,2,0.5,60,36,57,21,D
Jordi Magem Badals,2520,1,0.5,27,20,59,39,A
Jordi Magem Badals,2520,1,0.5,27,33,56,23,B
Jordi Magem Badals,2520,1,0.5,27,33,59,26,C
Jordi Magem Badals,2520,1,0.5,27,29,56,27,D
Reynaldo Vera Gonzalez-Quevedo,2485,1,0.5,32,58,50,-8,A
Reynaldo Vera Gonzalez-Quevedo,2485,1,0.5,32,47,53,6,C
Reynaldo Vera Gonzalez-Quevedo,2485,1,0.5,32,53,56,3,D
Sergei Tiviakov,2480,2,1.5,62,44,61,17,A
Sergei Tiviakov,2480,2,1.5,62,38,63,25,C
Sergei Tiviakov,2480,2,1.5,62,49,63,14,D
Viktor D Kupreichik,2545,2,1,74,30,65,35,A
Viktor D Kupreichik,2545,2,1,74,33,66,33,C
Viktor D Kupreichik,2545,2,1,74,30,66,36,D
Julio E Granda Zuniga,2620,1,0,25,58,48,-10,A
Julio E Granda Zuniga,2620,1,0,25,42,60,18,C
Julio E Granda Zuniga,2620,1,0,25,42,64,22,D
Javier B. Campos Moreno,2445,1,1,55,19,71,52,A
Javier B. Campos Moreno,2445,1,1,55,17,75,58,C
Javier B. Campos Moreno,2445,1,1,55,19,67,48,D
Erling Mortensen,2500,2,0,73,48,45,-3,A
Erling Mortensen,2500,2,0,73,46,47,1,C
Erling Mortensen,2500,2,0,73,44,51,7,D
Peter Svidler,2550,3,1.5,105,38,50,12,A
Peter Svidler,2550,3,1.5,105,38,52,14,C
Peter Svidler,2550,3,1.5,105,41,48,7,D
Darius Ruzele,2495,3,1.5,98,45,56,11,A
Darius Ruzele,2495,3,1.5,98,45,58,13,C
Darius Ruzele,2495,3,1.5,98,45,59,14,D
Jan Plachetka,2420,1,0,13,153,38,-115,A
Jan Plachetka,2420,1,0,13,139,31,-108,C
Jan Plachetka,2420,1,0,13,122,38,-84,D
Jiangchuan Ye,2575,1,0,23,72,56,-16,A
Jiangchuan Ye,2575,1,0,23,85,39,-46,C
Jiangchuan Ye,2575,1,0,23,92,39,-53,D
Spyridon Skembris,2525,1,0,23,52,52,0,A
Spyridon Skembris,2525,1,0,23,46,61,15,D
Ljubomir Ljubojevic,2580,3,1.5,64,35,45,10,A
Ljubomir Ljubojevic,2580,3,1.5,64,31,47,16,C
Ljubomir Ljubojevic,2580,3,1.5,64,26,50,24,D
Joel Benjamin,2610,1,1,44,51,52,1,A
Joel Benjamin,2610,1,1,44,56,45,-11,C
Joel Benjamin,2610,1,1,44,46,54,8,D
Petar Popovic,2530,2,0.5,68,42,54,12,A
Petar Popovic,2530,2,0.5,68,42,62,20,C
Petar Popovic,2530,2,0.5,68,49,53,4,D
Grigory Serper,2420,1,0.5,32,86,38,-48,A
Grigory Serper,2420,1,0.5,32,40,41,1,B
Grigory Serper,2420,1,0.5,32,52,38,-14,C
Grigory Serper,2420,1,0.5,32,47,38,-9,D
Zigurds Lanka,2540,2,1.5,53,74,34,-40,A
Zigurds Lanka,2540,2,1.5,53,41,40,-1,B
Zigurds Lanka,2540,2,1.5,53,42,42,0,C
Zigurds Lanka,2540,2,1.5,53,34,43,9,D
Ilia Smirin,2615,1,1,23,50,52,2,A
Ilia Smirin,2615,1,1,23,36,56,20,B
Ilia Smirin,2615,1,1,23,38,52,14,C
Ilia Smirin,2615,1,1,23,34,52,18,D
Bogdan Lalic,2500,2,1,78,48,59,11,A
Bogdan Lalic,2500,2,1,78,29,65,36,D
Dorian Rogozenco,2557,2,2,60,41,68,27,A
Dorian Rogozenco,2557,2,2,60,37,65,28,B
Dorian Rogozenco,2557,2,2,60,37,68,31,C
Dorian Rogozenco,2557,2,2,60,40,67,27,D
Walter Wittmann,2390,1,0,29,78,52,-26,A
Walter Wittmann,2390,1,0,29,79,48,-31,B
Walter Wittmann,2390,1,0,29,93,52,-41,C
Walter Wittmann,2390,1,0,29,94,55,-39,D
Vadim Zvjaginsev,2585,1,1,35,23,60,37,A
Vadim Zvjaginsev,2585,1,1,35,18,66,48,C
Vadim Zvjaginsev,2585,1,1,35,20,54,34,D
Zbynek Hracek,2530,1,1,51,31,53,22,A
Zbynek Hracek,2530,1,1,51,35,49,14,B
Zbynek Hracek,2530,1,1,51,38,41,3,C
Zbynek Hracek,2530,1,1,51,35,41,6,D
Vasilios Kotronias,2570,2,0.5,73,40,48,8,A
Vasilios Kotronias,2570,2,0.5,73,38,49,11,B
Vasilios Kotronias,2570,2,0.5,73,36,52,16,C
Vasilios Kotronias,2570,2,0.5,73,37,49,12,D
John T. H. Van Der Wiel,2555,2,2,51,51,53,2,A
John T. H. Van Der Wiel,2555,2,2,51,44,57,13,C
John T. H. Van Der Wiel,2555,2,2,51,37,59,22,D
Vlastimil Babula,2515,1,0,17,102,53,-49,A
Vlastimil Babula,2515,1,0,17,78,53,-25,B
Vlastimil Babula,2515,1,0,17,86,53,-33,C
Vlastimil Babula,2515,1,0,17,68,53,-15,D
Daniel H. Campora,2560,1,1,45,41,58,17,A
Daniel H. Campora,2560,1,1,45,33,60,27,C
Daniel H. Campora,2560,1,1,45,26,62,36,D
Artashes Minasian,2525,1,0.5,74,34,47,13,A
Artashes Minasian,2525,1,0.5,74,34,43,9,B
Artashes Minasian,2525,1,0.5,74,32,43,11,C
Artashes Minasian,2525,1,0.5,74,32,45,13,D
Goran Dizdar,2465,1,0.5,73,38,44,6,A
Goran Dizdar,2465,1,0.5,73,32,44,12,B
Goran Dizdar,2465,1,0.5,73,33,41,8,C
Goran Dizdar,2465,1,0.5,73,33,36,3,D
Anh Dung Nguyen,2340,1,0,30,54,50,-4,A
Anh Dung Nguyen,2340,1,0,30,41,50,9,B
Anh Dung Nguyen,2340,1,0,30,46,50,4,C
Anh Dung Nguyen,2340,1,0,30,35,63,28,D
Constantin Ionescu,2465,1,0.5,24,46,50,4,A
Constantin Ionescu,2465,1,0.5,24,32,58,26,B
Constantin Ionescu,2465,1,0.5,24,38,46,8,C
Constantin Ionescu,2465,1,0.5,24,42,46,4,D
Lajos Portisch,2610,1,1,54,37,57,20,A
Lajos Portisch,2610,1,1,54,26,57,31,B
Lajos Portisch,2610,1,1,54,28,57,29,C
Lajos Portisch,2610,1,1,54,32,59,27,D
Mikhail Rytshagov,2460,2,1,63,44,57,13,A
Mikhail Rytshagov,2460,2,1,63,46,54,8,C
Mikhail Rytshagov,2460,2,1,63,42,51,9,D
Lembit Oll,2475,4,1.5,122,51,57,6,A
Lembit Oll,2475,4,1.5,122,43,54,11,C
Lembit Oll,2475,4,1.5,122,42,55,13,D
Lubomir Ftacnik,2570,1,0.5,31,29,52,23,A
Lubomir Ftacnik,2570,1,0.5,31,26,52,26,D
Vasil Spasov,2525,3,1,93,59,57,-2,A
Vasil Spasov,2525,3,1,93,47,63,16,C
Vasil Spasov,2525,3,1,93,43,65,22,D
Jonathan D Tisdall,2465,1,0,22,90,27,-63,A
Jonathan D Tisdall,2465,1,0,22,56,46,-10,B
Jonathan D Tisdall,2465,1,0,22,75,32,-43,C
Jonathan D Tisdall,2465,1,0,22,50,46,-4,D
Andrei Istratescu,2515,2,0.5,49,50,59,9,A
Andrei Istratescu,2515,2,0.5,49,40,55,15,C
Andrei Istratescu,2515,2,0.5,49,36,57,21,D
Loek Van Wely,2560,1,0.5,18,23,72,49,A
Loek Van Wely,2560,1,0.5,18,31,56,25,C
Loek Van Wely,2560,1,0.5,18,24,61,37,D
Lev Psakhis,2615,1,0,50,49,42,-7,A
Lev Psakhis,2615,1,0,50,49,42,-7,B
Lev Psakhis,2615,1,0,50,44,42,-2,C
Lev Psakhis,2615,1,0,50,43,50,7,D
Utut Adianto,2520,1,0.5,14,33,50,17,A
Utut Adianto,2520,1,0.5,14,28,71,43,B
Utut Adianto,2520,1,0.5,14,33,64,31,C
Utut Adianto,2520,1,0.5,14,43,64,21,D
Jamshed Isaev,2380,1,0,40,66,40,-26,A
Jamshed Isaev,2380,1,0,40,50,40,-10,B
Jamshed Isaev,2380,1,0,40,44,38,-6,C
Jamshed Isaev,2380,1,0,40,44,38,-6,D
Vasily Yemelin,2520,1,0,32,77,50,-27,A
Vasily Yemelin,2520,1,0,32,80,47,-33,B
Vasily Yemelin,2520,1,0,32,94,44,-50,C
Vasily Yemelin,2520,1,0,32,96,47,-49,D
Gennadi Zaichik,2530,1,1,31,50,45,-5,A
Gennadi Zaichik,2530,1,1,31,40,55,15,B
Gennadi Zaichik,2530,1,1,31,42,45,3,C
Gennadi Zaichik,2530,1,1,31,42,48,6,D
Vladimir Dimitrov,2475,1,1,42,26,64,38,A
Vladimir Dimitrov,2475,1,1,42,42,60,18,B
Vladimir Dimitrov,2475,1,1,42,40,67,27,C
Vladimir Dimitrov,2475,1,1,42,41,67,26,D
Nasib Ginting,2395,1,0,41,85,54,-31,A
Nasib Ginting,2395,1,0,41,66,51,-15,B
Nasib Ginting,2395,1,0,41,60,66,6,C
Nasib Ginting,2395,1,0,41,58,51,-7,D
Heikki M. J. Westerinen,2370,1,0,45,34,44,10,A
Heikki M. J. Westerinen,2370,1,0,45,28,42,14,B
Heikki M. J. Westerinen,2370,1,0,45,27,51,24,C
Heikki M. J. Westerinen,2370,1,0,45,25,49,24,D
Alex Yermolinsky,2590,1,1,45,18,64,46,A
Alex Yermolinsky,2590,1,1,45,13,67,54,B
Alex Yermolinsky,2590,1,1,45,17,53,36,C
Alex Yermolinsky,2590,1,1,45,17,60,43,D
Walter Arencibia Rodriguez,2480,1,0,46,19,59,40,A
Walter Arencibia Rodriguez,2480,1,0,46,21,54,33,B
Walter Arencibia Rodriguez,2480,1,0,46,23,61,38,C
Walter Arencibia Rodriguez,2480,1,0,46,23,59,36,D
Eduardas Rozentalis,2595,1,0.5,20,70,55,-15,A
Eduardas Rozentalis,2595,1,0.5,20,22,65,43,D
Edvins Kengis,2580,1,1,35,36,57,21,A
Edvins Kengis,2580,1,1,35,41,54,13,C
Edvins Kengis,2580,1,1,35,32,49,17,D
Vladislav Nevednichy,2470,1,1,37,57,38,-19,A
Vladislav Nevednichy,2470,1,1,37,49,38,-11,B
Vladislav Nevednichy,2470,1,1,37,48,40,-8,C
Vladislav Nevednichy,2470,1,1,37,45,46,1,D
Smbat G Lputian,2590,1,0,36,68,39,-29,A
Smbat G Lputian,2590,1,0,36,58,39,-19,B
Smbat G Lputian,2590,1,0,36,54,44,-10,C
Smbat G Lputian,2590,1,0,36,54,42,-12,D
Lluis Oms Fuentes,2327,8,5,268,49,54,5,A
Lluis Oms Fuentes,2327,8,5,268,47,57,10,C
Lluis Oms Fuentes,2327,8,5,268,45,54,9,D
Adrian Villuendas Valero,2176,8,5.5,251,43,56,13,A
Adrian Villuendas Valero,2176,8,5.5,251,37,57,20,C
Adrian Villuendas Valero,2176,8,5.5,251,38,57,19,D
Pablo Glavina,2418,8,4.5,233,36,57,21,A
Pablo Glavina,2418,8,4.5,233,39,54,15,B
Pablo Glavina,2418,8,4.5,233,39,54,15,C
Pablo Glavina,2418,8,4.5,233,39,55,16,D
Borja Zamarbide Inarrea,2202,8,2.5,250,70,41,-29,A
Borja Zamarbide Inarrea,2202,8,2.5,250,68,43,-25,B
Borja Zamarbide Inarrea,2202,8,2.5,250,71,41,-30,C
Borja Zamarbide Inarrea,2202,8,2.5,250,71,42,-29,D
Jesus Javier Cortes Bueno,2314,7,4,228,39,57,18,A
Jesus Javier Cortes Bueno,2314,7,4,228,37,55,18,B
Jesus Javier Cortes Bueno,2314,7,4,228,38,54,16,C
Jesus Javier Cortes Bueno,2314,7,4,228,39,53,14,D
Antonio Lisarri Tomas,1961,2,0,35,76,37,-39,A
Antonio Lisarri Tomas,1961,2,0,35,71,43,-28,C
Antonio Lisarri Tomas,1961,2,0,35,68,46,-22,D
Jesus Cortes Lizano,2270,8,5,238,61,48,-13,A
Jesus Cortes Lizano,2270,8,5,238,57,50,-7,B
Jesus Cortes Lizano,2270,8,5,238,59,49,-10,C
Jesus Cortes Lizano,2270,8,5,238,58,51,-7,D
Alejandra Porras Mateo,1875,2,0,40,142,35,-107,A
Alejandra Porras Mateo,1875,2,0,40,116,37,-79,B
Alejandra Porras Mateo,1875,2,0,40,112,45,-67,C
Alejandra Porras Mateo,1875,2,0,40,116,48,-68,D
Miguel Argaya Urdaniz,2054,3,0.5,71,99,41,-58,A
Miguel Argaya Urdaniz,2054,3,0.5,71,89,37,-52,B
Miguel Argaya Urdaniz,2054,3,0.5,71,110,31,-79,C
Miguel Argaya Urdaniz,2054,3,0.5,71,96,30,-66,D
Tatiana Kononenko,2375,17,7.5,570,45,50,5,A
Tatiana Kononenko,2375,17,7.5,570,42,49,7,B
Tatiana Kononenko,2375,17,7.5,570,41,49,8,C
Tatiana Kononenko,2375,17,7.5,570,42,51,9,D
Fernando Lopez Gracia,2348,9,3.5,146,49,51,2,A
Fernando Lopez Gracia,2348,9,3.5,146,46,53,7,C
Fernando Lopez Gracia,2348,9,3.5,146,50,54,4,D
David Monell Camarasa,2212,9,4,327,41,52,11,A
David Monell Camarasa,2212,9,4,327,39,55,16,C
David Monell Camarasa,2212,9,4,327,38,54,16,D
Iraitz Mauleon Gutierrez,1863,1,0,22,127,41,-86,A
Iraitz Mauleon Gutierrez,1863,1,0,22,152,41,-111,B
Iraitz Mauleon Gutierrez,1863,1,0,22,119,45,-74,C
Iraitz Mauleon Gutierrez,1863,1,0,22,136,36,-100,D
Inigo Argandona Riveiro,2396,9,4,275,49,48,-1,A
Inigo Argandona Riveiro,2396,9,4,275,36,57,21,D
Oleg Korneev,2657,16,7.5,472,39,56,17,A
Oleg Korneev,2657,16,7.5,472,36,57,21,C
Oleg Korneev,2657,16,7.5,472,35,57,22,D
Daniel Moreno Gracia,2176,5,2,160,86,38,-48,A
Daniel Moreno Gracia,2176,5,2,160,82,37,-45,C
Daniel Moreno Gracia,2176,5,2,160,78,37,-41,D
Rafael Ruiz Escobar,1975,2,1,106,68,44,-24,A
Rafael Ruiz Escobar,1975,2,1,106,66,42,-24,B
Rafael Ruiz Escobar,1975,2,1,106,67,39,-28,C
Rafael Ruiz Escobar,1975,2,1,106,65,38,-27,D
Aitor Alcaide Luque,2100,6,3.5,169,65,44,-21,A
Aitor Alcaide Luque,2100,6,3.5,169,51,47,-4,C
Aitor Alcaide Luque,2100,6,3.5,169,62,45,-17,D
Jordi Magem Badals,2487,8,6,170,32,59,27,A
Jordi Magem Badals,2487,8,6,170,31,59,28,C
Jordi Magem Badals,2487,8,6,170,30,59,29,D
Alexei Shirov,2720,7,4.5,216,34,62,28,A
Alexei Shirov,2720,7,4.5,216,24,68,44,D
Radoslaw Wojtaszek,2630,7,3,209,40,55,15,A
Radoslaw Wojtaszek,2630,7,3,209,35,54,19,D
Aurelio Vila Dupla,2208,9,2,329,62,47,-15,A
Aurelio Vila Dupla,2208,9,2,329,59,49,-10,C
Aurelio Vila Dupla,2208,9,2,329,57,50,-7,D
Manuel Perez Candelario,2496,9,4.5,222,58,49,-9,A
Manuel Perez Candelario,2496,9,4.5,222,49,48,-1,D
Santiago Gonzalez De La Torre,2357,9,4,334,52,48,-4,A
Santiago Gonzalez De La Torre,2357,9,4,334,57,49,-8,D
Ivan Salgado Lopez,2425,9,5.5,324,51,51,0,A
Ivan Salgado Lopez,2425,9,5.5,324,53,54,1,C
Ivan Salgado Lopez,2425,9,5.5,324,53,55,2,D
Antonio Labena Bernal,2003,5,2.5,165,44,55,11,A
Antonio Labena Bernal,2003,5,2.5,165,49,50,1,C
Antonio Labena Bernal,2003,5,2.5,165,43,50,7,D
Miguel Navarro Cia,2297,9,4,365,40,53,13,A
Miguel Navarro Cia,2297,9,4,365,40,58,18,C
Miguel Navarro Cia,2297,9,4,365,41,57,16,D
Stuart C Conquest,2530,8,6.5,235,46,54,8,A
Stuart C Conquest,2530,8,6.5,235,41,53,12,C
Stuart C Conquest,2530,8,6.5,235,41,56,15,D
Alexander Morozevich,2747,7,6,294,36,57,21,A
Alexander Morozevich,2747,7,6,294,23,64,41,D
Claude Landenbergue,2446,9,3.5,303,45,48,3,A
Claude Landenbergue,2446,9,3.5,303,47,54,7,C
Claude Landenbergue,2446,9,3.5,303,46,50,4,D
Santiago Arjona Martinez,1985,5,2.5,169,60,50,-10,A
Santiago Arjona Martinez,1985,5,2.5,169,48,50,2,C
Santiago Arjona Martinez,1985,5,2.5,169,54,44,-10,D
Mikel Huerga Leache,2315,7,5.5,187,44,51,7,A
Mikel Huerga Leache,2315,7,5.5,187,42,52,10,C
Mikel Huerga Leache,2315,7,5.5,187,38,52,14,D
Olga Alexandrova,2371,9,5.5,224,42,50,8,A
Olga Alexandrova,2371,9,5.5,224,34,56,22,C
Olga Alexandrova,2371,9,5.5,224,39,53,14,D
Aleksa Strikovic,2535,9,8,229,36,56,20,A
Aleksa Strikovic,2535,9,8,229,29,58,29,C
Aleksa Strikovic,2535,9,8,229,27,61,34,D
Gustavo Barrenechea Bahamonde,2191,7,4,196,49,53,4,A
Gustavo Barrenechea Bahamonde,2191,7,4,196,44,57,13,C
Gustavo Barrenechea Bahamonde,2191,7,4,196,43,55,12,D
Inigo Montoya Irigoyen,2064,2,0.5,57,59,44,-15,A
Inigo Montoya Irigoyen,2064,2,0.5,57,51,40,-11,B
Inigo Montoya Irigoyen,2064,2,0.5,57,55,44,-11,C
Inigo Montoya Irigoyen,2064,2,0.5,57,54,44,-10,D
Juan Carlos Lakunza Oyarbide,2175,5,3.5,115,52,52,0,A
Juan Carlos Lakunza Oyarbide,2175,5,3.5,115,44,52,8,C
Juan Carlos Lakunza Oyarbide,2175,5,3.5,115,41,53,12,D
Miguel Illescas Cordoba,2620,7,2.5,210,51,56,5,A
Miguel Illescas Cordoba,2620,7,2.5,210,41,55,14,D
Viktor Laznicka,2596,7,2,289,42,56,14,A
Viktor Laznicka,2596,7,2,289,32,58,26,D
Mariano De Pablos Fernandez,2025,1,0,30,116,33,-83,A
Mariano De Pablos Fernandez,2025,1,0,30,112,33,-79,B
Mariano De Pablos Fernandez,2025,1,0,30,108,40,-68,C
Mariano De Pablos Fernandez,2025,1,0,30,108,37,-71,D
Alfonso Llorente Zaro,2419,6,5,145,30,50,20,A
Alfonso Llorente Zaro,2419,6,5,145,26,59,33,C
Alfonso Llorente Zaro,2419,6,5,145,28,57,29,D
Christian Bauer,2585,7,4,291,36,63,27,A
Christian Bauer,2585,7,4,291,29,64,35,D
Eduardo Ros Octavio De Toledo,2166,5,2.5,191,45,49,4,A
Eduardo Ros Octavio De Toledo,2166,5,2.5,191,37,48,11,D
Adrian Leranoz Zabalza,2061,4,2,93,65,58,-7,A
Adrian Leranoz Zabalza,2061,4,2,93,64,51,-13,C
Adrian Leranoz Zabalza,2061,4,2,93,60,46,-14,D
Joseba Otano Villanueva,1877,1,0,22,125,18,-107,A
Joseba Otano Villanueva,1877,1,0,22,109,23,-86,B
Joseba Otano Villanueva,1877,1,0,22,91,27,-64,C
Joseba Otano Villanueva,1877,1,0,22,80,23,-57,D
Eric Prie,2516,9,3,304,48,53,5,A
Eric Prie,2516,9,3,304,45,54,9,C
Eric Prie,2516,9,3,304,47,53,6,D
Eduardo Burguete Archel,2151,4,1.5,189,42,51,9,A
Eduardo Burguete Archel,2151,4,1.5,189,48,52,4,D
Dmitry Jakovenko,2671,7,5,298,42,57,15,A
Dmitry Jakovenko,2671,7,5,298,27,60,33,D
Gregorio Sola Plaza,2102,2,0,61,68,44,-24,A
Gregorio Sola Plaza,2102,2,0,61,72,48,-24,C
Gregorio Sola Plaza,2102,2,0,61,59,43,-16,D
Jose Miguel Ugalde Ezcurra,2215,9,6,236,39,56,17,A
Jose Miguel Ugalde Ezcurra,2215,9,6,236,37,55,18,C
Jose Miguel Ugalde Ezcurra,2215,9,6,236,38,53,15,D
Casimiro Ballina Amandi,2007,2,0,50,63,32,-31,A
Casimiro Ballina Amandi,2007,2,0,50,42,42,0,C
Casimiro Ballina Amandi,2007,2,0,50,47,44,-3,D
Joan Escofet Llongueras,1906,1,0,18,89,28,-61,A
Joan Escofet Llongueras,1906,1,0,18,115,28,-87,B
Joan Escofet Llongueras,1906,1,0,18,106,28,-78,C
Joan Escofet Llongueras,1906,1,0,18,109,33,-76,D
Ahmed Tarek Fahmy Moursy,1883,1,0,37,54,43,-11,A
Ahmed Tarek Fahmy Moursy,1883,1,0,37,62,51,-11,C
Ahmed Tarek Fahmy Moursy,1883,1,0,37,67,51,-16,D
Juan Mario Gomez Esteban,2486,9,4,432,40,56,16,A
Juan Mario Gomez Esteban,2486,9,4,432,37,55,18,C
Juan Mario Gomez Esteban,2486,9,4,432,37,55,18,D
Elizabeth Riera Morilla,1983,1,0,34,50,41,-9,A
Elizabeth Riera Morilla,1983,1,0,34,56,44,-12,C
Elizabeth Riera Morilla,1983,1,0,34,58,41,-17,D
Raul Garcia,2233,5,2,159,52,57,5,A
Raul Garcia,2233,5,2,159,49,57,8,D
David Arjol Echeverria,2073,4,2.5,134,61,48,-13,A
David Arjol Echeverria,2073,4,2.5,134,51,57,6,C
David Arjol Echeverria,2073,4,2.5,134,55,54,-1,D
Carlos Perez Marchal,2000,1,0,21,87,29,-58,A
Carlos Perez Marchal,2000,1,0,21,77,24,-53,C
Carlos Perez Marchal,2000,1,0,21,87,24,-63,D
Azer Mirzoev,2543,9,7,282,39,49,10,A
Azer Mirzoev,2543,9,7,282,35,51,16,C
Azer Mirzoev,2543,9,7,282,33,52,19,D
Daniel Gomez Anadon,2268,5,2.5,182,58,52,-6,A
Daniel Gomez Anadon,2268,5,2.5,182,57,52,-5,C
Daniel Gomez Anadon,2268,5,2.5,182,52,50,-2,D
Ignacio Eguia Cambero,1913,1,0,22,50,32,-18,A
Ignacio Eguia Cambero,1913,1,0,22,44,32,-12,C
Ignacio Eguia Cambero,1913,1,0,22,52,36,-16,D
Kiko Sanchez Salazar,1906,1,0,19,108,37,-71,A
Kiko Sanchez Salazar,1906,1,0,19,92,32,-60,B
Kiko Sanchez Salazar,1906,1,0,19,100,32,-68,C
Kiko Sanchez Salazar,1906,1,0,19,104,32,-72,D
Diego Moral Barragan,1863,1,0,19,55,47,-8,A
Diego Moral Barragan,1863,1,0,19,53,47,-6,D
Iker Iraneta Unzue,1812,2,0.5,69,62,54,-8,A
Iker Iraneta Unzue,1812,2,0.5,69,82,45,-37,C
Iker Iraneta Unzue,1812,2,0.5,69,69,46,-23,D
Axel Roviralta Montero,2061,1,0,25,119,28,-91,A
Axel Roviralta Montero,2061,1,0,25,118,28,-90,B
Axel Roviralta Montero,2061,1,0,25,121,32,-89,C
Axel Roviralta Montero,2061,1,0,25,80,32,-48,D
Pedro Vinal Gutierrez,2165,2,0.5,50,55,46,-9,A
Pedro Vinal Gutierrez,2165,2,0.5,50,65,38,-27,B
Pedro Vinal Gutierrez,2165,2,0.5,50,67,46,-21,C
Pedro Vinal Gutierrez,2165,2,0.5,50,68,42,-26,D
Imanol Martinez Salas,1956,3,0.5,86,58,45,-13,A
Imanol Martinez Salas,1956,3,0.5,86,68,45,-23,D
Emilio Duran Fernandez,1799,1,0,23,50,48,-2,A
Emilio Duran Fernandez,1799,1,0,23,62,44,-18,C
Emilio Duran Fernandez,1799,1,0,23,52,48,-4,D
Javier Ignacio Esparza Martinez,2047,1,0.5,38,36,63,27,A
Javier Ignacio Esparza Martinez,2047,1,0.5,38,44,60,16,C
Javier Ignacio Esparza Martinez,2047,1,0.5,38,51,55,4,D
Daniel Zamarbide Inarrea,2015,4,1.5,157,55,44,-11,A
Daniel Zamarbide Inarrea,2015,4,1.5,157,54,47,-7,C
Daniel Zamarbide Inarrea,2015,4,1.5,157,54,46,-8,D
Mario Leon Fernandez,2064,1,0,20,84,45,-39,A
Mario Leon Fernandez,2064,1,0,20,90,45,-45,C
Mario Leon Fernandez,2064,1,0,20,104,40,-64,D
Sergio Anguas Fanlo,2048,1,0.5,35,46,49,3,A
Sergio Anguas Fanlo,2048,1,0.5,35,45,46,1,B
Sergio Anguas Fanlo,2048,1,0.5,35,51,51,0,C
Sergio Anguas Fanlo,2048,1,0.5,35,52,43,-9,D
