Sort,Name,Rating,Games,Result,Moves,CPL,MM,Sort score,Analysis 
180,louiswei 2007.11.25,795,2,0.5,94,109,31,-78,Level A
548,laksen 2007.06.28,866,7,0,92,237,22,-215,Level A
107,Kyobutungi 2007.11.25,1076,1,0.5,77,77,25,-52,Level A
668,laksen 2007.06.30,852,5,1.5,71,319,27,-292,Level A
84,fewral 2007.05.19,963,1,0.5,71,78,39,-39,Level A
116,GatorWarrior 2007.05.19,1029,1,0.5,68,91,35,-56,Level A
216,louiswei 2007.12.23,824,2,1.5,67,113,19,-94,Level A
163,whitelighter 2007.06.14,994,2,0,67,107,37,-70,Level A
450,fseeling 2007.11.28,1005,2,1.5,66,205,29,-176,Level A
484,greenqueenbrasil 2007.04.25,817,5,0,65,207,18,-189,Level A
322,ippat 2007.11.28,984,2,0.5,64,154,25,-129,Level A
437,direworl 2007.04.23,900,2,0.5,60,201,28,-173,Level A
478,overloadcro 2007.03.27,853,2,1,59,217,29,-188,Level A
540,thebrickwall 2007.12.20,1012,2,1,58,246,34,-212,Level A
315,DINOCO 2007.10.22,794,2,0,57,148,21,-127,Level A
227,simonjs 2007.06.20,1010,2,0.5,57,133,35,-98,Level A
262,CausalClosure 2007.06.13,972,2,1,56,148,39,-109,Level A
176,kevinoc 2007.12.23,886,2,1.5,55,109,33,-76,Level A
339,DuncanRDG 2007.10.04,970,1,0,55,172,36,-136,Level A
569,greenqueenbrasil 2007.04.23,816,6,1,53,250,23,-227,Level A
226,louiswei 2007.12.05,829,2,1,53,140,42,-98,Level B
81,greatwhitepine 2007.09.09,960,2,2,52,81,44,-37,Level B
343,DINOCO 2007.11.25,857,2,0,51,160,24,-136,Level A
627,laksen 2007.07.30,864,5,2,51,272,16,-256,Level A
188,thess 2007.10.21,986,2,1,51,120,39,-81,Level A
98,peihan 2007.10.22,1078,2,2,51,86,37,-49,Level A
123,electronf 2007.06.14,991,1,1,50,101,42,-59,Level A
409,mpaon 2007.02.01,825,2,1,49,193,33,-160,Level A
300,Zevix 2007.04.23,955,1,0.5,49,163,41,-122,Level A
249,jmaeder 2007.10.21,957,2,1,49,135,31,-104,Level A
142,Kestreall 2007.10.04,1023,1,1,49,109,43,-66,Level A
354,louiswei 2007.12.22,832,2,0,47,168,28,-140,Level B
363,ilikecomputer 2007.11.07,953,1,0,47,178,34,-144,Level A
199,Aydo 2007.12.09,1079,2,2,47,119,32,-87,Level A
256,DINOCO 2007.11.18,816,1,0.5,46,130,24,-106,Level A
156,blingking 2007.12.22,1075,2,2,46,106,37,-69,Level B
767,xWildBillx 2007.03.24,849,4,0,45,405,16,-389,Level A
514,Cheezychess 2007.12.21,915,3,0,45,229,27,-202,Level A
103,ilikecar 2007.11.07,1038,1,1,45,78,27,-51,Level A
237,whitelighter 2007.07.04,956,2,1,44,135,34,-101,Level A
787,vetteboy 2007.10.12,949,1,1,43,441,16,-425,Level A
124,RandallMR 2007.11.25,1140,1,1,43,89,30,-59,Level A
192,BurtForFun 2007.11.18,1162,1,0.5,43,104,21,-83,Level A
396,andoferni 2007.07.14,933,3,1,42,194,38,-156,Level A
608,LopezLaTorre 2007.08.28,982,3,1,42,273,26,-247,Level A
467,laksen 2007.07.16,854,3,2,41,213,29,-184,Level A
247,Refry 2007.06.20,932,1,0.5,41,142,39,-103,Level A
390,Philiphh 2007.06.03,951,2,0,41,177,24,-153,Level A
479,thebrickwall 2007.12.10,952,1,1,41,208,20,-188,Level A
418,Ephphatha 2007.08.28,977,3,2,41,193,29,-164,Level A
128,Pixxilingstron 2007.03.09,1005,1,0,41,95,34,-61,Level C
151,TusharAmba 2007.10.28,1118,2,2,41,107,39,-68,Level A
350,Kwela 2007.10.09,740,1,1,40,153,15,-138,Level A
610,xWildBillx 2007.03.25,797,2,1,40,270,23,-247,Level A
433,slartibartflat 2007.01.21,1057,1,0.5,40,209,38,-171,Level A
35,hotwheela 2007.03.09,976,1,1,39,34,33,-1,Level C
236,Bolders 2007.03.27,1102,1,1,39,140,39,-101,Level A
377,navneet 2007.10.28,876,2,0,38,165,16,-149,Level A
607,jokersplay 2007.10.04,971,1,0,38,281,34,-247,Level A
200,luoyun 2007.12.05,989,1,0,38,119,32,-87,Level B
152,shadyKnight 2007.06.03,1001,2,2,38,105,37,-68,Level A
218,Sansui 2007.11.01,1106,1,0,38,129,34,-95,Level A
179,PhoenixRedOne 2007.10.09,1199,1,0,38,110,32,-78,Level A
82,lamemyles 2007.11.01,853,1,1,37,79,41,-38,Level A
125,DHamm 2007.11.24,878,1,1,37,103,43,-60,Level B
281,timothyschmid 2007.01.21,903,1,0.5,37,157,41,-116,Level A
523,Anja 2007.04.28,978,2,1,37,235,30,-205,Level A
427,ChuckieChex 2007.05.20,982,1,0,37,208,38,-170,Level A
212,vetteboy 2007.11.27,988,1,0.5,37,131,38,-93,Level A
387,GatorWarrior 2007.05.06,996,1,1,37,176,24,-152,Level A
402,jmaeder 2007.11.27,996,1,0.5,37,193,35,-158,Level A
578,meathelmet 2007.06.30,1100,2,2,37,260,30,-230,Level A
551,Malca 2007.10.04,1152,1,0,37,249,32,-217,Level C
531,direworl 2007.10.04,846,1,0,36,241,33,-208,Level A
328,DHamm 2007.12.08,946,2,1,36,168,36,-132,Level A
235,michaelchen 2007.12.16,952,1,0,36,140,39,-101,Level A
444,Woosky 2007.07.14,1003,2,1,36,211,36,-175,Level A
589,docholloday 2007.12.10,1020,1,0,36,263,28,-235,Level A
486,Tajibo 2007.10.04,1114,1,1,36,226,36,-190,Level A
191,NiceEvent 2007.11.24,819,1,0,35,120,37,-83,Level B
135,jinbu 2007.12.09,841,2,1,35,107,43,-64,Level A
307,vetteboy 2007.05.06,932,1,0,35,161,37,-124,Level A
352,Keiju 2007.04.28,946,2,1,35,174,34,-140,Level A
398,cameronbra 2007.07.14,1006,1,0,35,185,29,-156,Level A
134,Caledonian 2007.09.08,848,1,0,34,108,44,-64,Level B
137,jinbu 2007.12.07,848,1,0,34,102,38,-64,Level B
481,thess 2007.10.04,869,1,1,34,227,38,-189,Level A
457,aleksthegreat 2007.02.12,895,2,0,34,205,26,-179,Level A
224,zhouzhou 2007.11.15,915,1,0,34,124,27,-97,Level A
204,Artmachine 2007.11.15,1019,1,1,34,131,41,-90,Level A
174,shahar 2007.09.08,1102,1,1,34,104,29,-75,Level B
64,talleyman 2007.12.07,1124,1,1,34,72,47,-25,Level B
266,xWildBillx 2007.04.19,790,2,0.5,33,137,27,-110,Level A
738,laksen 2007.08.05,863,2,0,33,368,21,-347,Level A
718,xWildBillx 2007.03.23,896,4,0,33,348,18,-330,Level A
231,Babnet 2007.06.13,975,1,1,33,138,39,-99,Level A
441,soucyj 2007.09.09,980,1,0,33,210,36,-174,Level B
482,vetteboy 2007.12.20,996,1,0,33,222,33,-189,Level A
297,Jia 2007.05.20,999,1,1,33,160,39,-121,Level A
414,GatorWarrior 2007.04.23,1092,1,1,33,173,12,-161,Level A
577,Biggnick 2007.12.28,1136,1,0,33,263,33,-230,Level A
582,xWildBillx 2007.04.04,788,4,0,32,259,28,-231,Level A
404,mipsparc 2007.12.28,847,1,1,32,193,34,-159,Level A
9,greenqueenbrasil 2007.05.09,937,2,2,32,32,66,34,Level C
423,thebrickwall 2007.12.30,982,2,1,32,219,53,-166,Level C
740,jmaeder 2007.09.19,1003,1,0,32,393,38,-355,Level A
144,Linckar 2007.05.09,1036,1,0,32,97,31,-66,Level C
489,xWildBillx 2007.03.27,806,2,0,31,213,23,-190,Level A
261,DINOCO 2007.11.15,818,1,0,31,131,23,-108,Level A
549,louiswei 2007.09.08,856,2,0,31,231,16,-215,Level A
500,WesleySimmons 2007.09.09,1045,1,1,31,226,29,-197,Level A
196,louiswei 2007.12.19,834,1,0,30,125,40,-85,Level A
537,DINOCO 2007.11.28,839,1,0,30,241,30,-211,Level A
611,DINOCO 2007.10.12,864,1,0,30,265,17,-248,Level A
529,Philiphh 2007.06.02,869,3,1.5,30,227,20,-207,Level A
348,podlas 2007.12.30,913,2,1,30,178,40,-138,Level C
471,sirishb 2007.09.09,951,1,0,30,218,33,-185,Level A
117,whitelighter 2007.06.03,957,1,1,30,89,33,-56,Level A
749,CopilotJoe 2007.01.25,970,1,1,30,379,17,-362,Level A
370,thebrickwall 2007.12.19,1004,2,2,30,167,20,-147,Level A
197,lordcyrix 2007.06.03,1007,1,0,30,116,30,-86,Level A
572,Jia 2007.01.28,1011,1,0,30,255,27,-228,Level A
153,Malca 2007.06.28,1053,2,2,30,101,33,-68,Level A
314,guilut 2007.08.09,1085,2,2,30,154,27,-127,Level A
620,DINOCO 2007.11.07,807,2,1,29,270,17,-253,Level A
273,himmelsgrau 2007.01.28,833,1,1,29,151,38,-113,Level A
99,WhiteSide 2007.11.15,839,1,1,29,77,28,-49,Level A
509,ComradeRoshchin 2007.03.16,850,4,1,29,217,17,-200,Level A
670,DeathFromAbove 2007.03.07,904,2,0.5,29,309,17,-292,Level A
206,louiswei 2007.12.31,907,1,0,29,126,35,-91,Level C
568,michaelchen 2007.11.26,942,1,1,29,255,28,-227,Level A
502,jmaeder 2007.10.16,955,3,1,29,229,31,-198,Level A
665,XsteveoX 2007.06.02,960,1,1,29,313,24,-289,Level A
65,Avatarz 2007.12.16,1014,1,1,29,60,35,-25,Level A
242,chesscoolman 2007.02.12,1025,2,2,29,136,34,-102,Level A
654,Kongfuchess 2007.07.13,1058,2,1,29,315,34,-281,Level A
756,xWildBillx 2007.03.29,790,1,0,28,387,14,-373,Level A
208,ilikecomputer 2007.10.17,798,1,0,28,131,39,-92,Level B
407,spenda 2007.11.08,814,2,0,28,180,21,-159,Level A
430,DINOCO 2007.12.03,829,2,1,28,199,29,-170,Level A
604,sneakypawn 2007.03.12,850,1,0,28,266,21,-245,Level B
662,TonyLechner 2007.08.14,913,3,0,28,320,32,-288,Level A
728,LopezLaTorre 2007.09.09,942,1,1,28,356,18,-338,Level A
195,NiceEvent 2007.09.25,947,1,0,28,131,46,-85,Level C
305,jmaeder 2007.10.20,957,1,0.5,28,141,18,-123,Level A
161,nedy 2007.07.14,989,1,1,28,98,29,-69,Level A
148,Artmachine 2007.10.20,1009,1,0.5,28,103,36,-67,Level A
109,nightway 2007.09.25,1046,1,1,28,90,36,-54,Level C
26,sevenohnine 2007.12.31,1066,1,1,28,45,54,9,Level C
657,RIQUELME 2007.08.19,1169,1,1,28,325,39,-286,Level A
320,ComradeRoshchin 2007.05.28,780,2,2,27,154,26,-128,Level A
323,jinbu 2007.11.30,865,1,0,27,156,26,-130,Level B
271,Ratamacue 2007.02.14,873,1,0,27,131,19,-112,Level A
560,HEARTLESSWIZARD 2007.07.28,956,2,0,27,236,15,-221,Level C
565,yangyang 2007.09.23,960,1,0,27,245,22,-223,Level A
576,hotwheela 2007.03.12,969,1,1,27,259,30,-229,Level A
534,whitelighter 2007.06.02,977,1,0,27,242,33,-209,Level A
473,Malca 2007.06.13,1016,1,0,27,223,37,-186,Level A
446,Bmoresoldier 2007.07.04,1029,1,0,27,205,30,-175,Level A
573,lprcahn 2007.03.23,1057,3,3,27,247,19,-228,Level A
41,Ativa 2007.06.18,784,10,2,26,57,50,-7,Level C
397,laksen 2007.07.04,873,2,0,26,187,31,-156,Level A
453,mpaon 2007.01.21,896,2,0,26,191,15,-176,Level A
285,kreshoo 2007.06.12,936,1,1,26,136,19,-117,Level A
270,zhouzhou 2007.11.28,959,1,1,26,151,39,-112,Level A
367,thebrickwall 2007.12.09,962,1,0.5,26,181,35,-146,Level A
419,YINGYING 2007.06.12,979,1,0,26,187,23,-164,Level A
309,dustbuni 2007.02.13,1009,1,1,26,164,39,-125,Level B
686,Ephphatha 2007.08.15,1030,1,0,26,324,19,-305,Level A
699,Artmachine 2007.10.12,1047,4,2,26,333,19,-314,Level A
349,steventhenoob 2007.01.21,1072,2,2,26,161,23,-138,Level A
67,stephenbyers 2007.10.17,1110,1,1,26,74,46,-28,Level B
308,Caledonian 2007.12.09,795,1,0.5,25,152,28,-124,Level A
536,DINOCO 2007.11.16,800,1,0,25,250,40,-210,Level A
492,louiswei 2007.12.08,837,2,0,25,215,24,-191,Level A
592,NickVee 2007.04.21,868,1,1,25,266,28,-238,Level B
372,Kirktcb 2007.04.10,882,1,0,25,180,32,-148,Level B
708,zacq 2007.03.09,883,1,0,25,358,36,-322,Level A
639,louiswei 2007.09.02,899,2,0,25,285,20,-265,Level A
547,andoferni 2007.07.13,919,2,1,25,247,32,-215,Level A
366,zhouzhou 2007.09.23,971,1,1,25,169,24,-145,Level A
542,soucyj 2007.09.01,971,1,0,25,236,24,-212,Level A
426,paulfallet 2007.03.09,975,1,0,25,196,28,-168,Level A
147,zhouzhou 2007.11.26,976,1,0,25,103,36,-67,Level A
355,Chrisasdf 2007.03.12,976,1,0,25,168,28,-140,Level A
87,BurtForFun 2007.07.28,989,2,2,25,96,56,-40,Level C
296,thebrickwall 2007.12.23,1011,1,0,25,161,40,-121,Level A
701,Malca 2007.03.09,1047,1,1,25,343,28,-315,Level A
88,Malca 2007.07.02,1058,1,1,25,92,52,-40,Level C
493,SirEndipity 2007.03.28,1112,1,1,25,228,36,-192,Level B
290,juansebastian 2007.11.07,1178,2,1,25,160,40,-120,Level A
726,cjmaeder 2007.08.24,768,1,0,24,353,17,-336,Level A
666,louiswei 2007.10.29,806,1,0,24,303,13,-290,Level A
187,herrahuu 2007.10.04,817,1,1,24,131,50,-81,Level C
232,Doragon 2007.12.21,877,2,0.5,24,136,37,-99,Level B
104,Imiro 2007.06.17,925,1,1,24,102,50,-52,Level C
623,mjcknight 2007.01.24,941,1,0,24,267,13,-254,Level A
319,GolfBob 2007.03.09,968,1,1,24,157,29,-128,Level A
358,whitelighter 2007.06.17,977,1,0,24,163,21,-142,Level C
538,HomogenousMass 2007.03.07,1021,2,1.5,24,240,29,-211,Level A
637,MasterOfMagic 2007.01.25,1026,1,0,24,272,8,-264,Level A
691,stardawg 2007.03.25,1035,2,0,24,334,25,-309,Level A
652,direworl 2007.04.01,1070,1,1,24,313,33,-280,Level A
44,Pestachio 2007.11.30,1095,1,1,24,57,46,-11,Level B
579,eclipze 2007.02.01,1186,1,0,24,255,25,-230,Level A
340,ilikecomputer 2007.11.01,765,1,0,23,171,35,-136,Level A
483,jinbu 2007.10.08,835,1,0,23,215,26,-189,Level A
778,zhouzhou 2007.10.27,953,1,0,23,434,22,-412,Level A
462,soucyj 2007.09.19,968,1,1,23,218,35,-183,Level A
475,knightse 2007.02.13,982,1,0,23,208,22,-186,Level B
526,infernonk 2007.05.24,990,1,1,23,232,26,-206,Level A
449,CrassNaste 2007.06.29,993,1,0,23,206,30,-176,Level B
202,justhoff 2007.09.08,1000,1,1,23,128,39,-89,Level A
126,justhoff 2007.09.09,1010,1,0,23,90,30,-60,Level B
113,Dakel 2007.06.18,1012,2,1,23,84,30,-54,Level C
283,TrumpetJedi 2007.02.14,1021,1,1,23,152,35,-117,Level A
472,Biggnick 2007.04.25,1031,1,1,23,211,26,-185,Level A
406,MrAdcock 2007.01.24,1054,1,1,23,185,26,-159,Level A
118,lamemyles 2007.12.21,1068,2,1.5,23,105,48,-57,Level B
520,MagicMon 2007.07.04,1069,1,1,23,216,13,-203,Level A
503,telis 2007.04.21,1079,1,0,23,243,44,-199,Level B
286,tereliza 2007.03.12,1102,1,1,23,158,39,-119,Level B
264,fabras 2007.12.08,1114,1,1,23,140,30,-110,Level A
278,azaluski 2007.11.01,1123,1,1,23,140,26,-114,Level A
487,soucyj 2007.08.21,1124,1,0,23,220,30,-190,Level A
381,beasley 2007.10.08,1125,1,1,23,176,26,-150,Level A
601,louiswei 2007.09.09,840,1,0,22,258,14,-244,Level A
246,herrahuu 2007.03.28,853,1,0,22,149,46,-103,Level B
628,Asdrulbo 2007.05.23,860,2,1,22,290,32,-258,Level A
648,Kirktcb 2007.04.01,875,1,0,22,305,27,-278,Level A
443,vetteboy 2007.08.15,912,1,1,22,201,27,-174,Level A
205,luming 2007.07.02,920,1,0,22,126,36,-90,Level C
725,SuperMicroNanoMan 2007.08.22,938,2,1.5,22,359,23,-336,Level A
636,meenamoh 2007.04.30,942,1,0,22,291,27,-264,Level A
412,wyldeemgz 2007.04.21,966,1,0,22,188,27,-161,Level B
301,HomogenousMass 2007.03.16,967,3,2,22,154,32,-122,Level A
277,Jia 2007.04.21,989,1,1,22,160,46,-114,Level B
360,kassab 2007.07.04,1026,1,1,22,166,23,-143,Level A
127,JFolla 2007.06.12,1086,1,1,22,116,55,-61,Level C
160,bullrock 2007.12.23,1131,1,0,22,101,32,-69,Level B
276,waynerooneyfan 2007.11.08,1185,1,1,22,160,46,-114,Level C
225,TonyLechner 2007.08.21,761,1,1,21,141,43,-98,Level A
522,joethecoolestman 2007.10.22,762,2,0,21,238,33,-205,Level A
287,prettydarnbad 2007.06.12,782,1,0,21,152,33,-119,Level C
326,louiswei 2007.11.15,786,1,1,21,155,24,-131,Level A
605,jinbu 2007.10.16,786,1,0,21,279,33,-246,Level A
506,nunziocedi 2007.05.23,812,3,1,21,232,33,-199,Level A
353,nunziocedi 2007.05.22,854,1,0,21,173,33,-140,Level A
626,simonjs 2007.07.13,879,3,2.5,21,288,33,-255,Level A
458,SimSima 2007.02.22,888,1,0,21,210,29,-181,Level B
233,RoKStAR 2007.04.16,902,1,1,21,132,33,-99,Level A
374,jmaeder 2007.10.29,910,1,0,21,187,38,-149,Level A
813,vetteboy 2007.07.28,912,2,0,21,539,14,-525,Level A
679,luoyun 2007.11.14,964,1,1,21,328,29,-299,Level A
368,theshowboat 2007.03.19,977,1,0,21,165,19,-146,Level A
274,Artmachine 2007.09.01,1001,1,1,21,146,33,-113,Level A
365,unfrozen 2007.03.19,1021,1,1,21,174,29,-145,Level A
796,Biggnick 2007.04.30,1031,1,1,21,467,14,-453,Level A
284,jjmieres 2007.04.16,1047,1,0,21,146,29,-117,Level A
376,blingking 2007.12.21,1069,1,1,21,182,33,-149,Level A
588,mjwadams 2007.05.28,1158,1,0,21,264,29,-235,Level A
596,SCHWAM 2007.10.16,1205,1,1,21,260,19,-241,Level A
716,Seroth 2007.10.23,719,2,0,20,352,25,-327,Level A
706,TonyLechner 2007.08.20,775,1,0,20,348,30,-318,Level A
553,ilikecomputer 2007.10.29,778,1,0,20,227,10,-217,Level A
667,louiswei 2007.10.03,819,1,0,20,316,25,-291,Level A
585,jinbu 2007.11.13,840,2,1,20,242,10,-232,Level A
723,laksen 2007.07.13,894,3,0.5,20,349,15,-334,Level A
692,Kirktcb 2007.03.29,899,1,1,20,330,20,-310,Level A
535,zhouzhou 2007.11.16,904,1,1,20,219,10,-209,Level A
162,Bbbumpy 2007.06.29,908,1,1,20,115,45,-70,Level B
518,direworl 2007.04.19,933,2,0,20,218,15,-203,Level A
463,Ativa 2007.10.12,945,5,2,20,213,30,-183,Level A
690,andoferni 2007.06.09,970,1,0,20,328,20,-308,Level A
250,Depi 2007.10.14,971,2,2,20,129,25,-104,Level A
436,neog 2007.03.02,971,1,0,20,208,35,-173,Level B
477,whitelighter 2007.06.28,974,1,0,20,202,15,-187,Level A
434,ArcticDevil 2007.12.11,981,2,1,20,201,30,-171,Level A
385,Woosky 2007.06.28,983,1,1,20,176,25,-151,Level A
727,Woosky 2007.07.18,1003,2,0.5,20,358,20,-338,Level B
375,Cheezychess 2007.12.08,1006,1,0,20,184,35,-149,Level A
550,BurtForFun 2007.08.24,1024,1,1,20,236,20,-216,Level A
159,Malca 2007.05.22,1038,1,1,20,104,35,-69,Level A
630,jokkman 2007.12.03,1051,1,0,20,278,20,-258,Level A
181,rdubs 2007.10.29,1067,1,1,20,108,30,-78,Level A
403,peihan 2007.10.29,1084,1,1,20,173,15,-158,Level A
669,jinbu 2007.09.25,1096,1,1,20,317,25,-292,Level A
737,Seroth 2007.10.24,693,1,0,19,378,32,-346,Level A
525,Tycew 2007.09.25,778,1,0,19,238,32,-206,Level A
561,cjmaeder 2007.08.19,807,4,0,19,232,11,-221,Level A
442,ComradeRoshchin 2007.05.24,820,1,0,19,206,32,-174,Level A
555,greenqueenbrasil 2007.04.21,850,1,0,19,255,37,-218,Level B
34,Cheezychess 2007.12.23,865,1,1,19,43,42,-1,Level B
491,Cheezychess 2007.12.20,883,1,1,19,217,26,-191,Level A
171,richarddixon 2007.06.20,917,1,1,19,117,42,-75,Level A
304,Darvster 2007.04.09,962,3,1,19,165,42,-123,Level A
222,SixteenCorners 2007.04.19,965,2,2,19,117,21,-96,Level A
405,mikihiir 2007.05.30,969,1,1,19,191,32,-159,Level A
268,ellieuk 2007.03.02,1003,1,1,19,158,47,-111,Level B
439,soucyj 2007.10.16,1013,2,1,19,211,37,-174,Level A
150,BeNumberOne 2007.11.15,1021,1,0,19,99,32,-67,Level A
765,BurtForFun 2007.07.30,1029,2,0,19,396,11,-385,Level A
342,cecilieh 2007.07.30,1080,1,1,19,168,32,-136,Level A
97,checkmatejack 2007.02.22,1087,1,1,19,102,53,-49,Level B
321,SirEndipity 2007.04.04,1096,3,3,19,161,32,-129,Level A
33,tereliza 2007.04.10,1115,1,1,19,48,47,-1,Level B
46,GoSyracuse 2007.02.01,1134,1,1,19,70,58,-12,Level B
541,BurtForFun 2007.10.03,1139,1,1,19,244,32,-212,Level A
445,SirEndipity 2007.03.25,1153,1,1,19,207,32,-175,Level A
295,louiswei 2007.12.24,839,1,0,18,177,56,-121,Level B
558,kaarunya 2007.04.15,843,1,0,18,226,6,-220,Level A
770,laksen 2007.07.28,850,1,1,18,413,17,-396,Level A
391,DINOCO 2007.12.09,870,1,0,18,193,39,-154,Level A
594,vetteboy 2007.08.05,872,1,1,18,272,33,-239,Level A
209,Tycew 2007.11.21,906,1,0,18,125,33,-92,Level A
461,Cheezychess 2007.12.16,909,1,0,18,210,28,-182,Level A
775,kreshoo 2007.06.11,917,1,0,18,422,17,-405,Level A
580,adamjodonnell 2007.12.08,954,1,0,18,252,22,-230,Level A
774,Fimbrethil 2007.06.06,957,1,0,18,413,11,-402,Level A
373,JohntheChristian 2007.04.19,990,1,0,18,165,17,-148,Level A
132,mwebber 2007.10.25,998,1,0,18,113,50,-63,Level B
267,MajorNerd 2007.06.30,1021,4,0,18,132,22,-110,Level A
452,BurtForFun 2007.08.14,1049,2,2,18,198,22,-176,Level A
517,KevinusMaximus 2007.05.03,1051,1,1,18,236,33,-203,Level A
625,icman 2007.04.19,1079,1,0.5,18,265,11,-254,Level A
632,LUKAchess 2007.03.27,1182,1,0,18,288,28,-260,Level A
251,drewly 2007.10.22,1187,2,2,18,144,39,-105,Level A
272,Halfman 2007.10.29,1187,1,1,18,129,17,-112,Level A
485,Kirktcb 2007.05.03,853,1,0,17,207,18,-189,Level A
263,WilliamJ 2007.07.29,865,1,1,17,138,29,-109,Level A
77,buddhajuke 2007.10.25,878,1,1,17,81,47,-34,Level B
650,stardawg 2007.03.31,884,1,0,17,284,6,-278,Level A
415,TWINSXZ 2007.08.09,903,1,0,17,191,29,-162,Level A
634,Dakel 2007.04.09,907,1,0,17,273,12,-261,Level A
753,simonjs 2007.06.27,915,1,0,17,380,12,-368,Level A
158,kyleelhs 2007.10.27,944,1,1,17,104,35,-69,Level A
501,mjcknight 2007.01.06,952,1,0,17,226,29,-197,Level A
562,beasley 2007.09.06,967,2,2,17,251,29,-222,Level A
130,lordcyrix 2007.06.14,998,1,1,17,97,35,-62,Level A
659,BurtForFun 2007.07.16,1004,1,0,17,310,24,-286,Level A
146,BeNumberOne 2007.11.21,1006,1,1,17,72,6,-66,Level A
416,nedy 2007.07.29,1012,1,0,17,191,29,-162,Level A
711,HEARTLESSWIZARD 2007.04.06,1013,1,1,17,336,12,-324,Level A
395,jmaeder 2007.11.14,1015,1,0,17,197,41,-156,Level A
220,whitelighter 2007.05.30,1020,1,0,17,137,41,-96,Level A
258,thebrickwall 2007.12.16,1022,1,1,17,148,41,-107,Level A
269,BurtForFun 2007.08.19,1037,2,2,17,140,29,-111,Level A
219,tyfoonturk 2007.12.08,1041,1,1,17,124,29,-95,Level A
347,LopezLaTorre 2007.04.15,1078,1,1,17,155,18,-137,Level A
255,RIQUELME 2007.07.27,1080,1,0,17,135,29,-106,Level B
645,Syrik 2007.10.24,1112,1,1,17,294,18,-276,Level A
76,bullrock 2007.12.24,1139,1,1,17,87,53,-34,Level B
435,herculus 2007.08.20,1157,1,1,17,208,35,-173,Level A
194,AntidOto 2007.08.19,766,1,0,16,128,44,-84,Level A
513,louiswei 2007.11.01,782,1,0,16,207,6,-201,Level A
563,DINOCO 2007.10.30,789,2,0,16,247,25,-222,Level A
338,Youngturks 2007.08.08,835,1,0,16,186,50,-136,Level B
252,andoferni 2007.05.16,845,1,0,16,143,38,-105,Level A
644,hysong 2007.10.01,865,1,0,16,288,13,-275,Level A
333,emorej 2007.12.14,885,1,0,16,179,44,-135,Level A
141,tetrapharmakon 2007.04.21,893,1,1,16,122,56,-66,Level B
751,Spiraldown 2007.01.27,898,1,0,16,386,19,-367,Level A
359,zhouzhou 2007.11.10,907,1,0,16,168,25,-143,Level A
616,hysong 2007.09.29,918,2,0,16,270,19,-251,Level A
185,luoyun 2007.12.11,931,1,1,16,111,31,-80,Level A
106,thebrickwall 2007.12.08,955,1,1,16,83,31,-52,Level A
544,unfrozen 2007.04.06,964,1,0,16,238,25,-213,Level A
617,ScottieD 2007.11.17,971,2,0,16,271,19,-252,Level A
663,ArtVandeleigh 2007.01.28,993,1,1,16,307,19,-288,Level A
230,fishel 2007.09.02,1000,1,1,16,117,19,-98,Level A
388,jmaeder 2007.11.17,1003,2,2,16,190,37,-153,Level A
595,suppechasper 2007.06.16,1011,2,1,16,265,25,-240,Level A
303,nuthegoob 2007.01.06,1034,1,1,16,153,31,-122,Level A
498,Biggnick 2007.04.09,1038,1,1,16,201,6,-195,Level A
527,jaxonmills 2007.06.02,1040,1,1,16,238,31,-207,Level A
92,shouou 2007.05.16,1045,1,1,16,84,38,-46,Level A
591,SunRaphi 2007.06.27,1052,1,1,16,269,31,-238,Level A
399,divcat 2007.04.03,1069,1,0,16,175,19,-156,Level A
302,Andreadoria 2007.01.22,1075,1,0,16,153,31,-122,Level A
681,monergism 2007.05.28,1091,1,0,16,320,19,-301,Level A
705,GatorWarrior 2007.07.14,1091,2,2,16,342,25,-317,Level A
289,SixteenCorners 2007.04.25,1108,1,1,16,138,19,-119,Level A
464,Syrik 2007.10.23,1108,2,2,16,215,31,-184,Level A
744,splicerx 2007.06.28,1147,1,1,16,373,13,-360,Level A
371,Exsation 2007.10.15,829,1,0,15,188,40,-148,Level A
584,Kirktcb 2007.05.01,842,1,0.5,15,252,20,-232,Level A
55,infernonk 2007.01.22,860,1,1,15,59,40,-19,Level A
557,direworl 2007.05.04,881,2,0,15,260,40,-220,Level A
383,LitovecBlind 2007.08.09,901,1,0,15,184,33,-151,Level A
260,bigrustynail 2007.04.08,919,1,1,15,135,27,-108,Level A
815,paulfallet 2007.05.01,954,1,0,15,555,0,-555,Level A
759,KevinusMaximus 2007.05.17,958,1,1,15,383,7,-376,Level A
571,paulfallet 2007.04.08,974,1,0,15,247,20,-227,Level A
138,paulfallet 2007.04.19,984,1,1,15,97,33,-64,Level A
331,soucyj 2007.10.14,988,1,0,15,174,40,-134,Level B
234,whitelighter 2007.06.18,998,1,1,15,141,40,-101,Level A
58,salius 2007.12.14,1037,1,1,15,61,40,-21,Level A
223,nedy 2007.06.26,1039,1,0,15,130,33,-97,Level B
183,ignacionf 2007.11.10,1046,1,1,15,119,40,-79,Level A
704,redheat 2007.06.11,1048,1,1,15,350,33,-317,Level A
713,FrankyBaby 2007.06.02,1078,1,0.5,15,331,7,-324,Level A
145,slumberjack 2007.03.27,1098,1,1,15,86,20,-66,Level A
149,steventhenoob 2007.01.23,1098,2,1,15,100,33,-67,Level B
91,JLLR 2007.06.28,1118,1,1,15,98,53,-45,Level B
221,beasley 2007.10.15,1153,1,1,15,123,27,-96,Level A
755,awhittaker 2007.06.24,731,2,1,14,376,7,-369,Level A
619,Seroth 2007.10.22,736,1,0,14,274,21,-253,Level B
519,xWildBillx 2007.04.25,800,1,0,14,217,14,-203,Level B
499,louiswei 2007.11.19,802,1,0,14,226,29,-197,Level A
651,greenqueenbrasil 2007.04.24,825,1,0,14,286,7,-279,Level A
640,louiswei 2007.10.12,833,1,0,14,288,21,-267,Level A
11,panchivilla 2007.07.27,873,1,1,14,38,71,33,Level B
757,laksen 2007.07.18,873,1,0,14,388,14,-374,Level A
709,louiswei 2007.09.06,874,2,0,14,336,14,-322,Level A
24,jamesobrien 2007.06.26,897,1,1,14,46,57,11,Level B
642,Kirktcb 2007.04.08,899,1,0,14,291,21,-270,Level B
451,DEDEE 2007.02.13,913,1,0.5,14,205,29,-176,Level A
697,mjcknight 2007.01.26,918,1,1,14,327,14,-313,Level A
521,jamesobrien 2007.07.18,930,2,1.5,14,247,43,-204,Level B
516,lordcyrix 2007.06.06,970,1,1,14,239,36,-203,Level A
288,paulfallet 2007.03.24,973,1,0,14,140,21,-119,Level A
459,Woosky 2007.06.18,1000,1,0,14,195,14,-181,Level A
676,Linckar 2007.05.14,1002,1,1,14,326,29,-297,Level A
229,zzzsah 2007.03.24,1011,1,1,14,119,21,-98,Level A
495,slartibartflat 2007.01.27,1030,1,1,14,238,43,-195,Level A
440,Jia 2007.11.19,1060,1,1,14,210,36,-174,Level A
133,Eladar 2007.03.24,1061,1,0,14,114,50,-64,Level B
357,sdormeus 2007.12.21,1085,1,1,14,171,29,-142,Level A
61,Pandu 2007.07.16,1086,1,1,14,67,43,-24,Level A
772,alamaak 2007.07.16,1107,1,0,14,405,7,-398,Level A
121,xlmr 2007.11.01,1171,1,1,14,87,29,-58,Level A
316,TonyLechner 2007.08.18,786,1,0,13,142,15,-127,Level A
259,DINOCO 2007.10.27,799,1,0,13,139,31,-108,Level A
511,greenqueenbrasil 2007.04.29,808,1,0,13,240,39,-201,Level B
687,deboragleice 2007.11.12,846,1,0.5,13,313,8,-305,Level A
703,laksen 2007.07.15,863,1,0,13,338,23,-315,Level A
8,timothyschmid 2007.01.23,879,2,1,13,16,54,38,Level B
429,vitela 2007.09.28,907,1,1,13,201,31,-170,Level A
609,laksen 2007.06.27,914,3,0,13,270,23,-247,Level A
175,MrBoris 2007.05.25,946,1,1,13,130,54,-76,Level B
635,jmaeder 2007.10.15,966,1,0,13,278,15,-263,Level B
546,CausalClosure 2007.06.16,979,2,1,13,237,23,-214,Level A
735,FreddyAbeloos 2007.10.30,985,1,0,13,360,15,-345,Level B
574,ALFREDII 2007.04.15,989,1,1,13,243,15,-228,Level A
306,HomogenousMass 2007.03.10,1002,1,0,13,138,15,-123,Level A
803,jamesobrien 2007.07.19,1002,1,0,13,491,15,-476,Level A
564,Jia 2007.03.31,1006,1,1,13,230,8,-222,Level A
641,LopezLaTorre 2007.08.26,1017,1,0,13,283,15,-268,Level A
599,FlyingFig 2007.07.07,1030,1,0,13,273,31,-242,Level A
28,BeNumberOne 2007.12.03,1041,1,1,13,55,62,7,Level B
696,beasley 2007.09.28,1054,1,0,13,336,23,-313,Level A
528,nuthegoob 2007.01.26,1068,1,0,13,230,23,-207,Level A
334,beasley 2007.09.29,1071,1,1,13,174,39,-135,Level B
783,KTSCane 2007.12.23,1079,1,0,13,435,15,-420,Level A
217,paloloco 2007.04.29,1084,1,1,13,149,54,-95,Level B
653,Gregarious 2007.07.18,1095,1,1,13,288,8,-280,Level A
115,hanntannif 2007.10.27,1102,1,1,13,86,31,-55,Level A
394,SixteenCorners 2007.04.29,1115,1,0,13,194,39,-155,Level B
336,BurtForFun 2007.10.01,1122,1,1,13,158,23,-135,Level A
361,phillymaintman 2007.08.18,1139,1,1,13,166,23,-143,Level A
298,Oldskewlphool 2007.05.01,1156,1,0.5,13,152,31,-121,Level A
39,hotwheela 2007.04.25,1182,1,1,13,42,39,-3,Level B
57,mamede 2007.11.25,1190,1,1,13,75,54,-21,Level B
73,SChlebowski 2007.11.02,1194,1,1,13,77,46,-31,Level B
410,louiswei 2007.11.02,780,1,0,12,193,33,-160,Level B
804,louiswei 2007.10.30,802,1,0,12,490,8,-482,Level A
742,kaarunya 2007.04.13,851,1,0,12,372,17,-355,Level A
5,divcat 2007.04.29,875,1,1,12,23,75,52,Level B
497,greenqueenbrasil 2007.04.20,881,1,0,12,212,17,-195,Level A
658,laksen 2007.07.05,884,2,1,12,311,25,-286,Level A
612,direworl 2007.04.25,892,2,1,12,256,8,-248,Level A
228,jmaeder 2007.10.30,900,1,1,12,131,33,-98,Level B
633,hysong 2007.09.18,909,1,0,12,260,0,-260,Level A
71,juanjogallardo 2007.08.26,913,1,1,12,72,42,-30,Level A
384,Kirktcb 2007.03.31,914,1,0,12,184,33,-151,Level A
378,aliceg 2007.08.03,915,1,0,12,157,8,-149,Level A
739,andoferni 2007.07.07,916,1,1,12,349,0,-349,Level A
583,JohnstonDJ 2007.01.23,923,1,0,12,239,8,-231,Level A
545,YINGYING 2007.07.06,938,2,0,12,221,8,-213,Level A
411,zhouzhou 2007.12.11,939,1,0,12,185,25,-160,Level A
678,direworl 2007.04.15,939,1,0,12,306,8,-298,Level A
488,jmaeder 2007.10.23,943,1,0,12,215,25,-190,Level A
768,vetteboy 2007.10.30,944,1,1,12,415,25,-390,Level A
721,BourbaKiND 2007.04.30,960,1,1,12,340,8,-332,Level A
382,Zevix 2007.02.13,964,1,0.5,12,193,42,-151,Level A
586,metalayer 2007.06.16,964,1,0,12,258,25,-233,Level A
779,whitelighter 2007.07.08,967,1,0,12,439,25,-414,Level A
715,francod 2007.07.08,976,1,1,12,343,17,-326,Level A
581,nedy 2007.07.19,983,1,1,12,247,17,-230,Level A
238,Boldrig 2007.06.09,984,1,1,12,134,33,-101,Level A
494,HomogenousMass 2007.05.25,986,1,0,12,202,8,-194,Level B
51,MySic 2007.03.10,987,1,1,12,57,42,-15,Level A
530,wyldeemgz 2007.04.23,990,1,1,12,224,17,-207,Level A
379,Jia 2007.04.09,1000,1,1,12,157,8,-149,Level A
776,zhouzhou 2007.09.28,1017,1,0,12,417,8,-409,Level A
680,Fencingiscool 2007.09.19,1033,1,0,12,308,8,-300,Level A
240,POREDJE 2007.12.11,1036,2,2,12,126,25,-101,Level A
279,ThomasPace 2007.03.31,1068,1,1,12,131,17,-114,Level A
752,plcsparky 2007.12.13,1087,1,1,12,393,25,-368,Level A
100,LithFlash 2007.04.08,1099,1,1,12,109,58,-51,Level B
694,rarte 2007.12.18,1101,1,0,12,328,17,-311,Level A
362,Aydo 2007.07.15,1108,1,1,12,186,42,-144,Level A
78,ZenDarb 2007.05.04,1113,1,1,12,93,58,-35,Level B
318,NYTahiti 2007.03.24,1151,1,1,12,170,42,-128,Level A
476,SirEndipity 2007.03.24,1151,1,1,12,212,25,-187,Level A
454,beasley 2007.10.13,1157,1,0,12,210,33,-177,Level A
400,ddurden 2007.12.05,1167,1,1,12,173,17,-156,Level B
243,thepirate 2007.04.24,1173,1,1,12,135,33,-102,Level A
254,alexserrano 2007.04.23,1181,3,3,12,148,42,-106,Level A
684,Seroth 2007.10.30,674,1,0,11,339,36,-303,Level A
253,xWildBillx 2007.04.03,773,1,1,11,123,18,-105,Level A
556,TonyLechner 2007.08.16,799,1,0,11,219,0,-219,Level A
468,jinbu 2007.10.20,822,1,1,11,202,18,-184,Level B
567,ilikecomputer 2007.10.12,825,1,0,11,244,18,-226,Level A
310,mcmurray 2007.07.14,829,2,0,11,152,27,-125,Level A
157,karimniemela 2007.10.13,833,1,1,11,105,36,-69,Level A
790,louiswei 2007.12.13,840,1,0,11,448,9,-439,Level A
674,Ratatoesk 2007.12.18,858,1,1,11,302,9,-293,Level A
603,Kirktcb 2007.04.20,869,1,0,11,272,27,-245,Level A
505,hysong 2007.09.19,870,1,1,11,235,36,-199,Level A
43,Dicemice 2007.03.24,876,1,1,11,46,36,-10,Level B
275,direworl 2007.04.28,896,1,0,11,131,18,-113,Level A
447,Andreadoria 2007.01.14,913,1,1,11,193,18,-175,Level A
504,CaptainWeirdo 2007.08.22,935,2,0.5,11,235,36,-199,Level A
311,MasterGilly 2007.01.28,967,1,0,11,152,27,-125,Level A
590,suppechasper 2007.05.14,972,1,0,11,264,27,-237,Level A
389,Saldeeznuts 2007.04.15,982,2,1,11,180,27,-153,Level A
420,urodec 2007.04.30,985,1,1,11,173,9,-164,Level A
393,joshaidan 2007.10.11,986,1,0,11,210,55,-155,Level B
769,Kayode 2007.12.13,988,1,0,11,411,18,-393,Level A
325,thebrickwall 2007.11.12,993,1,0.5,11,139,9,-130,Level A
72,ilikecar 2007.10.11,994,1,1,11,86,55,-31,Level B
566,Jia 2007.01.02,1006,1,0,11,242,18,-224,Level B
280,bosamor 2007.10.16,1019,1,1,11,142,27,-115,Level A
386,ShawnStanley 2007.04.20,1038,1,1,11,188,36,-152,Level A
239,MSmarques 2007.07.30,1048,1,1,11,128,27,-101,Level A
317,Halfman 2007.07.30,1061,1,0,11,174,46,-128,Level B
120,willingdon 2007.01.23,1063,1,1,11,94,36,-58,Level A
335,CLAS 2007.06.28,1075,1,1,11,162,27,-135,Level A
53,GatorWarrior 2007.04.25,1079,1,1,11,45,27,-18,Level B
85,Malca 2007.04.20,1086,1,1,11,66,27,-39,Level A
417,alamaak 2007.07.05,1093,1,1,11,200,36,-164,Level A
10,Syrik 2007.10.22,1106,1,1,11,30,64,34,Level B
456,timmybucks 2007.06.30,1118,1,0.5,11,196,18,-178,Level A
817,beasley 2007.10.20,1132,1,0,11,665,0,-665,Level A
401,jamesthesecond 2007.10.12,1160,1,1,11,175,18,-157,Level A
143,perfectloop 2007.03.27,1186,1,1,11,102,36,-66,Level A
649,joethecoolestman 2007.10.23,754,1,0,10,298,20,-278,Level A
754,louiswei 2007.12.07,835,1,0,10,378,10,-368,Level A
799,louiswei 2007.09.15,844,1,0.5,10,468,10,-458,Level A
629,mpaon 2007.01.31,850,1,0,10,288,30,-258,Level A
47,jshumaker 2007.01.02,853,1,1,10,63,50,-13,Level B
683,slavonija 2007.01.03,856,2,0,10,301,0,-301,Level A
455,DeathFromAbove 2007.03.09,872,1,1,10,207,30,-177,Level A
186,direworl 2007.04.30,889,1,0,10,100,20,-80,Level A
490,buddhajuke 2007.10.05,895,1,0,10,231,40,-191,Level A
597,jinbu 2007.10.05,899,1,0,10,251,10,-241,Level A
79,RIQUELME 2007.07.30,934,1,1,10,76,40,-36,Level B
465,saturnine 2007.06.21,938,1,0,10,214,30,-184,Level A
777,jakehazel 2007.05.05,949,2,0,10,420,10,-410,Level A
380,electronf 2007.06.08,952,1,1,10,190,40,-150,Level A
364,Muffro 2007.07.09,954,1,0,10,175,30,-145,Level A
129,lordcyrix 2007.05.17,967,1,0,10,102,40,-62,Level A
712,paulfallet 2007.04.25,967,1,0,10,334,10,-324,Level A
660,tetrapharmakon 2007.04.08,972,1,0,10,307,20,-287,Level A
136,OldWazzaBoy 2007.11.13,980,1,1,10,104,40,-64,Level B
771,andoferni 2007.10.20,985,1,0,10,406,10,-396,Level A
293,Woosky 2007.07.09,987,1,1,10,140,20,-120,Level A
18,jlorby 2007.10.15,997,1,1,10,42,60,18,Level B
75,BeNumberOne 2007.10.20,1012,1,0,10,94,60,-34,Level B
722,CausalClosure 2007.06.08,1033,1,0,10,354,20,-334,Level A
466,HomogenousMass 2007.03.09,1036,1,0,10,214,30,-184,Level A
460,CLAS 2007.04.13,1051,1,1,10,191,10,-181,Level A
431,scarsetto 2007.07.14,1062,1,1,10,190,20,-170,Level A
119,LithFlash 2007.04.25,1080,1,1,10,97,40,-57,Level A
794,peihan 2007.09.15,1108,1,0.5,10,457,10,-447,Level A
203,ddurden 2007.10.12,1122,1,1,10,109,20,-89,Level A
45,robofriven 2007.08.16,1164,1,1,10,51,40,-11,Level A
50,Tycew 2007.09.21,702,1,1,9,58,44,-14,Level A
89,Tycew 2007.10.05,764,1,1,9,85,44,-41,Level A
747,nunziocedi 2007.06.01,784,1,0,9,394,33,-361,Level A
575,DINOCO 2007.10.18,808,1,0,9,239,11,-228,Level A
758,DINOCO 2007.10.17,825,1,0,9,398,22,-376,Level A
613,Eskupitazo 2007.07.06,860,1,1,9,271,22,-249,Level A
761,jinbu 2007.10.28,860,1,0.5,9,403,22,-381,Level A
422,timothyschmid 2007.03.08,869,1,0,9,187,22,-165,Level A
155,mrschultz 2007.05.06,878,2,0,9,113,44,-69,Level A
748,Rexton 2007.02.23,901,1,0,9,384,22,-362,Level A
507,SuperMicroNanoMan 2007.08.18,903,2,1.5,9,221,22,-199,Level A
673,YINGYING 2007.07.10,919,1,0,9,304,11,-293,Level A
785,andoferni 2007.07.06,933,1,0,9,422,0,-422,Level A
675,Codees 2007.09.22,939,1,0,9,317,22,-295,Level A
428,jmaeder 2007.09.21,964,1,0,9,203,33,-170,Level A
213,paulfallet 2007.04.30,967,1,0,9,126,33,-93,Level A
341,jmaeder 2007.09.28,976,1,1,9,169,33,-136,Level A
724,nedy 2007.07.03,977,1,0,9,357,22,-335,Level A
689,MrBoris 2007.10.20,983,1,1,9,307,0,-307,Level A
602,podlas 2007.12.13,991,1,1,9,278,33,-245,Level A
182,adamjodonnell 2007.12.21,997,1,1,9,100,22,-78,Level A
805,RiverRock 2007.04.07,997,2,1,9,505,22,-483,Level A
782,SoloBaric 2007.10.03,998,1,0,9,430,11,-419,Level A
74,CausalClosure 2007.08.03,999,1,1,9,53,22,-31,Level A
166,BeNumberOne 2007.10.30,1001,1,1,9,130,56,-74,Level A
108,soucyj 2007.10.23,1004,1,1,9,97,44,-53,Level A
661,CrassNaste 2007.06.30,1005,1,1,9,287,0,-287,Level A
38,Eladar 2007.04.15,1008,1,1,9,47,44,-3,Level A
750,ITVin 2007.02.11,1040,1,0,9,373,11,-362,Level A
168,netbrain 2007.01.03,1072,2,2,9,96,22,-74,Level A
719,Ketzalos 2007.04.17,1079,1,0,9,342,11,-331,Level A
40,tobys 2007.10.05,1104,1,1,9,48,44,-4,Level A
131,shadowroy 2007.10.23,1110,1,1,9,119,56,-63,Level A
178,aGameofChess 2007.03.08,1122,1,1,9,122,44,-78,Level A
25,Syrik 2007.10.30,1126,1,1,9,47,56,9,Level A
93,arrarat 2007.08.08,1152,1,1,9,103,56,-47,Level B
27,BOXERFOREVR 2007.04.19,1199,1,1,9,35,44,9,Level A
512,aadeeb 2007.07.19,775,1,0,8,239,38,-201,Level A
552,nunziocedi 2007.05.26,806,1,0,8,242,25,-217,Level A
593,louiswei 2007.10.17,812,1,0,8,238,0,-238,Level A
788,TonyLechner 2007.08.29,878,1,0,8,448,13,-435,Level A
101,zafercaymaz 2007.04.10,897,2,2,8,89,38,-51,Level A
671,SuperMicroNanoMan 2007.08.09,907,1,0.5,8,318,25,-293,Level A
294,whitelighter 2007.05.26,925,2,2,8,133,13,-120,Level A
720,zhouzhou 2007.11.09,927,1,0,8,345,13,-332,Level A
732,vetteboy 2007.11.09,939,1,1,8,340,0,-340,Level A
587,Silveraj 2007.10.03,958,1,1,8,246,13,-233,Level A
292,shawny 2007.04.25,959,1,1,8,145,25,-120,Level A
80,Sailmo 2007.03.24,962,1,1,8,87,50,-37,Level A
702,Jia 2007.04.26,975,1,0,8,340,25,-315,Level A
245,LzVandy 2007.06.01,985,1,1,8,153,50,-103,Level A
291,vetteboy 2007.12.07,990,1,1,8,145,25,-120,Level A
90,Malca 2007.06.16,1015,1,1,8,67,25,-42,Level A
624,Artmachine 2007.11.30,1025,1,0,8,267,13,-254,Level A
36,paulfallet 2007.01.14,1042,1,0,8,65,63,-2,Level A
86,BurtForFun 2007.07.06,1055,2,2,8,64,25,-39,Level A
682,adamjodonnell 2007.12.22,1062,1,1,8,314,13,-301,Level A
424,WayneRuyLopez 2007.11.25,1119,1,1,8,204,38,-166,Level A
496,vijm 2007.06.28,1124,1,1,8,220,25,-195,Level A
52,mbafreng 2007.01.31,1141,1,1,8,56,38,-18,Level A
105,brunuoh 2007.10.22,1203,1,1,8,102,50,-52,Level A
