Sort,Name,Rating,Games,Result,Moves,CPL,MM,Sort score,Analysis 
427,FJB 2005.03.23,1011,14,11.5,260,165,30,-135,Level A
375,Knighter 2000.02.02,959,11,4,225,157,32,-125,Level A
809,iveyjr 2005.03.23,886,8,2,159,253,25,-228,Level A
719,DazedDj 2003.12.16,946,7,1,136,223,26,-197,Level A
748,Mxkuma 2005.03.23,938,6,0.5,133,232,23,-209,Level A
327,fboccardo 2005.04.18,976,5,1,126,144,32,-112,Level A
499,fboccardo 2005.04.20,935,10,4,118,186,35,-151,Level A
538,coloradorover 2002.12.26,968,7,0,118,190,30,-160,Level A
323,garethcash 2005.04.18,1003,4,3,117,143,33,-110,Level A
270,BoardBoy 2003.12.16,1039,7,6,116,133,37,-96,Level A
259,IIpawnII 2000.02.02,750,5,4,112,127,34,-93,Level A
908,iveyjr 2005.03.22,920,8,1,103,276,15,-261,Level A
492,FJB 2005.03.22,951,9,8,95,180,31,-149,Level A
936,jbpuffer 2005.07.30,848,5,0,95,285,18,-267,Level A
440,gottago 2006.03.01,1136,4,4,91,167,30,-137,Level A
364,Kyobutungi 2005.06.14,1130,1,0.5,89,148,26,-122,Level A
128,Bryceman 2003.04.13,1165,1,0,88,94,43,-51,Level A
468,FJB 2005.03.21,870,8,6.5,88,169,25,-144,Level B
203,pezzissimo 2005.06.14,862,1,0.5,87,107,30,-77,Level A
532,iveyjr 2005.03.21,988,7,1.5,87,189,30,-159,Level B
133,Fitzakarle 2003.04.13,742,1,1,86,78,26,-52,Level A
652,Tarish 2006.03.01,755,3,0,85,208,27,-181,Level A
830,obao 2000.03.28,785,2,0,80,262,27,-235,Level A
402,MischiMaestro 2005.04.20,1045,6,4,76,164,34,-130,Level B
817,Knighter 2000.01.15,899,2,1,72,244,15,-229,Level A
450,FJB 2005.03.17,859,5,1.5,70,164,24,-140,Level A
177,supertintin 2004.07.27,1229,1,0.5,69,117,49,-68,Level C
322,Memnochblue 2006.04.22,873,3,0.5,68,144,34,-110,Level A
572,spudthedud 2006.02.14,831,2,2,67,190,24,-166,Level A
681,NathanBlair 2005.07.12,1080,4,2.5,67,227,39,-188,Level A
683,nspirit 2004.07.12,1021,3,0.5,67,224,36,-188,Level A
531,ShawnB 2006.02.14,1126,2,0,66,191,32,-159,Level A
151,ferking 2006.04.22,1119,3,2.5,65,97,37,-60,Level A
413,mcgrail 2006.03.05,832,7,0,64,164,31,-133,Level A
907,southwestco 2004.07.05,990,4,0,62,277,16,-261,Level A
305,oubobcat 2006.12.08,841,3,2,61,135,30,-105,Level A
487,mcgrail 2006.03.01,935,3,0.5,61,171,23,-148,Level A
703,Memnochblue 2006.05.26,850,4,1,61,219,26,-193,Level A
467,noogit 2005.07.30,1007,3,3,60,169,25,-144,Level A
951,HEARTLESSWIZARD 2005.06.19,875,1,1,59,301,27,-274,Level A
731,Memnochblue 2006.05.31,841,5,2,58,235,31,-204,Level A
1028,Crashinator 2008.11.21,843,2,0.5,58,365,40,-325,Level A
707,FJB 2005.03.14,840,5,2,57,222,28,-194,Level A
1048,CashCow 2001.10.10,850,4,1,57,365,25,-340,Level A
540,Truelan 2006.10.28,1004,2,0,56,187,27,-160,Level A
593,ferking 2006.05.31,1111,4,3,56,204,34,-170,Level A
172,Nassor 2005.12.23,950,2,1,55,106,40,-66,Level B
219,rnajerac 2005.12.23,951,2,1,55,127,45,-82,Level B
284,Playlight 2000.03.28,1142,1,1,55,144,44,-100,Level A
629,alexcardoso 2004.07.05,938,4,4,55,200,24,-176,Level A
650,fboccardo 2005.04.22,985,2,0,55,212,31,-181,Level A
312,SamuelJunior 2006.10.28,960,2,2,54,140,33,-107,Level A
381,KnightLightning 2006.09.06,956,2,0.5,54,156,30,-126,Level A
191,southwestco 2004.07.27,759,1,0.5,52,98,25,-73,Level C
196,jessmoll 2005.08.14,1009,1,1,52,119,44,-75,Level A
349,HEARTLESSWIZARD 2005.07.04,897,2,0,52,157,40,-117,Level A
222,marcuscole 2006.06.30,1003,2,1.5,51,120,37,-83,Level B
627,Schuerer 2005.06.19,1067,1,0,51,204,28,-176,Level A
827,dahuigou 2008.11.21,685,2,1.5,51,268,33,-235,Level A
245,SaltzLynnMa 2006.05.03,1107,1,0.5,50,135,44,-91,Level A
319,garethcash 2005.04.22,994,2,2,50,135,26,-109,Level A
422,mcgrail 2006.03.02,818,7,0,50,154,20,-134,Level A
553,Halfman 2006.01.20,887,2,1,50,195,32,-163,Level A
586,Knighter 2000.01.26,911,1,0,50,190,22,-168,Level A
794,TeddySauyet 2006.07.26,978,3,2,50,251,28,-223,Level A
148,shipwrecked 2005.07.04,1057,2,2,49,96,37,-59,Level A
247,sammyCmtww 2004.07.12,908,3,2,49,132,41,-91,Level A
227,LOZO 2005.08.14,987,1,0,48,122,38,-84,Level A
332,gnutz 2000.01.26,855,1,1,48,140,27,-113,Level A
345,olinebeefs 2006.01.03,1089,2,0,48,149,33,-116,Level A
661,Triplea 2003.03.29,909,6,5.5,48,205,23,-182,Level A
834,KJett 2003.03.06,856,1,0,48,265,29,-236,Level A
160,Dkling 2006.06.30,952,2,0.5,47,108,45,-63,Level B
306,JasperGreene 2006.03.01,1087,1,0.5,47,131,26,-105,Level A
325,Funditor 2006.10.04,907,2,0,47,148,36,-112,Level A
657,honte 2005.02.11,940,1,0,47,220,38,-182,Level A
268,marcuscole 2006.05.03,884,1,0.5,46,128,33,-95,Level A
386,unclebaal 2005.09.09,1081,1,0,45,158,31,-127,Level B
460,HEARTLESSWIZARD 2004.06.17,917,1,0,45,160,18,-142,Level A
600,Agee 2003.03.06,1020,1,1,45,198,27,-171,Level A
659,basitian 2005.03.14,1171,2,0,45,209,27,-182,Level A
167,dolphinsfan 2006.09.06,973,1,0.5,44,103,39,-64,Level A
281,tujhbq 2006.10.04,994,1,1,44,131,32,-99,Level A
383,petergriffin 2006.01.20,873,2,1,44,146,20,-126,Level A
486,danlei 2006.04.09,891,1,0.5,44,173,25,-148,Level A
493,Bossdog 2006.04.09,900,1,0.5,44,172,23,-149,Level A
515,schnootzer 2006.03.29,837,7,4,44,185,30,-155,Level A
545,Dkling 2006.06.29,987,3,1,44,186,25,-161,Level A
564,rickx 2005.02.11,1054,1,1,44,194,30,-164,Level A
878,supriyasodhi 2006.06.12,922,3,0,44,276,23,-253,Level A
88,Halfman 2006.01.03,876,2,2,43,70,37,-33,Level A
155,rochon 2005.09.09,909,1,1,43,105,44,-61,Level B
250,Guuyver 2002.05.17,817,1,0,43,114,23,-91,Level A
273,owlman 2002.05.17,1039,1,1,43,110,14,-96,Level A
352,hotwheela 2006.12.18,911,1,0,43,143,26,-117,Level A
420,HEARTLESSWIZARD 2005.07.12,861,2,1,43,162,28,-134,Level A
529,ferking 2006.05.26,1074,2,2,43,196,37,-159,Level A
635,bigrig 2005.09.04,985,1,0,43,207,28,-179,Level A
640,marcuscole 2006.06.29,994,3,2,43,213,33,-180,Level A
903,Crashinator 2008.11.28,789,4,2.5,43,283,23,-260,Level A
932,amajouity 2002.04.02,869,2,1,43,285,19,-266,Level A
978,dahuigou 2008.11.28,794,4,1.5,43,316,26,-290,Level A
85,Tizko 2006.08.05,887,1,1,42,73,43,-30,Level A
173,abcc 2006.08.05,1083,1,0,42,102,36,-66,Level A
642,TeddySauyet 2006.06.26,999,2,2,42,204,24,-180,Level A
789,Gaby 2001.07.30,1002,3,3,42,239,17,-222,Level A
168,bigouden 2006.12.09,1013,1,0,41,107,42,-65,Level A
192,merka 2005.01.18,810,1,0,41,93,20,-73,Level A
378,Halfman 2006.01.07,897,2,0,41,149,24,-125,Level A
418,Malca 2006.10.26,976,1,1,41,166,32,-134,Level A
539,spudthedud 2006.02.12,874,2,0,41,189,29,-160,Level A
605,Triplea 2003.01.25,822,3,2,41,201,29,-172,Level A
837,hungerartist 2006.06.12,1076,3,3,41,256,19,-237,Level A
843,ferking 2006.05.23,1089,1,0,41,263,24,-239,Level A
856,dumpyshubby 2003.09.22,984,1,0.5,41,272,29,-243,Level A
863,kingmicah 2002.04.02,1112,2,1,41,273,27,-246,Level A
65,pajac 2005.01.18,1101,1,1,40,56,40,-16,Level A
195,yihan 2002.12.26,948,2,2,40,106,32,-74,Level A
239,Silicate 2005.09.04,964,1,1,40,132,43,-89,Level A
311,iveyjr 2005.04.23,860,2,1,40,142,35,-107,Level A
673,SamuelJunior 2006.10.26,982,1,0,40,199,15,-184,Level A
260,OboeDeity 2005.04.23,929,2,1,39,124,31,-93,Level A
726,reddawgdead 2006.07.26,936,3,1,39,233,31,-202,Level A
823,KJett 2003.04.20,870,2,0,39,250,18,-232,Level A
100,GolfBob 2004.06.17,950,1,1,38,67,29,-38,Level A
115,uvrays 2006.12.09,952,1,1,38,82,37,-45,Level A
252,NRking 2006.12.08,1138,2,1,38,131,39,-92,Level A
952,MartyL 2005.06.21,932,4,2,38,290,16,-274,Level A
965,jpiscool 2006.12.22,1141,1,1,38,307,24,-283,Level A
1018,hotwheela 2006.12.22,810,1,0,38,334,18,-316,Level A
86,iascrazyorioles 2006.12.18,921,1,1,37,61,30,-31,Level A
118,laconique 2000.01.15,1019,1,1,37,82,35,-47,Level A
206,SergB 2006.09.26,1153,1,1,37,124,46,-78,Level B
339,Auerweck 2001.01.21,850,1,1,37,138,24,-114,Level A
670,MartyL 2005.07.02,958,2,1,37,211,27,-184,Level A
679,KJett 2003.09.22,894,1,0.5,37,218,32,-186,Level A
940,cuzzer 2005.11.09,1067,1,0,37,291,22,-269,Level A
207,uvrays 2006.09.26,806,2,1,36,114,36,-78,Level A
393,IOMatrix 2001.01.21,1137,1,0,36,162,33,-129,Level A
522,HEARTLESSWIZARD 2004.12.23,827,1,0,36,184,28,-156,Level A
525,intelinside 2005.12.03,1027,1,0,36,199,42,-157,Level A
801,KJett 2003.01.25,1003,1,0,36,250,25,-225,Level A
866,kilkennycat 2005.11.09,904,1,1,36,270,22,-248,Level A
185,GolfBob 2006.05.23,892,1,1,35,113,43,-70,Level A
355,Knighter 2000.01.27,903,2,2,35,141,23,-118,Level A
419,twno 2004.05.12,876,3,2,35,163,29,-134,Level A
442,garethcash 2005.04.20,1033,3,1,35,172,34,-138,Level A
455,HEARTLESSWIZARD 2005.12.03,913,1,1,35,164,23,-141,Level A
461,schnootzer 2006.03.28,1108,6,0,35,186,43,-143,Level A
508,coloradorover 2003.01.22,1032,2,1,35,173,20,-153,Level A
732,iveyjr 2005.03.27,875,2,0,35,233,29,-204,Level A
832,FJB 2005.03.11,905,3,0.5,35,244,9,-235,Level A
83,HappyCrap 2000.02.02,885,1,1,34,61,32,-29,Level A
246,Halfman 2006.03.01,986,3,3,34,135,44,-91,Level A
288,WardBurtonfan 2003.02.02,821,2,1,34,130,29,-101,Level A
333,GolfBob 2004.12.23,1005,1,1,34,137,24,-113,Level A
389,PIONPAGO 2006.01.14,945,2,0.5,34,173,44,-129,Level B
551,LazyFIDERook 2006.08.22,922,1,0,34,198,35,-163,Level A
660,BollNCSU 2001.07.30,953,3,0,34,206,24,-182,Level A
771,StrwberyNBanana 2000.02.05,990,1,1,34,228,12,-216,Level A
802,chmpf 2009.03.29,926,1,1,34,249,24,-225,Level A
840,fjjvh 2009.03.29,672,1,0,34,262,24,-238,Level A
1034,hwm 2005.05.06,912,1,0,34,351,21,-330,Level A
299,telaviv 2004.10.05,1035,1,0,33,146,42,-104,Level A
359,pohlie 2005.06.30,1021,1,1,33,153,33,-120,Level A
563,TLorD 2005.06.13,1002,2,1,33,194,30,-164,Level B
653,WhiteSide 2004.03.02,848,2,1,33,208,27,-181,Level A
917,twno 2004.07.22,897,2,0,33,278,15,-263,Level A
1027,DumbRedNeck 2009.07.30,731,3,1,33,342,18,-324,Level A
142,ennil 2004.10.05,916,1,1,32,96,41,-55,Level A
204,Cybersun 2006.02.15,992,1,0,32,105,28,-77,Level A
594,ChessRio 2005.12.21,949,2,1,32,195,25,-170,Level A
626,twno 2004.05.15,904,2,2,32,207,31,-176,Level A
698,PIONPAGO 2006.01.13,931,2,2,32,214,22,-192,Level A
734,BothFeet 2005.11.07,926,1,0,32,232,28,-204,Level A
759,hitchhiker 2001.01.07,912,1,0,32,237,25,-212,Level A
885,Gaby 2001.01.07,1005,1,1,32,273,19,-254,Level A
1072,drevilrocks 2004.10.09,1119,1,0,32,394,22,-372,Level A
197,Triplea 2003.04.20,1006,2,2,31,107,32,-75,Level A
447,SamuelJunior 2006.06.27,916,2,1,31,179,39,-140,Level A
500,Halfman 2005.12.21,939,1,0,31,180,29,-151,Level A
595,HEARTLESSWIZARD 2004.10.10,862,1,0,31,193,23,-170,Level A
715,GolfBob 2004.03.12,865,1,0,31,219,23,-196,Level B
729,SpacedCadet 2002.01.25,1028,3,2,31,226,23,-203,Level A
753,BlueKeyboard 2005.05.06,1048,1,1,31,233,23,-210,Level A
846,BishopDaMan 2005.11.07,866,1,1,31,263,23,-240,Level A
855,Gaby 2002.01.25,930,3,1,31,275,32,-243,Level A
882,BothFeet 2005.08.26,946,1,0,31,286,32,-254,Level A
913,AceEvl 2002.11.13,923,2,0,31,286,23,-263,Level A
972,FJB 2005.03.16,836,1,1,31,314,26,-288,Level A
1003,Superdonut 2006.12.30,1065,1,0,31,324,23,-301,Level A
1004,aadeeb 2005.10.23,796,3,0,31,317,16,-301,Level A
1042,TeddySauyet 2006.06.27,1027,2,1,31,374,36,-338,Level A
1043,newwave 2001.10.10,1005,1,0,31,361,23,-338,Level A
91,KnightToRookSix 2003.02.02,1127,1,1,30,71,37,-34,Level A
166,Knighter 2000.01.28,925,2,2,30,104,40,-64,Level A
240,shipwrecked 2005.06.30,954,1,0,30,132,43,-89,Level A
266,Shadax 2005.06.13,969,2,1,30,138,43,-95,Level B
294,mrfriday 2000.01.27,737,1,0,30,140,37,-103,Level A
520,pddchess 2005.12.22,882,1,1,30,196,40,-156,Level A
706,Tarish 2006.01.27,861,1,0,30,227,33,-194,Level A
720,cpinya 2006.03.05,962,5,5,30,217,20,-197,Level A
761,WesternRed 1999.12.01,1126,1,1,30,237,23,-214,Level A
780,shechem 2004.02.11,1056,1,1,30,246,27,-219,Level A
833,hatrik 2006.10.25,1032,1,0,30,266,30,-236,Level A
845,amajouity 2002.08.02,930,1,0,30,273,33,-240,Level A
851,wolfla 2006.04.25,846,2,1,30,261,20,-241,Level A
909,Kimber 1999.12.01,828,1,0,30,289,27,-262,Level A
992,basitian 2005.03.16,1005,2,1,30,323,27,-296,Level A
346,netbrain 2006.08.22,1043,1,1,29,147,31,-116,Level A
392,cpinya 2006.03.29,1063,3,2,29,170,41,-129,Level B
426,Guuyver 2002.06.07,815,1,0,29,176,41,-135,Level A
479,HEARTLESSWIZARD 2004.10.22,846,1,0,29,163,17,-146,Level B
485,LeCrabe 2002.06.07,1056,1,1,29,176,28,-148,Level A
709,Johnnyp 2005.11.30,828,1,0,29,226,31,-195,Level A
754,mwcommander 2000.02.05,898,1,0,29,224,14,-210,Level A
808,mickeyl 2006.02.18,1008,2,1,29,259,31,-228,Level A
813,nuthegoob 2006.10.17,933,2,1,29,238,10,-228,Level A
1106,nuthegoob 2006.10.16,963,4,0,29,439,14,-425,Level A
139,PIONPAGO 2006.01.31,985,1,1,28,100,46,-54,Level C
180,ASABOTO 2004.03.12,1092,1,1,28,115,46,-69,Level B
276,HEARTLESSWIZARD 2005.06.08,909,1,0,28,122,25,-97,Level B
285,HEARTLESSWIZARD 2005.07.30,951,2,2,28,136,36,-100,Level B
382,dockson 2004.02.11,874,1,0,28,151,25,-126,Level A
391,Nassor 2005.12.22,1055,1,0,28,172,43,-129,Level A
412,pendragonz 2003.03.29,1031,1,0.5,28,172,39,-133,Level A
430,Halfman 2006.01.31,915,1,0,28,156,21,-135,Level C
584,doubleo 2005.06.29,962,1,0.5,28,193,25,-168,Level A
644,GolfBob 2004.03.03,966,1,0,28,201,21,-180,Level A
752,iveyjr 2005.03.24,876,2,1,28,235,25,-210,Level A
760,Trasimene 2002.08.02,1043,1,1,28,243,29,-214,Level A
783,nicolaus 2006.04.25,984,2,1,28,252,32,-220,Level A
816,bigrig 2005.08.06,866,1,1,28,250,21,-229,Level A
915,mssronald 2003.03.29,874,2,0,28,284,21,-263,Level A
919,rbb 2005.10.20,756,1,1,28,293,29,-264,Level A
75,telaviv 2004.10.10,1000,1,1,27,66,41,-25,Level A
171,astronomyguy 2005.11.30,1124,1,1,27,110,44,-66,Level A
230,ChessRio 2006.01.04,891,2,1,27,114,30,-84,Level A
309,shechem 2004.03.03,1020,1,1,27,136,30,-106,Level A
404,Krandall 2006.03.20,918,1,1,27,156,26,-130,Level A
431,JuliusG 2006.03.26,914,1,0,27,162,26,-136,Level A
436,Kyobutungi 2005.04.25,1101,1,0,27,178,41,-137,Level A
448,daChodeMan 2006.03.01,883,1,0,27,173,33,-140,Level A
559,fuz 2000.02.02,933,2,1,27,178,15,-163,Level A
604,mascota 2005.08.06,984,1,0,27,205,33,-172,Level A
607,olinebeefs 2006.01.27,1036,1,1,27,206,33,-173,Level A
621,alexcardoso 2004.07.22,1086,2,2,27,197,22,-175,Level A
740,HEARTLESSWIZARD 2005.11.24,928,1,0,27,239,33,-206,Level A
807,KJett 2003.02.21,874,1,0,27,249,22,-227,Level A
920,knightscastle 2002.10.20,1084,1,0,27,283,19,-264,Level B
961,SkarryLarry 2005.07.13,841,3,0,27,296,15,-281,Level A
1041,feelm 2006.11.12,998,2,0,27,370,33,-337,Level A
1045,aikloong 2002.07.20,698,5,0,27,361,22,-339,Level A
106,Shuckey 2000.01.28,916,1,0,26,91,50,-41,Level C
170,spiZ 2004.10.22,1047,1,1,26,112,46,-66,Level B
292,petergriffin 2006.03.22,1192,1,1,26,137,35,-102,Level A
363,JuliusG 2006.04.01,927,1,1,26,157,35,-122,Level A
380,pohlie 2005.11.24,1045,1,1,26,161,35,-126,Level A
429,ZeroKool 2000.02.06,914,1,0,26,158,23,-135,Level A
445,milamores 2005.11.24,922,1,1,26,162,23,-139,Level A
477,gswiff 2003.02.21,1088,1,1,26,181,35,-146,Level A
490,JuliusG 2006.03.30,892,1,1,26,184,35,-149,Level A
623,chrisyacoub 2002.10.20,914,1,1,26,218,42,-176,Level B
776,DHunt 2005.08.29,1091,1,1,26,237,19,-218,Level A
792,WhiteSide 2003.11.10,923,1,0,26,265,42,-223,Level A
835,ferking 2006.03.30,1021,1,0,26,255,19,-236,Level A
883,KJett 2003.04.04,869,1,0,26,277,23,-254,Level A
892,vav 2002.11.09,953,1,0,26,283,27,-256,Level A
896,spudthedud 2006.02.13,766,2,1,26,284,27,-257,Level A
991,newbeeforu 2005.07.01,1013,2,0,26,318,23,-295,Level A
99,nosek 2005.03.17,1106,2,1.5,25,86,48,-38,Level B
117,Laddie 2002.12.26,1044,2,2,25,87,40,-47,Level A
145,aet 2000.02.06,993,1,1,25,92,36,-56,Level A
152,Halfman 2006.03.20,1069,1,0,25,96,36,-60,Level A
261,ninox 2006.03.26,985,1,1,25,121,28,-93,Level A
275,KJett 2003.04.05,859,1,1,25,137,40,-97,Level A
307,Paestka 2005.05.17,946,1,0,25,125,20,-105,Level B
310,dockson 2004.02.10,874,1,0,25,151,44,-107,Level C
396,HEARTLESSWIZARD 2005.08.26,979,1,1,25,157,28,-129,Level A
405,GolfBob 2004.03.13,847,1,0,25,154,24,-130,Level A
441,giannhsk 2005.04.19,805,1,0,25,178,40,-138,Level A
464,StrwberyNBanana 2000.03.29,1090,1,1,25,155,12,-143,Level A
501,mrfriday 2000.01.15,672,1,0,25,175,24,-151,Level A
534,GolfBob 2004.09.02,999,1,1,25,187,28,-159,Level A
587,supriyasodhi 2006.06.09,938,1,0,25,184,16,-168,Level A
611,mwcommander 2000.03.29,844,1,0,25,185,12,-173,Level A
628,jpresley 2001.10.10,1093,3,3,25,200,24,-176,Level A
649,iveyjr 2005.07.02,889,2,1,25,213,32,-181,Level A
678,JohnstonDJ 2006.12.08,942,1,0,25,209,24,-185,Level A
725,bttfman 2002.11.13,1065,1,1,25,217,16,-201,Level A
869,chelletijn 2004.02.16,958,3,2,25,289,40,-249,Level A
876,HEARTLESSWIZARD 2004.09.25,804,3,1,25,280,28,-252,Level B
982,trovillion 2005.09.05,979,1,1,25,324,32,-292,Level A
1032,joelbow 2003.03.29,980,5,0,25,343,16,-327,Level A
1046,dgreality 2003.03.22,1132,1,0,25,351,12,-339,Level A
63,TLorD 2005.06.08,961,1,1,24,60,46,-14,Level B
140,TravisBarker 2005.08.06,1063,1,0.5,24,100,46,-54,Level B
178,faldur 2004.03.13,1102,1,1,24,106,38,-68,Level A
181,fboccardo 2005.04.19,928,1,1,24,111,42,-69,Level A
228,spudthedud 2006.02.15,965,1,1,24,122,38,-84,Level A
269,willcarter 2006.01.14,1027,1,1,24,134,38,-96,Level B
337,lsilipo 2005.04.22,818,1,1,24,152,38,-114,Level A
341,Tarish 2006.03.22,719,1,0,24,153,38,-115,Level A
358,feelm 2006.11.18,985,1,1,24,162,42,-120,Level A
372,AceEvl 2002.11.07,950,2,0.5,24,158,33,-125,Level A
373,BothFeet 2005.06.29,958,1,0.5,24,158,33,-125,Level A
495,ajwillington 2003.11.10,1054,1,1,24,188,38,-150,Level A
518,Theodin 2005.10.20,998,1,0,24,198,42,-156,Level A
597,Cybersun 2006.04.19,1043,1,0,24,187,17,-170,Level A
606,uvrays 2005.11.24,908,1,0,24,189,17,-172,Level A
690,Loran 2009.07.30,767,3,2,24,224,33,-191,Level A
721,pbanx 2006.10.18,1023,1,1,24,232,33,-199,Level A
747,nepvetm 2006.09.09,1053,1,0,24,238,29,-209,Level A
810,VasTech 2006.11.18,946,1,0,24,253,25,-228,Level A
877,RandyRoo 2006.12.09,753,5,0,24,286,33,-253,Level A
881,apospap 2006.06.26,972,1,0,24,270,17,-253,Level A
931,SamuelJunior 2006.06.26,904,1,0,24,295,29,-266,Level A
976,jujupieces 2005.09.02,976,1,0,24,318,29,-289,Level A
994,varchata 2002.06.07,971,1,0,24,322,25,-297,Level A
1040,fjjvh 2009.04.04,666,4,0,24,344,8,-336,Level A
119,Malca 2006.09.27,1046,1,0,23,77,30,-47,Level B
123,loccsta 2004.02.08,915,1,0,23,62,13,-49,Level C
193,Fitzakarle 2003.04.12,787,1,0,23,118,44,-74,Level A
218,wavewave 2006.03.05,1168,1,1,23,111,30,-81,Level A
242,yanto 2004.02.10,995,1,1,23,115,26,-89,Level C
249,feelm 2006.10.25,918,1,1,23,130,39,-91,Level A
256,BothFeet 2005.07.13,973,3,3,23,136,43,-93,Level A
262,NathanBlair 2005.08.06,929,1,0.5,23,129,35,-94,Level B
297,ELMC 2006.01.04,1057,1,0,23,120,17,-103,Level B
304,Silicate 2005.08.29,899,1,0,23,140,35,-105,Level A
390,pezzissimo 2005.08.17,879,1,0,23,173,44,-129,Level A
457,leffub 2004.08.29,901,2,2,23,172,30,-142,Level A
507,pawnpeddler 2005.04.22,1068,1,0,23,183,30,-153,Level A
631,HEARTLESSWIZARD 2004.09.02,791,1,0,23,186,9,-177,Level A
665,mrcapp 2004.04.17,867,1,0,23,209,26,-183,Level A
766,wwdotti 2005.11.28,1024,1,0,23,232,17,-215,Level A
811,pddchess 2006.01.23,887,2,1,23,250,22,-228,Level A
874,GolfBob 2004.03.09,935,2,0,23,273,22,-251,Level A
905,shechem 2004.03.09,1006,2,2,23,291,30,-261,Level A
964,allgood 2000.03.28,1095,1,1,23,313,30,-283,Level A
979,azshtrdude 2004.09.11,963,1,0,23,312,22,-290,Level A
1074,Anoten 2006.02.04,913,1,0,23,399,22,-377,Level A
1093,alexcardoso 2004.06.08,956,2,1,23,415,9,-406,Level A
12,PravinMamania 2004.02.08,982,1,1,22,18,41,23,Level C
42,Funditor 2006.09.27,947,1,1,22,49,46,-3,Level B
52,Halfman 2006.01.04,912,1,1,22,54,46,-8,Level B
111,Triplea 2003.04.12,1041,1,1,22,83,41,-42,Level A
161,ninox 2006.04.01,1010,1,0,22,99,36,-63,Level A
188,ChessProzac 2000.02.02,974,2,1,22,103,32,-71,Level A
202,hbengts 2006.06.09,973,1,1,22,109,32,-77,Level A
254,pocheptsoff 2005.04.10,1046,2,2,22,124,32,-92,Level A
320,vismaior 2006.02.20,947,1,0.5,22,151,41,-110,Level A
350,HEARTLESSWIZARD 2005.11.28,907,1,1,22,153,36,-117,Level A
399,cpinya 2006.03.28,970,5,5,22,171,41,-130,Level A
410,southwestco 2004.07.15,770,1,0,22,155,23,-132,Level B
434,HEARTLESSWIZARD 2005.08.17,975,1,1,22,159,23,-136,Level A
435,bttfman 2002.11.07,995,2,1.5,22,154,18,-136,Level A
472,PawnStarrz 2003.04.04,1128,1,1,22,177,32,-145,Level A
478,Funditor 2006.10.03,892,2,1,22,178,32,-146,Level A
552,skuller 2002.07.20,1073,5,5,22,195,32,-163,Level A
795,HEARTLESSWIZARD 2004.06.10,963,1,0,22,241,18,-223,Level B
798,eaglesloft 2003.03.29,1013,2,2,22,251,27,-224,Level A
804,SChlebowski 2005.09.02,1061,1,0,22,258,32,-226,Level B
967,obao 2000.03.27,857,2,0,22,292,9,-283,Level A
984,smugknave 2005.10.10,989,2,0.5,22,320,27,-293,Level A
1058,sneakypawn 2006.10.26,894,2,0,22,361,9,-352,Level A
1062,jcizotti 2005.09.05,944,1,0,22,390,27,-363,Level A
1105,greenqueenbrasil 2007.04.23,816,1,0,22,429,5,-424,Level A
59,aafire 2006.04.19,943,1,1,21,55,43,-12,Level A
78,TEMH 2005.05.17,1041,1,1,21,69,43,-26,Level B
90,dockson 2004.01.15,869,1,1,21,91,57,-34,Level C
94,philippeopr 2005.08.14,1135,1,0.5,21,68,33,-35,Level A
134,lsilipo 2005.04.25,872,1,1,21,96,43,-53,Level A
141,churningpigskin 2003.12.16,740,1,0,21,103,48,-55,Level B
159,AceDiamond 2003.12.16,990,1,1,21,86,24,-62,Level B
199,ninox 2006.01.07,999,1,1,21,94,19,-75,Level A
263,dockson 2005.03.11,936,1,1,21,118,24,-94,Level A
331,nicolaus 2006.06.23,1084,1,1,21,142,29,-113,Level A
357,SkarryLarry 2005.08.14,769,1,0.5,21,152,33,-119,Level A
362,Panzulo 2006.06.23,844,1,0,21,159,38,-121,Level A
424,PravinMamania 2004.01.15,1041,1,0,21,153,19,-134,Level C
484,debateking 2005.03.27,1101,1,1,21,191,43,-148,Level A
504,HEARTLESSWIZARD 2004.10.09,779,1,1,21,181,29,-152,Level A
521,MartyL 2005.07.01,915,2,2,21,194,38,-156,Level A
523,redistribute 2006.10.03,1096,2,1,21,180,24,-156,Level A
528,Knighter 2000.01.22,925,2,0,21,177,19,-158,Level A
570,Unknowner 2005.10.23,1071,1,1,21,195,29,-166,Level A
620,kimida 2006.02.20,1041,1,0.5,21,199,24,-175,Level A
634,Knighter 2000.01.23,893,2,1,21,217,38,-179,Level A
639,jshumaker 2006.12.30,845,1,1,21,213,33,-180,Level A
648,brisham 2003.03.03,991,2,2,21,214,33,-181,Level A
664,sixer 2006.05.27,829,1,0,21,212,29,-183,Level C
695,Sevenkings 2006.12.28,1012,1,0,21,221,29,-192,Level A
696,TomJr 2005.10.15,873,1,0,21,216,24,-192,Level A
713,HEARTLESSWIZARD 2004.09.11,764,1,1,21,234,38,-196,Level A
764,Halfman 2006.02.18,925,1,0,21,228,14,-214,Level A
772,rossx 2006.09.05,974,1,1,21,236,19,-217,Level A
787,Paestka 2005.05.16,982,1,0,21,240,19,-221,Level A
790,cutenuke 2002.11.09,927,1,1,21,236,14,-222,Level A
803,darjos 2003.03.03,971,2,0,21,244,19,-225,Level A
814,iascrazyorioles 2006.03.26,954,1,0,21,262,33,-229,Level A
847,dopeyone 2004.03.15,827,1,0,21,259,19,-240,Level A
865,ooohtodd 2005.07.12,1004,1,0,21,286,38,-248,Level A
867,twno 2004.04.26,890,2,0,21,267,19,-248,Level A
897,cjott 2005.07.24,975,2,0,21,292,33,-259,Level A
912,rossx 2006.09.13,998,1,1,21,296,33,-263,Level A
954,Triplea 2003.02.01,871,1,0,21,306,29,-277,Level A
960,Derro 2004.08.01,1151,1,1,21,310,29,-281,Level A
980,louiswei 2007.10.23,800,1,0,21,300,10,-290,Level A
1054,Nemobxl 2006.04.21,930,1,0,21,367,19,-348,Level A
38,vat 2004.07.15,1217,1,1,20,46,45,-1,Level B
87,Tibmag 2005.07.11,1029,1,1,20,67,35,-32,Level A
107,BlindRoundTower 2002.12.26,1037,1,1,20,71,30,-41,Level A
184,danielp 2006.05.27,1087,1,1,20,115,45,-70,Level C
215,nuthegoob 2006.10.31,936,1,0,20,105,25,-80,Level A
236,MTSimkus 2005.07.11,969,1,0,20,112,25,-87,Level A
248,mcavoy 2004.04.17,1064,1,1,20,131,40,-91,Level A
313,LuckyG 2006.03.13,1053,1,1,20,137,30,-107,Level A
330,OwenDeathstalker 2004.06.10,968,1,1,20,158,45,-113,Level B
343,betsys 2006.03.13,942,1,0,20,145,30,-115,Level A
401,JorgeAdRomero 2006.01.04,1028,1,0,20,165,35,-130,Level A
406,dardanus 2003.04.05,1134,1,0,20,151,20,-131,Level A
417,Unknowner 2005.10.15,1088,1,1,20,169,35,-134,Level A
432,shahar 2006.09.09,900,1,1,20,161,25,-136,Level A
466,dbalparda 2006.02.12,966,1,1,20,179,35,-144,Level B
543,hydek 2006.03.30,1033,1,1,20,201,40,-161,Level A
558,ultradude 2005.02.22,885,1,1,20,188,25,-163,Level B
560,GolfBob 2005.03.17,1108,1,0,20,173,10,-163,Level A
590,pddchess 2006.01.10,926,2,0.5,20,194,25,-169,Level A
609,Lightmonster 2006.03.26,983,1,1,20,203,30,-173,Level A
624,brekneck 2003.02.01,1073,1,1,20,216,40,-176,Level A
630,Joinedup 2005.02.22,890,1,0,20,212,35,-177,Level B
637,rbb 2006.03.25,900,1,1,20,204,25,-179,Level A
663,clickoo 2005.12.09,820,1,0,20,218,35,-183,Level A
669,Bossdog 2006.04.10,880,1,1,20,214,30,-184,Level A
688,nuthegoob 2006.10.18,933,2,1,20,215,25,-190,Level A
694,GlennaSarous 2003.11.22,956,1,0,20,222,30,-192,Level A
699,Nackler 2006.09.05,1010,1,0,20,212,20,-192,Level A
736,johnald 2006.03.28,855,2,1,20,214,10,-204,Level A
757,LaFleurDeLys 2003.01.22,885,1,0,20,231,20,-211,Level A
767,dafke 2005.09.02,997,1,1,20,230,15,-215,Level A
821,DAarden 2006.10.17,975,1,1,20,256,25,-231,Level A
842,DINOCO 2007.10.23,781,1,1,20,243,5,-238,Level A
899,mrfriday 2000.01.29,724,1,0,20,274,15,-259,Level A
927,KJett 2003.03.22,842,1,1,20,285,20,-265,Level A
959,HEARTLESSWIZARD 2005.07.24,949,2,2,20,285,5,-280,Level A
988,HEARTLESSWIZARD 2004.08.01,804,1,0,20,319,25,-294,Level A
57,RHankinsJr 2006.02.12,1149,1,1,19,53,42,-11,Level A
69,uvrays 2006.10.31,831,1,1,19,52,32,-20,Level A
124,wolfla 2006.02.12,913,1,0,19,108,58,-50,Level B
125,stefaan 2000.01.22,1024,1,1,19,87,37,-50,Level A
182,caleas 2002.09.20,1021,1,1,19,106,37,-69,Level A
221,jashevan 2005.12.09,1088,1,1,19,119,37,-82,Level A
223,Halfman 2006.03.25,1060,1,0,19,120,37,-83,Level A
353,ItIsLife 2006.12.28,943,1,1,19,138,21,-117,Level A
444,Faeriedragon 2003.01.10,822,1,1,19,171,32,-139,Level B
473,Nemobxl 2006.03.30,954,1,0,19,177,32,-145,Level A
496,CooperW 2005.05.16,1010,1,1,19,182,32,-150,Level A
509,RDearman 2003.01.10,1082,1,0,19,201,47,-154,Level B
524,jonohelms 2005.09.26,1130,1,1,19,177,21,-156,Level A
554,twno 2004.04.21,930,1,0,19,195,32,-163,Level A
581,aBlade 2006.04.29,1079,1,0,19,205,37,-168,Level A
601,rtgreen 2005.09.26,861,1,0,19,192,21,-171,Level A
619,gough 2003.11.22,971,1,1,19,207,32,-175,Level A
662,Sevenkings 2006.10.26,1101,2,2,19,203,21,-182,Level A
716,MassachusettsFats 2006.03.21,1080,1,0,19,217,21,-196,Level A
825,pezzissimo 2005.06.13,910,1,0,19,249,16,-233,Level B
844,dillondeck 2006.01.13,967,1,0,19,250,11,-239,Level A
889,iveyjr 2005.03.26,880,1,0,19,276,21,-255,Level A
906,KJett 2003.02.20,887,1,0,19,282,21,-261,Level A
949,metallicguy 2006.09.13,1001,1,0,19,299,26,-273,Level A
968,ferking 2006.03.16,1034,1,0,19,296,11,-285,Level A
975,ClaesF 2006.04.08,1036,1,0,19,293,5,-288,Level A
990,Reeco 2005.07.23,1150,1,1,19,321,26,-295,Level A
1019,morts 2006.05.06,1070,1,0,19,350,32,-318,Level B
1035,HogODeath 2007.04.23,1047,1,1,19,353,21,-332,Level A
1057,bonillaice 2005.07.23,847,1,0,19,363,11,-352,Level A
1068,mssronald 2003.02.15,849,2,1,19,384,16,-368,Level A
1080,Hamhawk 2005.03.22,1006,2,0,19,391,5,-386,Level A
1084,Bossdog 2006.04.24,907,1,1,19,404,11,-393,Level A
10,dbalparda 2006.03.02,1165,1,1,18,32,56,24,Level B
194,twno 2004.04.04,890,1,1,18,113,39,-74,Level A
216,younder 2002.09.20,920,1,0,18,114,33,-81,Level A
225,WarlordNatick 2005.10.16,1117,1,1,18,140,56,-84,Level B
237,Ziggles 2005.07.30,999,1,0,18,121,33,-88,Level B
253,Krandall 2006.03.18,978,1,0,18,125,33,-92,Level B
295,Paestka 2005.05.12,918,1,0,18,125,22,-103,Level B
296,zebrafish 2006.04.29,876,1,1,18,120,17,-103,Level A
300,Knighter 2000.01.30,952,2,2,18,126,22,-104,Level A
301,chelletijn 2004.02.15,998,3,1,18,149,44,-105,Level A
316,allgood 2000.03.27,1015,2,2,18,130,22,-108,Level A
336,coloradorover 2003.01.07,1046,2,1,18,153,39,-114,Level A
342,voetbalfan 2004.02.15,968,3,2,18,148,33,-115,Level A
366,johnoleary 2005.06.13,1044,1,1,18,167,44,-123,Level B
370,mrfriday 2000.02.07,758,1,0,18,169,44,-125,Level A
374,Knighter 2000.01.29,954,1,1,18,158,33,-125,Level A
415,Ureshii 2004.04.21,908,1,1,18,144,11,-133,Level A
474,Folinsbee 2004.03.02,934,1,0,18,173,28,-145,Level A
482,hcube 2004.04.04,1092,1,0,18,164,17,-147,Level A
557,Yesu 2006.04.08,901,1,1,18,191,28,-163,Level A
614,pddchess 2005.12.14,957,1,0,18,202,28,-174,Level A
641,GlennaSarous 2003.10.29,933,1,1,18,208,28,-180,Level A
651,mrudy 2003.01.22,964,1,1,18,209,28,-181,Level A
655,Ziggles 2005.07.27,830,1,1,18,203,22,-181,Level A
685,HEARTLESSWIZARD 2004.08.29,843,2,0,18,206,17,-189,Level A
758,Ljovusa 2004.05.12,1013,1,1,18,240,28,-212,Level A
777,twno 2004.07.16,920,2,0,18,229,11,-218,Level A
785,HEARTLESSWIZARD 2005.07.02,931,1,0,18,231,11,-220,Level A
815,mssronald 2003.02.13,944,1,0,18,251,22,-229,Level A
829,johnald 2006.03.20,907,1,0,18,263,28,-235,Level A
871,ooohtodd 2005.07.18,946,2,1,18,271,22,-249,Level A
886,BoardBoy 2004.01.04,1079,1,0.5,18,265,11,-254,Level A
888,BothFeet 2005.07.27,964,1,0,18,283,28,-255,Level A
891,ChessRio 2005.12.29,925,1,0,18,289,33,-256,Level A
914,debateking 2005.03.26,1031,1,1,18,285,22,-263,Level A
941,SChlebowski 2006.02.13,1152,1,1,18,291,22,-269,Level A
946,Cybersun 2006.04.24,1021,1,0,18,288,17,-271,Level A
958,aalaptop 2006.02.04,1082,1,1,18,291,11,-280,Level A
969,FJB 2005.04.03,1083,1,1,18,325,39,-286,Level A
973,Truelan 2006.10.16,932,1,1,18,310,22,-288,Level A
998,SavoySlim 2003.10.29,1049,1,0,18,310,11,-299,Level A
1037,lager 2002.04.12,882,1,0,18,363,28,-335,Level A
1044,nathy 2009.08.04,752,1,0,18,360,22,-338,Level A
1137,surrencytw 2004.11.13,1093,1,0,18,534,11,-523,Level A
35,HEARTLESSWIZARD 2005.09.14,942,1,1,17,53,53,0,Level B
40,Cortez 2000.02.02,970,1,0,17,37,35,-2,Level B
153,aet 2000.02.07,1040,1,1,17,95,35,-60,Level A
163,lksharma 2006.12.09,1256,2,2,17,81,18,-63,Level A
165,doomie 2006.04.19,873,1,1,17,111,47,-64,Level B
190,andermec 2006.01.07,900,1,1,17,107,35,-72,Level A
255,fuss 2004.03.15,992,1,1,17,121,29,-92,Level A
318,Silicate 2005.08.27,891,1,0,17,144,35,-109,Level A
328,Xillion 2006.03.20,1049,1,1,17,141,29,-112,Level A
356,alexcardoso 2004.07.16,1055,2,2,17,136,18,-118,Level A
409,hotwheelb 2006.12.02,854,1,0,17,156,24,-132,Level A
425,GolfBob 2005.09.14,1016,1,0,17,152,18,-134,Level B
443,claudiolozea 2003.02.20,1088,1,1,17,167,29,-138,Level A
456,Silicate 2005.09.02,932,1,1,17,201,59,-142,Level B
491,iveyjr 2005.03.28,866,1,0,17,184,35,-149,Level B
497,army 2000.01.29,881,1,0,17,168,18,-150,Level B
505,DazedDj 2004.01.04,809,1,0.5,17,176,24,-152,Level A
526,Farfarer 2004.07.27,1100,1,0,17,192,35,-157,Level A
541,Tarish 2006.02.28,775,1,0,17,184,24,-160,Level A
555,matingrituals 2006.05.03,964,1,0,17,192,29,-163,Level A
571,HEARTLESSWIZARD 2005.03.25,947,1,0,17,190,24,-166,Level A
610,Bulochka 2005.01.05,921,1,0,17,197,24,-173,Level A
643,SUNNYMAN 2006.03.16,950,1,1,17,204,24,-180,Level A
687,bigrig 2005.10.10,1001,1,0.5,17,225,35,-190,Level A
710,augustuscaesar 2006.07.25,917,1,0,17,213,18,-195,Level A
733,Zumon 2004.07.29,1089,1,1,17,233,29,-204,Level A
770,FJB 2005.03.15,860,2,0,17,234,18,-216,Level A
778,zhouzhaowu 2009.04.04,821,1,1,17,218,0,-218,Level A
822,lsilipo 2005.04.07,887,1,0,17,267,35,-232,Level B
831,eaglesloft 2003.02.15,1035,2,1,17,259,24,-235,Level A
875,Lexus 2003.05.03,1055,1,0,17,293,41,-252,Level A
887,hwm 2005.04.30,912,1,0,17,284,29,-255,Level A
916,Garzon 2006.07.26,1080,1,1,17,281,18,-263,Level A
925,chrisyacoub 2002.08.09,952,1,0,17,300,35,-265,Level A
1008,RoKStAR 2006.03.29,995,2,1,17,330,24,-306,Level A
1010,KJett 2003.05.03,865,1,1,17,334,24,-310,Level A
1129,pinkdragon 2006.04.27,906,1,0,17,512,6,-506,Level A
131,mwcommander 2000.04.06,832,1,1,16,96,44,-52,Level A
205,jrico 2005.08.27,1086,1,1,16,96,19,-77,Level A
264,talkymeat 2005.04.10,909,1,0,16,158,63,-95,Level B
272,ferking 2006.04.19,1078,1,0,16,127,31,-96,Level B
280,franciscotlima 2005.08.13,993,1,0,16,137,38,-99,Level B
361,StrwberyNBanana 2000.04.06,1052,1,0,16,159,38,-121,Level A
376,azshtrdude 2005.12.14,881,1,1,16,156,31,-125,Level A
416,medilein 2005.03.28,1108,1,1,16,178,44,-134,Level B
421,agathea 2006.05.31,988,1,1,16,159,25,-134,Level A
454,iansss 2006.05.06,926,1,1,16,166,25,-141,Level B
511,rbb 2005.10.16,820,1,0,16,179,25,-154,Level B
535,MMen 2004.05.12,1017,1,0,16,165,6,-159,Level A
549,HEARTLESSWIZARD 2004.07.29,827,1,0,16,201,38,-163,Level A
561,GolfBob 2005.03.25,1032,1,1,16,169,6,-163,Level A
568,cybersmash 2004.06.08,1020,2,1,16,178,13,-165,Level A
625,exaanil 2006.04.23,1068,1,1,16,214,38,-176,Level A
700,Halfman 2006.01.23,876,2,1,16,211,19,-192,Level A
723,BishopDaMan 2005.10.08,985,1,0,16,219,19,-200,Level A
735,ooohtodd 2005.07.15,968,1,0,16,223,19,-204,Level B
763,utsutso 2002.05.12,1098,1,0,16,233,19,-214,Level B
765,LeyZ 2009.08.04,826,1,1,16,234,19,-215,Level A
819,Funditor 2006.09.28,1016,1,0,16,261,31,-230,Level A
850,ZEFER 2003.04.11,1071,1,0.5,16,272,31,-241,Level A
853,powendel 2006.05.31,1002,1,0,16,254,13,-241,Level A
870,Etka 2006.04.10,1048,1,0,16,274,25,-249,Level A
902,zebrafish 2006.04.23,917,1,0,16,285,25,-260,Level A
923,Cybersun 2006.02.12,1004,1,0,16,277,13,-264,Level A
966,BothFeet 2005.07.18,967,1,0,16,302,19,-283,Level A
1085,MartyL 2005.06.23,956,1,0,16,399,6,-393,Level A
1099,dockson 2004.04.06,984,1,1,16,431,19,-412,Level A
1104,twno 2004.04.06,883,1,0,16,438,19,-419,Level A
47,aet 2000.01.29,994,1,1,15,52,47,-5,Level B
89,FEDt 2006.12.02,1054,1,1,15,66,33,-33,Level A
101,HGBoone 2005.08.13,873,1,1,15,79,40,-39,Level B
103,artir 2005.06.21,1068,2,0,15,87,47,-40,Level B
112,Nett 2005.01.05,1004,1,1,15,76,33,-43,Level A
187,americanista 2005.12.29,1069,1,1,15,104,33,-71,Level A
212,giles 2000.01.23,888,1,1,15,99,20,-79,Level A
317,sibil 2004.04.26,1104,1,1,15,149,40,-109,Level A
348,flinn 2003.05.02,1029,1,0,15,157,40,-117,Level A
351,Armoral 2004.04.17,1029,1,0,15,150,33,-117,Level A
384,vibronic 2004.04.17,931,1,1,15,146,20,-126,Level A
395,Kyobutungi 2005.04.07,1067,1,1,15,162,33,-129,Level B
398,stdonn 2006.02.12,1097,1,1,15,142,13,-129,Level A
428,TheCardinal 2006.07.25,1052,1,1,15,162,27,-135,Level A
462,Saldeeznuts 2006.09.28,937,1,1,15,170,27,-143,Level A
463,Fitzakarle 2003.04.10,907,1,0,15,163,20,-143,Level A
498,Cahta 2002.03.03,1116,1,0,15,163,13,-150,Level A
510,twno 2004.05.11,869,1,1,15,187,33,-154,Level A
573,southwestco 2004.07.14,782,1,0,15,179,13,-166,Level A
596,Silicate 2005.08.28,884,1,1,15,190,20,-170,Level A
647,Kyobutungi 2005.03.24,1095,1,0,15,193,13,-180,Level A
671,SChlebowski 2006.01.10,1078,1,1,15,211,27,-184,Level A
676,DazedDj 2004.01.02,840,2,0,15,212,27,-185,Level B
684,amajouity 2002.06.27,922,1,0,15,221,33,-188,Level B
702,DaveFromWazza 2005.11.27,1000,1,1,15,233,40,-193,Level A
730,dumpyshubby 2003.07.05,920,2,1,15,210,7,-203,Level A
852,encairo 2004.02.26,1034,1,0,15,254,13,-241,Level B
857,LEOUTSAKOS 2005.04.30,1085,1,1,15,270,27,-243,Level A
859,Sunsfan 2006.07.26,1008,1,1,15,263,20,-243,Level A
868,BoardBoy 2003.12.12,1024,1,0.5,15,261,13,-248,Level B
955,iveyjr 2005.04.03,857,1,0,15,305,27,-278,Level A
970,CelticMoon 2003.01.24,1097,2,2,15,300,13,-287,Level A
1012,platyjoe 2004.07.03,1051,1,1,15,326,13,-313,Level A
1033,augustuscaesar 2006.07.26,850,1,0,15,355,27,-328,Level A
51,whatbomb 2002.05.12,887,1,1,14,58,50,-8,Level B
129,Cybersun 2006.05.03,1031,1,1,14,94,43,-51,Level A
132,GaryP 2001.06.12,934,1,1,14,95,43,-52,Level A
156,HOOT 2002.03.03,860,1,1,14,90,29,-61,Level A
169,DazedDj 2003.12.12,921,1,0.5,14,123,57,-66,Level B
251,mascota 2005.07.15,965,1,1,14,142,50,-92,Level B
258,ChessRio 2005.12.30,912,1,1,14,129,36,-93,Level A
315,voetbalfan 2004.09.25,978,2,1,14,151,43,-108,Level B
334,eaglesloft 2003.02.13,1027,1,1,14,120,7,-113,Level A
367,aGameofChess 2006.01.12,1111,1,0,14,144,21,-123,Level B
371,Turtleskies 2004.07.27,891,1,1,14,161,36,-125,Level A
465,Panzerkampfwagon 2006.02.12,912,1,1,14,187,43,-144,Level A
481,chessmoker 2001.06.12,946,1,0,14,176,29,-147,Level A
488,marioandluigi 2006.03.05,1130,1,1,14,169,21,-148,Level A
506,vismaior 2006.03.02,936,1,1,14,173,21,-152,Level A
514,slingdraw 2000.01.30,899,1,0,14,191,36,-155,Level A
533,MikeRN 2002.08.09,1023,1,1,14,188,29,-159,Level A
550,Halfman 2005.12.30,897,1,0,14,199,36,-163,Level A
574,Halfman 2006.01.01,882,1,0,14,210,43,-167,Level A
576,EvilenasThrone 2004.11.19,1033,1,0,14,203,36,-167,Level A
577,Kyobutungi 2005.03.22,1043,1,1,14,196,29,-167,Level A
582,iveyjr 2005.07.22,901,1,0,14,204,36,-168,Level A
591,americanista 2006.01.01,1002,1,1,14,190,21,-169,Level A
682,SkarryLarry 2005.07.15,792,2,0,14,224,36,-188,Level A
689,betsys 2006.03.21,850,1,1,14,227,36,-191,Level A
711,sneakypawn 2006.11.14,865,1,0,14,209,14,-195,Level B
750,nicolaus 2006.03.29,1024,3,1,14,216,7,-209,Level A
762,dahuigou 2008.12.05,706,1,0,14,235,21,-214,Level A
773,Knighter 1999.12.28,926,1,1,14,231,14,-217,Level A
775,bigouden 2006.12.07,1022,1,0,14,239,21,-218,Level A
938,Endymion 2002.04.12,1046,1,1,14,297,29,-268,Level A
956,HEARTLESSWIZARD 2005.11.05,940,1,0,14,292,14,-278,Level A
963,Dusti 2003.02.05,837,1,0,14,303,21,-282,Level A
1007,lsilipo 2005.04.10,854,2,0,14,325,21,-304,Level B
1029,FJB 2005.03.27,1024,1,1,14,354,29,-325,Level A
55,DSSagent 2003.06.26,980,1,1,13,64,54,-10,Level B
80,pendragonz 2003.04.10,1070,1,1,13,65,39,-26,Level A
143,smod 2006.01.23,984,1,1,13,94,39,-55,Level B
174,HEARTLESSWIZARD 2005.02.09,853,1,1,13,97,31,-66,Level B
176,tunacem 2006.11.12,920,1,1,13,113,46,-67,Level B
179,wreckncrew 2005.06.28,896,1,1,13,99,31,-68,Level A
231,sibil 2004.03.02,1095,1,1,13,116,31,-85,Level A
232,HEARTLESSWIZARD 2005.07.22,879,1,1,13,109,23,-86,Level A
244,Parne 2004.05.15,1075,1,0,13,137,46,-91,Level B
433,ModestNihilist 2005.09.28,948,1,1,13,159,23,-136,Level A
437,Mikimouse 2003.03.22,1027,1,0,13,176,39,-137,Level B
453,znode 2005.10.08,1000,1,1,13,180,39,-141,Level A
458,SamuelJunior 2006.12.07,946,1,1,13,165,23,-142,Level A
502,churningpigskin 2003.06.26,797,1,0,13,166,15,-151,Level B
503,schachmatze 2006.04.21,920,1,1,13,191,39,-152,Level A
527,pohlie 2006.05.10,986,1,0,13,181,23,-158,Level A
544,iansss 2006.04.27,895,1,0,13,200,39,-161,Level A
547,MMen 2004.05.11,1070,1,0,13,176,15,-161,Level A
566,Triplea 2003.05.01,990,1,0,13,204,39,-165,Level B
575,dgreality 2003.04.11,923,1,0.5,13,206,39,-167,Level A
578,Lexus 2003.05.10,1035,1,0.5,13,190,23,-167,Level B
585,KJett 2005.11.05,1046,1,1,13,191,23,-168,Level A
646,coloradorover 2003.02.05,1141,1,1,13,195,15,-180,Level A
654,amajouity 2002.06.07,907,1,1,13,204,23,-181,Level A
680,Rohein 2005.06.28,1063,1,0,13,195,8,-187,Level A
692,iveyjr 2005.04.06,854,1,0,13,206,15,-191,Level A
693,bonillaice 2005.08.07,830,2,1,13,238,46,-192,Level B
724,arragorn 1999.12.13,959,1,1,13,215,15,-200,Level A
742,loserman 2005.09.28,901,1,0,13,246,39,-207,Level A
751,dockson 2005.03.15,951,1,1,13,241,31,-210,Level A
782,Paestka 2005.05.06,1000,2,0,13,234,15,-219,Level B
788,jmlichtman 2006.05.26,961,2,1,13,236,15,-221,Level A
805,Ccannibal 2006.04.27,1051,1,1,13,257,31,-226,Level A
873,TeddySauyet 2006.06.28,1010,1,0,13,290,39,-251,Level A
879,Mikimouse 2003.03.31,1017,1,0,13,276,23,-253,Level A
918,entanglement 2005.06.21,994,1,1,13,295,31,-264,Level A
924,passports 2005.09.19,1107,1,1,13,272,8,-264,Level A
983,ferking 2006.03.14,1043,2,0,13,339,46,-293,Level B
999,iveyjr 2005.04.07,864,1,0,13,315,15,-300,Level A
1020,ConditionZero 2004.11.13,873,1,1,13,350,31,-319,Level A
1030,Halfman 2006.02.13,930,1,0,13,349,23,-326,Level A
1081,ooohtodd 2005.07.26,951,1,0,13,411,23,-388,Level B
5,muselaers 2005.05.12,1017,1,1,12,13,67,54,Level B
21,youngrower 2005.05.06,830,2,2,12,44,58,14,Level B
44,HGBoone 2006.11.14,1124,1,1,12,62,58,-4,Level B
50,EliteHunter 2006.03.18,1006,1,1,12,66,58,-8,Level B
102,jmvbxx 2006.09.06,1004,1,1,12,98,58,-40,Level B
110,petergriffin 2006.02.28,1167,1,1,12,84,42,-42,Level A
113,KJett 2003.05.10,886,1,0.5,12,86,42,-44,Level B
137,Halfman 2006.04.24,1082,1,1,12,78,25,-53,Level A
138,BoardBoy 2004.01.02,1071,2,2,12,112,58,-54,Level B
144,Agenbite 1999.12.13,1025,1,0,12,88,33,-55,Level A
183,racinebaby 2006.11.29,1125,1,1,12,94,25,-69,Level A
186,Rhiannontg 2005.02.09,1068,1,0,12,103,33,-70,Level B
208,Crashinator 2008.12.05,808,1,1,12,95,17,-78,Level A
233,Triplea 2003.03.22,863,1,1,12,120,33,-87,Level B
274,zukerro 2004.02.16,932,1,0,12,139,42,-97,Level A
302,Chronoscepter 1999.12.28,799,1,0,12,147,42,-105,Level A
308,alexcardoso 2004.07.14,1066,1,1,12,122,17,-105,Level A
326,Vox 2004.11.19,806,1,1,12,145,33,-112,Level A
377,olzie 2005.03.17,1031,1,1,12,150,25,-125,Level A
394,harrypotar 2006.11.29,820,1,0,12,162,33,-129,Level A
407,Tarish 2006.09.13,705,1,0,12,174,42,-132,Level B
469,dldnjstjq 2005.05.02,939,1,0,12,169,25,-144,Level A
470,wolfla 2006.04.24,874,1,0,12,161,17,-144,Level A
519,KirkB 2003.01.25,1174,1,1,12,198,42,-156,Level A
537,DKG 2005.04.07,1077,1,1,12,202,42,-160,Level A
548,debateking 2005.03.24,1039,1,1,12,179,17,-162,Level A
616,maxmaz 2004.05.15,1077,1,0,12,199,25,-174,Level A
658,rochon 2005.09.18,1069,1,0,12,215,33,-182,Level A
668,DSSagent 2003.05.01,992,1,1,12,217,33,-184,Level B
705,KellBell 2001.07.05,547,1,0,12,236,42,-194,Level A
714,FarooqBaloch 2005.12.04,997,1,0,12,221,25,-196,Level A
746,sneakypawn 2006.10.27,867,1,0,12,225,17,-208,Level B
768,Breneric 2006.04.27,1028,1,1,12,223,8,-215,Level A
799,FraserChapman 2005.08.28,961,1,0,12,232,8,-224,Level A
826,crazycousins 2006.06.19,1156,1,1,12,267,33,-234,Level A
836,caracaskid 2004.10.02,895,1,0,12,262,25,-237,Level B
839,LaVigne 2005.12.14,931,1,0,12,263,25,-238,Level A
862,Gaby 2001.12.27,945,1,0,12,288,42,-246,Level A
911,hotwheelb 2006.12.06,899,1,0,12,270,8,-262,Level B
935,Pancetta 2006.01.23,1075,1,0,12,292,25,-267,Level A
950,magicmaster 2000.03.19,770,2,0,12,273,0,-273,Level A
981,alexcardoso 2004.07.09,1042,1,0,12,324,33,-291,Level A
1049,Neeter 2003.03.16,890,1,0,12,366,25,-341,Level A
1053,hfarnsworth 2005.10.05,1047,1,0,12,353,8,-345,Level A
1094,mascota 2005.11.17,934,1,0,12,415,8,-407,Level A
1101,LaFleurDeLys 2003.01.08,876,1,0,12,424,8,-416,Level A
1124,twno 2004.07.15,918,2,0,12,493,0,-493,Level A
1127,Spartagus 2005.12.24,1007,2,0,12,512,8,-504,Level A
3,tujhbq 2006.10.02,933,1,1,11,14,82,68,Level B
28,icman 2005.03.04,1086,1,1,11,64,73,9,Level B
43,Halfman 2006.01.12,867,2,1,11,39,36,-3,Level B
53,diamonds 2005.04.10,1131,2,2,11,64,55,-9,Level B
54,ennil 2004.10.02,929,1,1,11,65,55,-10,Level B
61,selectorSimit 2006.12.06,914,1,1,11,59,46,-13,Level B
81,wwdotti 2005.12.04,970,2,2,11,53,27,-26,Level A
104,Folinsbee 2004.02.26,941,1,1,11,86,46,-40,Level B
122,punkat 2006.05.10,1013,1,1,11,84,36,-48,Level A
162,abeme 2003.05.02,855,1,1,11,90,27,-63,Level A
271,mrudy 2003.01.07,894,1,1,11,132,36,-96,Level A
277,Laddie 2005.07.15,1074,2,2,11,134,36,-98,Level A
282,bigrig 2005.12.04,1022,1,1,11,126,27,-99,Level B
283,jmgamber 2006.09.13,1226,1,1,11,126,27,-99,Level B
293,iveyjr 2005.05.02,878,1,1,11,120,18,-102,Level A
347,onewords 2004.02.18,977,1,0,11,134,18,-116,Level B
368,HEARTLESSWIZARD 2005.11.30,924,1,0,11,160,36,-124,Level B
369,pollbellini 2005.12.14,952,1,1,11,142,18,-124,Level A
400,clickoo 2005.12.04,862,1,0,11,166,36,-130,Level B
403,Elrocks 2006.10.02,764,1,0,11,157,27,-130,Level B
411,ferking 2006.04.24,1131,1,1,11,132,0,-132,Level A
438,ewrosenthal 2006.03.04,1159,1,1,11,173,36,-137,Level B
480,youngrower 2005.03.04,910,1,0,11,155,9,-146,Level B
489,Shagmaster 2008.12.27,712,1,0,11,195,46,-149,Level B
517,tmth 2005.07.26,1043,1,1,11,211,55,-156,Level B
617,Memnochblue 2006.04.24,860,1,0,11,192,18,-174,Level A
691,Funditor 2006.09.22,876,1,0,11,209,18,-191,Level B
704,jpiscool 2006.12.23,1147,1,0,11,211,18,-193,Level A
728,mcgrail 2006.03.04,826,2,1,11,249,46,-203,Level B
744,KaleidoscopeEyes 2002.12.30,1019,1,0,11,244,36,-208,Level A
755,Kimber 1999.11.30,838,1,0,11,247,36,-211,Level A
779,undersoft 2005.06.23,928,1,1,11,255,36,-219,Level A
781,AFMD 2006.07.19,1153,1,0,11,237,18,-219,Level B
784,HEARTLESSWIZARD 2005.11.27,918,1,0,11,238,18,-220,Level A
793,twilc 2006.07.19,806,1,1,11,259,36,-223,Level B
848,aadeeb 2005.09.19,844,1,0,11,258,18,-240,Level A
910,Kimber 1999.11.24,865,1,0,11,289,27,-262,Level A
989,nathy 2009.08.06,733,1,0,11,312,18,-294,Level A
993,Johnnyp 2006.01.29,802,1,0,11,323,27,-296,Level A
1000,HEARTLESSWIZARD 2006.01.29,963,1,1,11,309,9,-300,Level A
1002,aalaptop 2006.02.12,1124,1,0,11,328,27,-301,Level A
1050,flinn 2003.03.04,962,1,0,11,360,18,-342,Level A
1055,mwcommander 2000.02.16,870,1,0,11,358,9,-349,Level A
1063,trovillion 2005.09.07,1039,1,1,11,381,18,-363,Level A
1064,VasTech 2006.07.26,985,1,0,11,373,9,-364,Level A
1086,Memnochblue 2006.04.10,1088,1,0,11,404,9,-395,Level A
1091,aikloong 2002.07.07,719,2,0,11,418,18,-400,Level A
1151,LaFleurDeLys 2003.01.25,849,1,0,11,676,9,-667,Level A
7,chelletijn 2004.02.18,958,1,1,10,15,60,45,Level B
9,BRubble 2003.07.05,1044,1,1,10,42,70,28,Level B
26,forkboy 2005.11.30,977,1,1,10,49,60,11,Level B
62,owenbagge 2002.06.27,943,1,1,10,64,50,-14,Level B
64,walnutwally 2006.10.27,1112,1,1,10,54,40,-14,Level B
68,xxYxxY 2006.05.09,980,1,1,10,59,40,-19,Level A
70,allgood 2000.04.02,1049,1,1,10,50,30,-20,Level B
147,calibra 2001.12.27,1049,1,1,10,99,40,-59,Level A
200,Homki 2005.04.06,1065,1,1,10,85,10,-75,Level A
214,SkyReaper 2006.02.12,834,1,1,10,110,30,-80,Level A
238,Birgie 2008.12.27,822,1,1,10,118,30,-88,Level B
241,konovalov 2001.07.05,1313,1,1,10,129,40,-89,Level A
286,coloradorover 2002.12.30,885,1,1,10,120,20,-100,Level A
379,WesternRed 1999.11.24,1126,1,1,10,135,10,-125,Level A
423,loserman 2006.03.29,887,1,0,10,154,20,-134,Level B
475,ktinfl 2009.08.06,866,1,1,10,165,20,-145,Level A
476,KarstenBlom 2006.01.13,1063,1,0,10,165,20,-145,Level A
608,returnofcaz 2006.03.02,1003,2,2,10,203,30,-173,Level A
618,DEDEE 2006.05.09,936,1,0,10,184,10,-174,Level A
672,sammyCmtww 2004.07.09,861,1,1,10,204,20,-184,Level A
717,Triplea 2003.03.16,826,1,1,10,216,20,-196,Level A
749,obao 2000.04.02,747,1,0,10,219,10,-209,Level B
786,LaFleurDeLys 2003.01.07,901,1,0,10,230,10,-220,Level A
806,mwcommander 2000.02.26,857,1,0,10,226,0,-226,Level A
824,coloradorover 2003.01.08,1023,1,1,10,232,0,-232,Level A
890,collmemasteur 2004.07.15,1008,2,2,10,275,20,-255,Level A
894,supriyasodhi 2006.06.20,854,1,0,10,266,10,-256,Level A
947,jcizotti 2005.09.18,900,1,1,10,281,10,-271,Level A
977,Scottrick 2005.06.26,1004,1,0,10,320,30,-290,Level A
987,forkboy 2005.11.29,1068,1,0,10,334,40,-294,Level A
1036,Funditor 2006.10.05,876,1,0,10,342,10,-332,Level B
1067,fjjvh 2009.04.05,665,2,0,10,386,20,-366,Level A
1075,dustbuni 2006.08.30,909,1,0,10,377,0,-377,Level A
1088,Foufoutos 2004.09.05,854,1,0,10,406,10,-396,Level A
1092,stickyfinger 2003.12.01,1022,1,0,10,434,30,-404,Level A
1095,LaFleurDeLys 2003.01.24,862,1,0,10,429,20,-409,Level A
1103,aikloong 2002.07.03,747,2,0,10,428,10,-418,Level A
2,IvoSt 2006.06.09,905,1,1,9,18,89,71,Level A
33,DunnMark 2004.01.13,1167,1,1,9,54,56,2,Level A
39,HGBoone 2006.09.22,987,1,1,9,45,44,-1,Level B
46,Buoy 2000.03.19,1220,2,2,9,61,56,-5,Level A
76,Melko 2004.02.16,990,1,1,9,93,67,-26,Level A
84,MnM 2000.02.26,1091,1,1,9,74,44,-30,Level A
135,Giuditta 2003.03.31,980,1,1,9,86,33,-53,Level A
213,pacetaker 2002.12.26,1125,1,1,9,124,44,-80,Level A
226,MartyL 2005.06.26,897,1,1,9,128,44,-84,Level A
265,subwoofer 2006.11.25,1092,1,1,9,139,44,-95,Level A
291,twilc 2006.06.19,832,1,0,9,146,44,-102,Level A
344,ferking 2006.06.20,1118,1,1,9,160,44,-116,Level A
388,BothFeet 2005.07.11,972,1,1,9,150,22,-128,Level A
414,nicknator 2006.05.04,1050,1,1,9,155,22,-133,Level A
459,hotwheela 2006.12.23,784,1,1,9,164,22,-142,Level A
471,CashCow 2004.01.13,831,1,0,9,155,11,-144,Level A
579,Damagical 2006.03.26,1103,1,1,9,189,22,-167,Level A
622,zephrys 2006.11.12,932,1,1,9,232,56,-176,Level A
675,hungerartist 2006.06.09,1013,1,0,9,218,33,-185,Level A
697,StrwberyNBanana 2000.02.16,1002,1,1,9,214,22,-192,Level A
722,achimdragos 2006.08.21,844,1,1,9,244,44,-200,Level B
727,sammyCmtww 2004.07.03,809,2,1,9,213,11,-202,Level A
743,twilc 2006.06.11,951,1,0,9,218,11,-207,Level A
812,bonillaice 2005.07.11,949,1,0,9,250,22,-228,Level A
860,Nemobxl 2006.05.04,901,1,0,9,266,22,-244,Level A
898,KoolBreez 2006.03.26,868,1,0,9,292,33,-259,Level A
926,americanista 2005.11.17,868,1,1,9,287,22,-265,Level A
939,blevente 2006.10.16,958,3,3,9,302,33,-269,Level A
944,BigIrish 2006.01.14,975,1,0.5,9,315,44,-271,Level B
1011,hotwheelb 2006.11.25,881,1,0,9,310,0,-310,Level A
1051,hungerartist 2006.08.21,1090,1,0,9,366,22,-344,Level B
1076,cubcadet 2006.02.13,943,1,0,9,390,11,-379,Level A
20,LeFol 2006.06.11,1041,1,1,8,49,63,14,Level A
77,skuller 2002.07.03,1065,2,2,8,88,62,-26,Level A
121,basitian 2005.03.17,1001,1,1,8,86,38,-48,Level A
130,prodenter 2006.02.13,1041,1,1,8,102,50,-52,Level A
209,SamuelJunior 2006.06.28,978,1,1,8,142,63,-79,Level A
220,puzzledmindLady 2005.08.07,1022,1,1,8,120,38,-82,Level B
224,metallicguy 2006.10.05,885,1,1,8,147,63,-84,Level B
257,hwqa 2004.09.25,1055,1,1,8,131,38,-93,Level B
321,uvrays 2006.03.14,832,1,0,8,148,38,-110,Level A
324,loserman 2006.02.13,811,1,0,8,150,38,-112,Level A
387,WardBurtonfan 2003.01.24,892,1,0,8,166,38,-128,Level A
452,JWest 2002.07.30,916,1,1,8,204,63,-141,Level A
483,eaglesloft 2003.03.04,1004,1,1,8,160,13,-147,Level A
580,Pfistou 2005.12.24,1112,1,1,8,206,38,-168,Level A
589,Nemobxl 2006.04.10,820,1,1,8,207,38,-169,Level A
602,Issaac 2003.02.28,1071,1,0,8,184,13,-171,Level A
636,Agenbite 1999.11.16,679,1,0,8,204,25,-179,Level A
656,PacManVideoGame 2005.10.05,941,1,1,8,232,50,-182,Level A
686,rtgreen 2005.09.07,925,1,0,8,240,50,-190,Level A
712,marcuscole 2006.05.05,881,1,0,8,246,50,-196,Level A
741,iansss 2006.05.05,923,1,1,8,231,25,-206,Level A
756,colpitts 2004.09.05,1064,1,1,8,236,25,-211,Level A
849,MischiMaestro 2005.04.18,999,1,1,8,253,13,-240,Level A
893,wiky 2006.02.19,1002,1,0,8,281,25,-256,Level A
922,HerrGott 2006.08.21,1043,1,0,8,277,13,-264,Level A
933,hawklady 2004.01.09,819,1,0,8,279,13,-266,Level A
937,zhouzhaowu 2009.04.05,871,1,1,8,280,13,-267,Level A
943,LaFleurDeLys 2003.01.13,854,1,0,8,270,0,-270,Level A
945,Caledonian 2006.05.02,877,1,0,8,309,38,-271,Level A
997,southwestco 2004.07.06,799,2,0,8,324,25,-299,Level A
1023,createwaves 2001.07.02,903,1,0,8,334,13,-321,Level A
1038,Joinedup 2005.02.03,925,1,0,8,360,25,-335,Level A
1069,uvrays 2006.10.17,878,1,0,8,368,0,-368,Level A
1070,hwm 2005.04.28,933,1,0,8,384,13,-371,Level A
1071,fjjvh 2009.04.02,667,2,0,8,397,25,-372,Level A
1082,CashCow 2002.08.11,891,1,0,8,391,0,-391,Level A
1102,dustbuni 2006.04.25,966,1,0,8,416,0,-416,Level A
1142,medilein 2005.02.21,1032,1,1,8,576,0,-576,Level A
