Sort,Name,Rating,Games,Result,Moves,CPL,MM,Sort score,Analysis 
515,pinkbunny 2009.08.16,931,15,2,135,269,31,-238,Level A
557,Adolar 2009.08.03,1023,8,3,123,278,24,-254,Level A
593,nathy 2009.08.29,773,10,1.5,114,296,25,-271,Level A
430,nathy 2009.12.26,721,7,1,113,229,29,-200,Level A
522,nathy 2009.12.22,747,5,0.5,101,270,28,-242,Level A
254,ElevatorJoe 2009.08.16,992,12,11,95,171,42,-129,Level B
396,nathy 2009.08.26,731,9,3,95,209,21,-188,Level A
222,hailu 2009.08.22,953,3,1,84,147,33,-114,Level C
54,spiritswords 2009.08.22,970,3,2,82,78,48,-30,Level C
523,nathy 2009.08.30,793,5,0,75,267,25,-242,Level A
244,jumpinggreenfrog 2009.08.24,909,5,3,73,163,37,-126,Level A
507,nathy 2009.12.23,728,4,1,73,249,16,-233,Level A
425,intellow 2009.10.07,899,4,3,72,226,29,-197,Level A
453,zqnzt 2009.09.30,1071,2,2,72,230,19,-211,Level A
331,intellow 2009.09.30,918,2,0,70,187,30,-157,Level A
563,nathy 2009.08.05,742,6,1,70,277,21,-256,Level A
666,nathy 2009.08.28,755,9,2.5,70,343,16,-327,Level A
531,nathy 2009.12.25,736,5,0,68,266,21,-245,Level A
231,stota 2009.09.29,972,2,0,67,152,36,-116,Level B
98,samoancharger 2009.09.29,1024,2,2,66,102,48,-54,Level B
591,kybrai 2009.12.18,799,8,1,63,290,22,-268,Level A
247,ElevatorJoe 2009.08.13,998,2,1,62,163,35,-128,Level B
265,HareBrain 2009.11.21,995,2,1.5,61,168,33,-135,Level A
278,intellow 2009.11.21,966,2,0.5,61,170,31,-139,Level A
303,praxodes 2009.11.20,1124,1,1,61,180,33,-147,Level A
570,nathy 2009.11.09,792,7,1,61,282,23,-259,Level A
645,pinkbunny 2009.08.17,763,6,3,60,329,20,-309,Level A
552,mmjchess 2009.12.04,923,9,2,59,279,27,-252,Level B
342,intellow 2009.10.04,909,2,0,57,173,12,-161,Level A
506,japhet 2009.12.18,1076,8,7,55,262,29,-233,Level A
95,karpovasparov 2009.11.20,836,1,0,54,84,33,-51,Level A
301,samoancharger 2009.08.16,982,6,6,53,182,36,-146,Level A
594,hippyman 2009.12.22,900,4,3,52,294,23,-271,Level A
362,kardsplz 2009.11.08,994,2,0,51,193,24,-169,Level A
255,ANDYTASTIC 2009.08.03,973,4,3,50,162,32,-130,Level A
274,gobemouche 2009.09.11,965,2,1,50,166,28,-138,Level A
289,stota 2009.09.14,971,1,0.5,50,165,24,-141,Level A
560,whowant 2009.08.27,971,5,4,49,288,33,-255,Level A
174,stota 2009.09.17,972,2,1,48,119,25,-94,Level A
184,antharas 2009.11.08,1003,2,2,48,126,29,-97,Level A
305,kkj 2009.09.14,1026,1,0.5,48,175,27,-148,Level A
477,SkyMeadow 2009.10.27,936,4,2,48,241,19,-222,Level A
504,Hazardo 2009.08.19,953,5,1,47,255,23,-232,Level A
318,reframed 2009.08.13,899,2,1,46,190,37,-153,Level A
436,brickell 2009.08.25,883,1,0.5,46,241,37,-204,Level A
659,hippyman 2009.12.07,934,2,0,46,349,26,-323,Level A
283,scoroyale 2009.08.02,925,3,1.5,45,171,31,-140,Level A
559,nathy 2009.08.03,763,5,0.5,45,272,18,-254,Level A
422,lowandbehold 2009.10.07,976,2,2,44,235,39,-196,Level A
293,Nopolis 2009.12.14,888,2,0,43,173,30,-143,Level A
385,Hazardo 2009.09.11,962,1,0,43,208,26,-182,Level A
584,nathy 2009.12.20,750,3,0.5,43,289,23,-266,Level A
401,ktinfl 2009.10.31,848,1,0,42,216,26,-190,Level A
545,gobemouche 2009.10.12,915,2,1,42,273,24,-249,Level A
437,japhet 2009.12.30,1057,4,3,41,236,32,-204,Level A
199,antharas 2009.10.31,987,1,1,40,140,35,-105,Level A
249,OxoCube 2009.10.04,1066,1,1,40,153,25,-128,Level A
323,ElectronTheory 2009.10.10,1160,2,1.5,40,190,35,-155,Level B
335,SkyMeadow 2009.10.28,923,2,1,40,191,33,-158,Level A
439,Bhunt 2009.08.04,1050,1,0.5,40,230,25,-205,Level B
558,EvilQueen 2009.08.13,1024,2,2,40,276,22,-254,Level A
644,nathy 2009.08.07,732,5,1,40,334,25,-309,Level A
36,Kloth 2009.12.26,987,3,3,39,62,54,-8,Level C
295,hautefoxx 2009.10.10,836,2,0.5,39,180,36,-144,Level B
652,tangelo 2009.09.20,849,1,0,39,336,21,-315,Level A
191,DaydreamXXI 2009.08.16,977,2,0,38,124,24,-100,Level A
193,Hazardo 2009.08.04,929,1,0.5,38,146,42,-104,Level B
285,fektija 2009.12.26,1046,2,1,38,164,24,-140,Level A
313,saipanislandboy 2009.10.20,785,3,0,38,175,24,-151,Level A
421,OSZCAR 2009.08.11,1031,1,0.5,38,236,40,-196,Level A
152,andrejas 2009.08.25,1019,1,0.5,37,120,38,-82,Level A
233,pets 2009.12.23,1062,1,1,37,140,22,-118,Level A
248,Fukiyama 2009.12.22,1044,1,0.5,37,160,32,-128,Level A
251,Tyzore 2009.10.28,937,2,0.5,37,147,19,-128,Level A
271,GoGoYubari 2009.08.24,1087,2,2,37,169,32,-137,Level A
415,hippyman 2009.12.18,929,3,0,37,226,32,-194,Level A
561,hippyman 2009.12.21,886,4,2,37,274,19,-255,Level A
56,Hosed 2009.10.28,1031,2,1.5,36,75,44,-31,Level A
308,HareBrain 2009.08.13,846,1,1,36,188,39,-149,Level B
366,azote 2009.08.03,1009,1,1,36,204,33,-171,Level A
389,kybrai 2009.12.30,862,4,1,36,215,31,-184,Level A
418,HareBrain 2009.08.29,869,2,1,36,213,19,-194,Level A
668,TheDancingQueen 2009.08.13,835,4,0,36,336,8,-328,Level A
153,chagf 2009.10.20,1018,3,3,35,116,34,-82,Level A
194,reframed 2009.08.11,909,2,0.5,35,141,37,-104,Level A
196,gobemouche 2009.09.17,972,1,0,35,138,34,-104,Level A
514,Hazardo 2009.08.14,983,1,0,35,272,34,-238,Level A
518,pinkbunny 2009.08.18,851,3,1,35,266,26,-240,Level A
608,nathy 2009.09.19,771,5,2,35,306,26,-280,Level A
634,guisbi 2009.12.07,965,2,1,35,328,29,-299,Level A
106,powerfail 2009.12.16,994,1,1,34,104,47,-57,Level C
240,badstep 2009.08.21,1055,2,1,34,160,35,-125,Level A
440,gobemouche 2009.09.20,1014,1,1,34,226,21,-205,Level A
236,ANDYTASTIC 2009.08.02,973,1,0.5,33,144,24,-120,Level A
380,kybrai 2009.12.17,854,2,0,33,203,24,-179,Level A
382,gobemouche 2009.12.18,995,1,0,33,213,33,-180,Level B
387,pinkbunny 2009.08.23,926,3,0,33,216,33,-183,Level A
524,Bhunt 2009.08.24,1005,3,0.5,33,263,21,-242,Level A
546,niCeMoovez 2009.10.29,902,3,2,33,270,21,-249,Level A
566,antharas 2009.10.07,955,1,0,33,278,21,-257,Level A
200,lowandbehold 2009.08.24,876,2,1.5,32,150,44,-106,Level B
409,nathy 2009.08.06,735,3,0,32,214,22,-192,Level A
424,kinkobel 2009.11.07,1038,1,0.5,32,209,13,-196,Level A
463,hippyman 2009.12.09,886,2,0,32,243,28,-215,Level A
128,paderboots 2009.08.19,874,2,1.5,31,113,39,-74,Level B
243,Contranigma 2009.09.17,934,1,1,31,141,16,-125,Level A
322,HareBrain 2009.11.07,957,1,0.5,31,173,19,-154,Level A
535,SkyMeadow 2009.11.16,984,2,2,31,269,23,-246,Level A
574,ZAMMA 2009.12.23,1021,1,1,31,279,19,-260,Level A
710,nathy 2009.08.11,746,4,1,31,417,16,-401,Level A
105,Puscifer 2009.12.16,994,1,0,30,107,50,-57,Level C
143,kardsplz 2009.11.26,937,1,0,30,111,33,-78,Level B
310,nathy 2009.11.05,803,2,0,30,180,30,-150,Level A
367,tomecki 2009.10.19,836,2,0,30,198,27,-171,Level B
408,mdxp 2009.10.27,1006,2,1,30,222,30,-192,Level A
469,Bhunt 2009.08.14,1009,1,1,30,259,40,-219,Level A
482,Loran 2009.08.12,774,4,0,30,237,13,-224,Level B
555,Bhunt 2009.09.15,987,1,0,30,276,23,-253,Level A
611,fargeklatt 2009.11.26,922,5,1,30,302,20,-282,Level A
624,kybrai 2009.12.20,778,2,0,30,312,23,-289,Level A
117,SkyMeadow 2009.10.30,916,1,1,29,101,38,-63,Level A
126,WillByron 2009.10.19,1128,2,2,29,117,45,-72,Level B
229,pinkbunny 2009.08.21,884,1,1,29,161,45,-116,Level B
262,biondy 2009.10.30,1066,1,0,29,157,24,-133,Level A
344,SkyMeadow 2009.10.29,914,2,1,29,186,24,-162,Level A
354,Kkidplayer 2009.12.18,987,1,1,29,211,45,-166,Level B
357,biondy 2009.10.27,1019,2,1,29,195,28,-167,Level A
423,bennywalsh 2009.08.30,1047,2,2,29,213,17,-196,Level A
457,bgilby 2009.10.28,1043,1,0,29,244,31,-213,Level A
606,sccoach 2009.10.31,1070,3,1,29,305,28,-277,Level A
720,TheDancingQueen 2009.08.12,867,2,0,29,436,17,-419,Level A
62,drinkingwater 2009.11.26,1029,1,1,28,76,43,-33,Level B
108,holmesianman 2009.08.05,880,2,2,28,98,39,-59,Level A
164,mathspriyanka 2009.09.17,1060,1,0,28,121,32,-89,Level A
241,franzgabo 2009.08.24,918,1,0,28,157,32,-125,Level A
326,Adolar 2009.08.05,903,1,0,28,188,32,-156,Level A
426,ANDYTASTIC 2009.08.19,1012,3,3,28,211,14,-197,Level A
609,fargeklatt 2009.11.27,920,2,0,28,310,29,-281,Level A
614,Musclorman 2009.08.20,927,2,0.5,28,315,32,-283,Level A
642,BrootFaus 2009.10.29,1003,2,1,28,336,29,-307,Level A
77,mariusmattheus 2009.08.12,1111,4,4,27,90,44,-46,Level B
137,sammakkon 2009.09.09,1029,1,1,27,113,37,-76,Level A
157,japhet 2009.12.17,1067,2,2,27,128,44,-84,Level A
225,gwhatever 2009.09.09,942,1,0,27,141,26,-115,Level A
378,Loran 2009.09.04,752,2,0,27,196,19,-177,Level A
461,Hazardo 2009.09.12,946,1,1,27,245,30,-215,Level A
604,gobemouche 2009.09.12,973,1,0,27,287,11,-276,Level A
622,hautefoxx 2009.10.11,831,2,1,27,305,18,-287,Level A
234,TheDuster 2009.10.31,894,4,3,26,157,38,-119,Level A
282,pinkbunny 2009.08.22,892,2,2,26,178,38,-140,Level A
316,Bhunt 2009.08.21,1050,2,1,26,183,31,-152,Level A
325,Gasparinho 2009.08.29,1028,2,2,26,194,38,-156,Level A
390,sxsonar 2009.01.13,987,1,1,26,211,27,-184,Level A
495,saipanislandboy 2009.10.12,942,2,0,26,240,12,-228,Level A
502,Hazardo 2009.08.05,932,2,2,26,259,27,-232,Level A
549,soffan 2009.09.05,844,1,1,26,286,35,-251,Level A
217,lacceroswaldo 2009.12.14,1060,1,1,25,148,36,-112,Level A
237,whowant 2009.08.30,1011,2,2,25,158,36,-122,Level A
319,Hazardo 2009.08.07,929,1,1,25,189,36,-153,Level A
406,gobemouche 2009.10.31,957,1,0.5,25,211,20,-191,Level A
449,lowandbehold 2009.09.15,1012,1,1,25,246,36,-210,Level A
468,intellow 2009.10.31,904,1,0.5,25,238,20,-218,Level A
487,Bhunt 2009.08.03,1049,1,1,25,250,24,-226,Level A
491,niCeMoovez 2009.09.11,921,1,0,25,252,24,-228,Level A
540,ElectronTheory 2009.10.11,1163,2,1,25,276,28,-248,Level A
573,rylruler 2009.08.17,946,1,0,25,280,20,-260,Level B
607,HareBrain 2009.11.26,951,1,0,25,303,24,-279,Level A
613,tanimachi 2009.09.21,1057,2,1,25,294,12,-282,Level A
671,nathy 2009.08.04,757,3,0,25,347,16,-331,Level A
703,SkyMeadow 2009.11.01,919,1,0,25,414,28,-386,Level B
712,hamaa 2009.12.20,952,1,0.5,25,424,20,-404,Level A
85,OSZCAR 2009.08.13,1017,1,1,24,87,38,-49,Level A
118,michaelhu 2009.09.04,1158,2,2,24,100,37,-63,Level A
221,mergall 2009.12.25,1056,2,2,24,160,46,-114,Level C
264,whowant 2009.08.29,1012,2,2,24,155,21,-134,Level A
320,Volodymir 2009.12.14,1102,2,2,24,174,21,-153,Level A
347,markhodges 2009.09.05,1127,1,0,24,193,29,-164,Level A
355,japhet 2009.12.20,1086,2,2,24,191,25,-166,Level A
369,chessboyjazz 2009.11.25,1106,1,0.5,24,219,46,-173,Level B
429,HareBrain 2009.11.27,962,1,1,24,212,13,-199,Level A
503,LaurentDelaon 2009.08.18,1059,2,1,24,257,25,-232,Level A
542,gobemouche 2009.10.16,947,1,0,24,273,25,-248,Level A
638,brntout 2009.08.10,858,1,0,24,329,25,-304,Level A
686,Loran 2009.09.05,743,4,0,24,387,38,-349,Level A
131,gobemouche 2009.10.23,980,2,1,23,119,44,-75,Level B
147,bluetac 2009.11.22,985,1,0,23,115,35,-80,Level A
186,chagf 2009.10.12,999,2,2,23,133,35,-98,Level A
311,Sokka 2009.12.25,1062,1,1,23,180,30,-150,Level A
338,rylruler 2009.08.13,957,1,0,23,190,30,-160,Level B
363,weshoward 2009.11.22,906,2,2,23,191,22,-169,Level A
442,badstep 2009.08.28,1028,1,0,23,242,35,-207,Level A
466,gwhatever 2009.09.13,945,1,0,23,238,22,-216,Level A
490,lowandbehold 2009.08.21,904,3,1,23,249,22,-227,Level A
516,LaurentDelaon 2009.08.26,1062,2,1,23,264,26,-238,Level A
521,hippyman 2009.12.14,863,2,0,23,263,22,-241,Level A
528,Xoppo 2009.08.17,1073,3,2,23,270,26,-244,Level A
587,HareBrain 2009.11.22,1015,2,0,23,275,9,-266,Level A
589,SkyMeadow 2009.10.31,925,1,0,23,289,22,-267,Level A
617,japhet 2009.10.31,1056,1,1,23,310,26,-284,Level A
656,joulu 2009.08.24,916,1,0,23,329,13,-316,Level B
690,chakmo 2009.12.22,983,1,1,23,385,30,-355,Level B
79,stota 2009.10.09,996,1,0,22,97,50,-47,Level C
89,andrejas 2009.08.05,1087,1,1,22,82,32,-50,Level A
121,lashaberulava 2009.12.09,1011,1,1,22,91,23,-68,Level A
134,tramontane 2009.10.09,1003,1,1,22,107,32,-75,Level C
268,zEviscerator 2009.09.13,955,1,1,22,172,36,-136,Level A
292,Crashinator 2009.01.13,814,1,0,22,169,27,-142,Level A
324,happyelk 2009.09.25,1066,1,1,22,169,14,-155,Level A
353,Bhunt 2009.08.25,983,1,1,22,192,27,-165,Level A
361,drewblastoff 2009.09.11,1007,1,1,22,196,27,-169,Level A
375,MaximilliannKidd 2009.10.12,1056,1,1,22,194,18,-176,Level A
405,intellow 2009.10.06,911,1,0,22,214,23,-191,Level A
407,nathy 2009.08.16,733,1,0,22,205,14,-191,Level A
486,MasterBelch 2009.10.23,1018,2,1,22,253,27,-226,Level B
519,ivebeenabducted 2009.08.10,995,1,1,22,254,14,-240,Level A
520,ironwutang 2009.08.27,841,13,2,22,254,14,-240,Level A
576,SkyMeadow 2009.10.22,915,3,1,22,275,14,-261,Level A
578,nathy 2009.12.06,773,2,0,22,300,36,-264,Level A
677,berthusganja 2009.11.27,1081,1,1,22,371,32,-339,Level A
5,yuyoyu 2009.10.09,1001,1,1,21,13,62,49,Level C
59,StarAsia 2009.11.22,982,1,1,21,64,33,-31,Level A
68,GaKK 2009.10.09,996,1,0,21,70,33,-37,Level C
100,rseymoure 2009.10.02,1063,1,0,21,98,43,-55,Level B
146,wildbeal 2009.08.17,989,1,1,21,128,48,-80,Level B
149,CHIMOL 2009.08.25,958,1,0,21,114,33,-81,Level A
165,sigggih 2009.08.26,1045,1,1,21,128,38,-90,Level A
206,badstep 2009.08.07,1064,1,0,21,146,38,-108,Level A
307,gobemouche 2009.08.28,955,2,0,21,172,24,-148,Level A
309,sandiren 2009.10.16,1048,1,1,21,178,29,-149,Level A
333,BessieBoodle 2009.09.25,933,1,0,21,176,19,-157,Level A
388,sarduspater 2009.11.09,1037,4,4,21,227,43,-184,Level A
393,Demolishor 2009.10.10,900,2,0,21,215,29,-186,Level A
402,gobemouche 2009.08.18,993,1,0,21,209,19,-190,Level B
428,ktinfl 2009.11.01,841,1,1,21,247,48,-199,Level B
465,Hempnotic 2009.11.27,997,1,0,21,240,24,-216,Level A
567,raysfan 2009.09.19,1080,4,3,21,276,19,-257,Level A
616,Nopolis 2009.12.06,855,1,1,21,313,29,-284,Level A
632,Loran 2009.09.21,738,1,0,21,315,19,-296,Level A
654,EvilQueen 2009.08.12,1006,2,2,21,334,19,-315,Level A
102,mergall 2009.11.16,972,1,0,20,85,30,-55,Level A
120,DeathKnights 2009.08.28,951,1,1,20,101,35,-66,Level A
158,tdalex 2009.08.16,1080,1,1,20,114,30,-84,Level A
202,SkyMeadow 2009.11.15,980,1,1,20,141,35,-106,Level A
226,SkyMeadow 2009.11.26,1042,1,1,20,140,25,-115,Level A
257,zqnzt 2009.06.28,1017,1,0,20,161,30,-131,Level B
259,nathy 2009.08.31,781,5,1,20,156,25,-131,Level A
352,xDieInAFirex 2009.10.27,667,1,0,20,195,30,-165,Level A
381,stota 2009.10.01,938,1,0,20,199,20,-179,Level A
434,gobemouche 2009.10.06,966,1,1,20,227,25,-202,Level A
459,sccoach 2009.11.26,1004,3,2,20,244,30,-214,Level A
467,Quien 2009.11.15,942,1,0,20,237,20,-217,Level A
470,karpovasparov 2009.12.20,919,2,1,20,254,35,-219,Level A
512,ironwutang 2009.08.26,999,6,0,20,261,25,-236,Level A
556,nathy 2009.10.23,806,1,0,20,279,25,-254,Level A
599,kybrai 2009.12.27,759,3,2,20,303,30,-273,Level A
620,kwe 2009.11.21,1036,2,1,20,322,35,-287,Level A
639,intellow 2009.10.13,881,1,0,20,314,10,-304,Level A
647,Loran 2009.10.09,752,2,0,20,319,10,-309,Level A
687,owzat 2009.10.24,997,1,1,20,384,35,-349,Level A
697,SkyMeadow 2009.10.21,943,2,0,20,371,10,-361,Level A
82,LeyZ 2009.06.28,864,1,1,19,101,53,-48,Level B
162,SGTMAJUSMC 2009.11.25,882,1,0.5,19,126,37,-89,Level B
235,Hazardo 2009.08.11,956,1,1,19,162,42,-120,Level A
275,nathy 2009.11.17,778,1,0,19,159,21,-138,Level B
346,lukeex 2009.12.14,1029,1,1,19,195,32,-163,Level A
383,Mels 2009.08.26,1051,1,1,19,206,26,-180,Level A
410,elfrieda 2009.11.14,997,1,1,19,213,21,-192,Level A
448,pmineirov 2009.10.23,1097,1,1,19,235,26,-209,Level A
496,Enato 2009.10.13,1107,1,1,19,233,5,-228,Level A
551,mergall 2009.11.21,923,2,1,19,272,21,-251,Level A
569,gobemouche 2009.08.25,921,2,1,19,274,16,-258,Level A
713,MasterBelch 2009.10.12,975,1,0,19,409,5,-404,Level A
731,Loran 2009.10.01,757,1,0,19,482,16,-466,Level A
116,soffan 2009.11.05,1068,1,1,18,95,33,-62,Level A
298,ktinfl 2009.08.23,904,1,1,18,166,22,-144,Level A
348,TheDuster 2009.11.11,913,2,2,18,186,22,-164,Level A
359,Hosed 2009.08.11,1055,2,1,18,190,22,-168,Level A
365,graystanley 2009.08.21,898,1,0,18,181,11,-170,Level A
403,Kkidplayer 2009.12.04,957,2,1,18,230,39,-191,Level B
417,ktinfl 2009.10.27,858,1,0,18,216,22,-194,Level A
420,Hazardo 2009.08.02,902,1,0,18,240,44,-196,Level B
431,Hazardo 2009.08.03,894,2,2,18,222,22,-200,Level A
444,ElevatorJoe 2009.08.11,1024,1,0,18,236,28,-208,Level A
445,SGTMAJUSMC 2009.11.26,886,1,0.5,18,230,22,-208,Level A
493,francod 2009.12.26,996,1,1,18,250,22,-228,Level A
501,ANDYTASTIC 2009.08.10,970,2,0,18,260,28,-232,Level A
536,japhet 2009.12.28,1058,1,0.5,18,268,22,-246,Level A
543,Azerath 2009.11.11,907,2,0,18,254,6,-248,Level A
583,Bhunt 2009.09.13,1012,1,0,18,276,11,-265,Level A
673,Loran 2009.08.23,754,2,0,18,338,6,-332,Level A
678,pinkbunny 2009.08.19,859,1,0,18,368,28,-340,Level A
679,japhet 2009.12.27,1087,3,1,18,374,33,-341,Level A
707,corrosiv 2009.10.01,1034,1,1,18,409,17,-392,Level A
41,Phye 2009.11.17,1008,1,1,17,78,65,-13,Level B
150,nathy 2009.09.18,774,1,0,17,110,29,-81,Level B
181,JooBoo 2009.08.26,986,1,1,17,138,41,-97,Level A
198,Hazardo 2009.08.18,944,1,1,17,152,47,-105,Level B
205,GaKK 2009.10.27,968,1,0,17,149,41,-108,Level A
260,RichardJohnson 2009.10.27,1322,1,1,17,155,24,-131,Level A
263,reframed 2009.08.19,1069,1,0,17,163,29,-134,Level B
267,Hazardo 2009.08.10,939,2,2,17,177,41,-136,Level A
332,IanRemsen 2009.11.26,1085,1,0.5,17,186,29,-157,Level A
478,silverspruce 2009.11.14,994,1,0,17,240,18,-222,Level A
484,hippyman 2009.12.05,905,1,0,17,260,35,-225,Level A
533,chakmo 2009.12.07,947,1,1,17,287,41,-246,Level A
568,Mnika 2009.12.22,991,1,1,17,293,35,-258,Level A
575,Ifex 2009.09.17,981,1,1,17,285,24,-261,Level A
579,DrillOp 2009.10.22,960,2,1,17,293,29,-264,Level A
615,graphiboy 2009.12.10,990,1,0,17,301,18,-283,Level A
618,TheDancingQueen 2009.08.11,891,1,0,17,303,18,-285,Level A
630,Laskerson 2009.12.05,1031,1,1,17,319,24,-295,Level A
636,Bhunt 2009.08.19,1047,1,1,17,330,29,-301,Level A
670,telepathetic 2009.08.13,1000,1,0,17,349,18,-331,Level A
702,TheDancingQueen 2009.08.14,781,2,0,17,391,6,-385,Level A
730,Hazardo 2009.08.06,940,2,0,17,482,18,-464,Level B
16,raysfan 2009.09.18,1017,1,1,16,34,56,22,Level B
72,intellow 2009.10.10,905,2,2,16,77,38,-39,Level A
132,happyelk 2009.10.01,1051,1,1,16,113,38,-75,Level A
227,Hazardo 2009.08.24,964,1,1,16,140,25,-115,Level A
253,MasterBelch 2009.10.20,888,1,0,16,141,13,-128,Level A
304,chaosmonger 2009.12.21,1028,1,1,16,172,25,-147,Level A
412,nathy 2009.09.08,778,1,0,16,224,31,-193,Level A
416,Loran 2009.09.02,743,2,0.5,16,225,31,-194,Level A
481,kevincollins 2009.12.10,1005,1,1,16,249,25,-224,Level A
485,Loran 2009.10.02,752,1,0,16,238,13,-225,Level B
499,kybrai 2009.12.28,848,1,0.5,16,256,25,-231,Level A
548,uetuseuu 2009.10.17,990,1,0,16,275,25,-250,Level A
565,Ifex 2009.09.23,953,1,0,16,282,25,-257,Level A
580,Hazardo 2009.08.20,935,1,0,16,283,19,-264,Level A
610,chakmo 2009.12.09,951,1,0,16,294,13,-281,Level A
664,onomatopeia 2009.09.29,1080,1,1,16,345,19,-326,Level B
667,dadoc 2009.08.02,965,1,0,16,353,25,-328,Level A
691,farofero 2009.12.23,999,1,0,16,380,25,-355,Level A
698,nathy 2009.08.09,728,3,1,16,391,25,-366,Level A
711,getit 2009.08.28,1008,1,1,16,414,13,-401,Level A
740,weshoward 2009.11.19,886,1,0,16,586,19,-567,Level A
40,HareBrain 2009.10.02,850,1,1,15,59,47,-12,Level B
101,kkj 2009.10.20,1053,1,1,15,95,40,-55,Level A
125,beverlyframingham 2009.08.02,1095,1,1,15,131,60,-71,Level B
140,SecondQueen 2009.08.06,1069,1,1,15,110,33,-77,Level A
159,GMenBigBlue 2009.08.21,1015,4,1,15,113,27,-86,Level A
256,SexyTime 2009.12.04,1091,3,3,15,164,33,-131,Level B
258,nathy 2009.12.27,718,2,0.5,15,158,27,-131,Level A
261,Tyranth 2009.08.23,1070,2,2,15,160,27,-133,Level A
321,sccoach 2009.12.13,960,3,2,15,207,53,-154,Level B
376,tangelo 2009.09.10,934,1,0,15,189,13,-176,Level A
392,nathy 2009.09.17,780,2,0,15,212,27,-185,Level A
400,robbienorma 2009.12.09,1045,1,1,15,223,33,-190,Level A
404,intellow 2009.11.14,939,1,0,15,218,27,-191,Level A
450,Loran 2009.09.29,759,1,0,15,237,27,-210,Level B
460,Phye 2009.11.14,1008,1,1,15,227,13,-214,Level A
479,JBWALKER 2009.12.04,967,2,2,15,250,27,-223,Level B
537,nathy 2009.09.21,789,2,0,15,267,20,-247,Level A
572,Loran 2009.11.14,727,3,0,15,293,33,-260,Level A
603,EvilQueen 2009.08.11,958,1,1,15,289,13,-276,Level A
621,Dconneen 2009.12.11,937,1,0,15,314,27,-287,Level B
628,kkj 2009.09.21,1007,1,1,15,306,13,-293,Level A
681,ACECAKER 2009.10.24,987,1,0,15,359,13,-346,Level A
706,mergall 2009.12.13,1023,2,0,15,412,20,-392,Level B
66,timeToLive 2009.09.11,1077,1,1,14,56,21,-35,Level A
92,robbienorma 2009.08.19,1080,1,0.5,14,108,57,-51,Level B
103,danielbmarques 2009.12.18,1093,1,1,14,92,36,-56,Level A
133,samoancharger 2009.08.20,1009,1,1,14,111,36,-75,Level A
139,gobemouche 2009.09.13,972,1,1,14,113,36,-77,Level A
204,SundanceKidIN 2009.12.25,1059,2,2,14,143,36,-107,Level A
211,Nopolis 2009.12.22,886,1,0,14,160,50,-110,Level B
212,SeanMohsin 2009.09.11,889,1,0,14,131,21,-110,Level A
215,xuch 2009.09.27,886,1,0,14,147,36,-111,Level A
224,Ravacholsixneuf 2009.08.20,991,1,1,14,151,36,-115,Level A
238,NRking 2009.09.27,1042,1,1,14,159,36,-123,Level A
245,dafics 2009.09.08,1099,1,1,14,133,7,-126,Level A
250,charlestacda 2009.12.20,1026,1,1,14,149,21,-128,Level A
281,Sagi 2009.10.29,1051,1,1,14,190,50,-140,Level B
290,Loran 2009.08.15,756,1,0,14,162,21,-141,Level A
356,graphiboy 2009.11.09,1051,1,1,14,187,21,-166,Level A
398,KingzKill 2009.12.20,1072,1,0,14,226,36,-190,Level A
435,Loran 2009.09.06,734,1,0,14,217,14,-203,Level B
451,HareBrain 2009.08.27,917,1,0,14,247,36,-211,Level A
462,Hazardo 2009.08.25,972,1,0,14,244,29,-215,Level A
475,Loran 2009.09.07,731,2,0,14,221,0,-221,Level A
476,Nopolis 2009.12.23,884,1,1,14,243,21,-222,Level A
534,ElectronTheory 2009.09.05,1153,1,1,14,275,29,-246,Level A
547,Tyranth 2009.08.22,1068,1,0,14,270,21,-249,Level A
550,intellow 2009.09.29,913,1,0,14,280,29,-251,Level B
571,nathy 2009.09.13,792,1,0,14,296,36,-260,Level A
585,ANDYTASTIC 2009.08.17,1018,4,3,14,287,21,-266,Level A
641,Loran 2009.11.08,734,1,0,14,312,7,-305,Level A
655,holmesianman 2009.08.03,1018,1,0,14,329,14,-315,Level A
658,uetuseuu 2009.09.23,992,1,1,14,364,43,-321,Level B
680,ktinfl 2009.08.04,863,2,1,14,363,21,-342,Level A
717,andrejas 2009.08.27,1028,3,2,14,432,21,-411,Level A
723,duesse 2009.12.09,722,1,0,14,433,7,-426,Level A
50,onomatopeia 2009.10.01,1095,1,1,13,55,31,-24,Level A
63,MikiD 2009.12.06,961,2,2,13,71,38,-33,Level A
83,Shurka 2009.10.02,1167,1,1,13,103,54,-49,Level B
113,sandiren 2009.10.09,1057,2,2,13,91,31,-60,Level A
115,gobemouche 2009.08.19,961,2,1,13,83,23,-60,Level A
127,mariusmattheus 2009.08.15,1203,1,1,13,103,31,-72,Level A
135,WoodyMac 2009.10.01,893,1,0,13,106,31,-75,Level A
142,phuziOn 2009.09.10,965,1,1,13,117,39,-78,Level A
177,catfu 2009.08.06,1039,1,1,13,126,31,-95,Level A
180,mdxp 2009.10.28,1018,1,1,13,127,31,-96,Level A
242,Hosed 2009.10.27,1020,1,1,13,148,23,-125,Level A
270,ktinfl 2009.10.04,890,1,0,13,176,39,-137,Level A
302,ChessOwnU 2009.12.07,966,2,1,13,169,23,-146,Level A
372,mergall 2009.12.11,984,1,1,13,221,46,-175,Level B
443,dewie 2009.09.17,1065,1,1,13,239,31,-208,Level A
509,nathy 2009.08.12,736,1,0,13,242,8,-234,Level A
588,gobemouche 2009.09.03,954,1,1,13,290,23,-267,Level A
600,SkyMeadow 2009.11.05,938,1,1,13,298,23,-275,Level A
629,chrcoluk 2009.08.12,868,1,0,13,333,39,-294,Level A
631,SkyMeadow 2009.10.03,957,1,0,13,335,39,-296,Level A
665,TheRedSkin 2009.10.07,964,1,0,13,366,39,-327,Level A
692,beatleeleven 2009.12.19,998,1,0,13,370,15,-355,Level A
695,Ifex 2009.09.19,1039,1,0,13,374,15,-359,Level A
33,Acdtume 2009.09.29,1222,1,1,12,47,42,-5,Level B
58,byronjmilhall 2009.08.08,980,1,1,12,64,33,-31,Level B
71,hedgardo 2009.11.14,1187,3,3,12,81,42,-39,Level A
112,tdalex 2009.08.24,1146,1,1,12,93,33,-60,Level A
129,russkime 2009.08.08,1012,1,0,12,107,33,-74,Level B
209,xSnakex 2009.08.24,843,1,0,12,142,33,-109,Level A
213,badstep 2009.08.06,1045,2,2,12,169,58,-111,Level B
230,pmineirov 2009.11.08,1109,1,1,12,158,42,-116,Level A
232,duesse 2009.10.20,920,1,0,12,142,25,-117,Level A
312,MrFrogees 2009.08.12,1108,1,1,12,184,33,-151,Level A
314,FaustArp 2009.08.28,945,1,1,12,168,17,-151,Level A
345,antharas 2009.10.13,978,1,0,12,179,17,-162,Level A
395,BTX 2009.12.16,1029,1,0,12,195,8,-187,Level A
397,hippyman 2009.12.12,872,1,0,12,222,33,-189,Level A
427,smalldreams 2009.08.16,1084,1,0,12,206,8,-198,Level A
441,lucasdawn 2009.08.16,906,1,0,12,239,33,-206,Level A
454,russkime 2009.08.18,962,1,0,12,228,17,-211,Level B
494,drewblastoff 2009.09.13,957,1,1,12,245,17,-228,Level A
527,reframed 2009.08.20,1066,1,0.5,12,277,33,-244,Level A
553,intellow 2009.08.28,1024,1,0.5,12,269,17,-252,Level A
562,intellow 2009.11.09,934,1,1,12,272,17,-255,Level A
637,nathy 2009.09.24,778,1,0,12,319,17,-302,Level A
646,EdSleazy 2009.12.17,1046,1,1,12,326,17,-309,Level A
682,thechrisfactor 2009.12.21,1091,1,0,12,380,33,-347,Level A
728,smalldreams 2009.08.17,1087,1,0,12,466,8,-458,Level A
39,Nebri 2009.12.23,1149,1,1,11,67,55,-12,Level B
44,elfrieda 2009.11.16,1006,1,0,11,70,55,-15,Level B
88,Kkidplayer 2009.12.16,930,1,1,11,86,36,-50,Level A
97,blackknightwa 2009.12.20,1025,1,1,11,88,36,-52,Level A
119,AlfredJ 2009.08.18,1032,1,1,11,110,46,-64,Level B
172,gobemouche 2009.10.04,971,1,1,11,102,9,-93,Level A
195,nabisko 2009.12.18,1051,1,1,11,140,36,-104,Level A
197,powerfail 2009.12.27,1048,1,0.5,11,131,27,-104,Level A
201,Plainzero 2009.12.23,806,1,0,11,142,36,-106,Level B
210,mergall 2009.11.29,961,1,1,11,127,18,-109,Level A
223,owzat 2009.10.17,979,1,1,11,141,27,-114,Level A
288,ANDYTASTIC 2009.08.06,1015,2,1,11,168,27,-141,Level A
328,tomys 2009.08.04,1054,2,2,11,174,18,-156,Level A
339,protoz 2009.10.15,1009,1,1,11,187,27,-160,Level A
386,intellow 2009.10.15,905,1,0,11,219,36,-183,Level A
399,HareBrain 2009.10.03,916,1,1,11,226,36,-190,Level A
411,gobemouche 2009.10.10,927,1,0,11,239,46,-193,Level B
433,shailen 2009.08.27,947,1,1,11,238,36,-202,Level B
447,niCeMoovez 2009.09.23,890,1,0,11,255,46,-209,Level B
464,corrosiv 2009.09.22,972,1,1,11,242,27,-215,Level A
472,graphiboy 2009.10.21,1023,1,1,11,256,36,-220,Level A
473,ironwutang 2009.08.28,828,1,1,11,257,36,-221,Level A
483,alonsofer 2009.08.26,945,1,1,11,233,9,-224,Level A
505,tanimachi 2009.10.21,1018,2,2,11,232,0,-232,Level A
529,mrmackenfan 2009.11.23,839,1,0,11,244,0,-244,Level A
532,Boofstrini 2009.12.17,929,1,0,11,254,9,-245,Level A
541,Quien 2009.11.30,942,2,1,11,275,27,-248,Level A
564,samoancharger 2009.08.09,1081,1,1,11,274,18,-256,Level A
590,japhet 2009.12.16,1061,1,1,11,295,27,-268,Level A
595,Contranigma 2009.09.13,876,1,0,11,289,18,-271,Level A
597,andrejas 2009.08.26,1014,1,0,11,299,27,-272,Level A
602,TheDuster 2009.10.29,952,2,0,11,284,9,-275,Level A
674,gobemouche 2009.09.22,1014,1,0,11,351,18,-333,Level A
701,SkyMeadow 2009.11.19,1112,1,1,11,393,9,-384,Level A
729,gobemouche 2009.09.10,965,2,0,11,468,9,-459,Level A
8,LaurentDelaon 2009.08.31,1099,2,1,10,31,70,39,Level B
21,adnjrw 2009.08.03,811,1,0,10,55,70,15,Level B
37,TRADICIONAL 2009.09.06,1121,1,1,10,58,50,-8,Level B
38,topherpalmtree 2009.11.16,925,2,1,10,69,60,-9,Level B
47,hailu 2009.08.28,961,1,1,10,71,50,-21,Level B
52,auglaize 2009.08.29,1052,1,1,10,65,40,-25,Level B
57,GMenBigBlue 2009.08.29,945,1,0,10,71,40,-31,Level B
84,sammyblade 2009.08.29,1031,1,1,10,99,50,-49,Level B
109,Fukiyama 2009.12.12,1032,1,1,10,89,30,-59,Level A
203,schnookLberry 2009.12.20,936,1,0,10,147,40,-107,Level A
284,Phye 2009.11.29,1031,1,0,10,170,30,-140,Level A
287,Quien 2009.11.23,932,1,1,10,171,30,-141,Level A
294,Marcvz 2009.08.26,1045,1,1,10,173,30,-143,Level A
296,xXxghostxXx 2009.11.11,987,1,0,10,174,30,-144,Level A
327,Fukiyama 2009.12.20,997,1,1,10,176,20,-156,Level A
336,newscot 2009.12.19,900,1,1,10,200,40,-160,Level A
340,intellow 2009.09.21,988,1,0,10,180,20,-160,Level A
341,hedgardo 2009.09.24,1075,1,1,10,191,30,-161,Level A
364,topherpalmtree 2009.11.30,914,1,0,10,190,20,-170,Level A
379,beatleeleven 2009.12.20,958,1,0,10,218,40,-178,Level A
391,lousychess 2009.08.17,1131,1,1,10,194,10,-184,Level A
419,gobemouche 2009.10.09,949,2,0.5,10,225,30,-195,Level A
432,Plainzero 2009.11.29,847,1,0,10,210,10,-200,Level A
474,uetuseuu 2009.09.22,1019,1,0,10,241,20,-221,Level B
510,sospo 2009.08.21,1034,1,0,10,255,20,-235,Level A
513,Hazardo 2009.09.25,931,1,1,10,237,0,-237,Level A
526,QuantumMystic 2009.09.30,987,1,0,10,253,10,-243,Level A
539,paderboots 2009.08.28,944,1,1,10,257,10,-247,Level A
592,Loran 2009.10.07,769,2,0,10,278,10,-268,Level A
601,Contranigma 2009.09.08,891,1,0,10,285,10,-275,Level A
626,Bhunt 2009.09.25,1066,1,0,10,290,0,-290,Level A
648,mrmackenfan 2009.10.25,849,2,0.5,10,330,20,-310,Level A
657,smalldreams 2009.08.28,1131,1,0,10,349,30,-319,Level A
726,Musclorman 2009.08.30,884,1,1,10,442,0,-442,Level A
6,topherpalmtree 2009.10.20,815,1,1,9,19,67,48,Level A
19,remotoots 2009.08.06,970,1,1,9,38,56,18,Level A
26,owzat 2009.09.21,928,2,2,9,41,44,3,Level A
31,drunkindurham 2009.09.07,1264,1,1,9,48,44,-4,Level A
42,AlfredJ 2009.08.23,1051,1,1,9,57,44,-13,Level B
49,JTKhouw 2009.08.04,949,1,1,9,80,56,-24,Level A
55,AlfredJ 2009.08.28,1080,1,1,9,87,56,-31,Level A
60,Nebri 2009.11.29,1092,1,1,9,88,56,-32,Level A
111,mrdigital 2009.09.05,1177,3,3,9,93,33,-60,Level A
145,Giully 2009.12.30,1020,1,1,9,112,33,-79,Level A
148,thotthescribe 2009.09.08,1097,1,1,9,114,33,-81,Level A
160,GMenBigBlue 2009.08.26,966,2,0,9,155,67,-88,Level A
168,Dreamlight 2009.08.26,1048,1,1,9,125,33,-92,Level A
169,protoz 2009.10.10,953,1,1,9,126,33,-93,Level B
170,Hazardo 2009.09.30,953,1,1,9,126,33,-93,Level A
216,EvilQueen 2009.08.14,1020,1,1,9,133,22,-111,Level A
239,fektija 2009.12.18,1020,1,1,9,157,33,-124,Level A
246,DeanMartin 2009.08.18,1125,1,1,9,172,44,-128,Level B
279,Minkowsky 2009.11.26,1069,1,1,9,161,22,-139,Level A
280,yanfen 2009.10.13,994,1,1,9,161,22,-139,Level A
349,Booyens 2009.08.17,933,1,1,9,186,22,-164,Level A
384,dhally 2009.12.21,1104,1,0,9,215,33,-182,Level A
452,SkyMeadow 2009.11.17,1016,1,0,9,233,22,-211,Level A
489,Loran 2009.09.12,724,1,0,9,249,22,-227,Level A
492,LaurentDelaon 2009.12.09,1149,1,1,9,250,22,-228,Level A
500,Khotaa 2009.12.30,843,1,0,9,265,33,-232,Level A
517,mawhin 2009.11.09,942,1,0,9,249,11,-238,Level A
554,Admirn 2009.08.16,967,1,0,9,263,11,-252,Level A
581,LucasKerberHara 2009.08.28,957,1,0,9,275,11,-264,Level A
635,sigggih 2009.08.22,1065,1,0,9,311,11,-300,Level A
643,bialyhetman 2009.10.19,1221,1,1,9,319,11,-308,Level A
650,nathy 2009.09.16,783,1,0,9,324,11,-313,Level A
683,brntout 2009.08.06,947,3,0,9,369,22,-347,Level A
685,tangelo 2009.09.23,821,1,0,9,381,33,-348,Level A
699,Loran 2009.10.19,744,1,0,9,382,11,-371,Level A
742,Quien 2009.11.16,920,1,0,9,674,0,-674,Level A
17,mergall 2009.11.17,919,1,1,8,43,63,20,Level A
27,soffan 2009.09.03,1033,1,0,8,49,50,1,Level A
32,SameerMalik 2009.09.05,1047,1,1,8,55,50,-5,Level A
35,jpjcalculator 2009.09.17,925,1,1,8,45,38,-7,Level A
43,silverspruce 2009.10.04,994,1,1,8,64,50,-14,Level A
45,Giully 2009.10.27,1048,1,1,8,53,38,-15,Level A
48,Kundeohmar 2009.10.09,893,1,0.5,8,46,25,-21,Level A
80,antharas 2009.10.22,1004,1,1,8,97,50,-47,Level A
107,Shridaren 2009.09.11,1005,1,1,8,82,25,-57,Level A
122,stota 2009.09.23,1004,1,1,8,132,63,-69,Level A
124,Thantos 2009.09.02,1141,1,0.5,8,108,38,-70,Level A
161,joulu 2009.08.28,835,1,1,8,126,38,-88,Level A
167,intellow 2009.10.11,916,1,0,8,130,38,-92,Level A
173,egidio 2009.10.05,1085,1,1,8,132,38,-94,Level A
179,ChessOwnU 2009.12.06,884,1,0,8,134,38,-96,Level A
188,Loran 2009.09.20,740,1,0,8,150,50,-100,Level A
189,Sirenus 2009.09.13,1123,1,1,8,138,38,-100,Level A
192,nathy 2009.12.19,757,1,0,8,128,25,-103,Level A
220,getit 2009.08.26,1007,1,1,8,126,13,-113,Level A
273,chagf 2009.10.30,1052,1,1,8,162,25,-137,Level A
297,ziglag 2009.09.12,1199,1,1,8,169,25,-144,Level A
300,jewhouse 2009.08.16,1001,1,1,8,184,38,-146,Level A
306,powerfail 2009.12.28,1009,1,1,8,173,25,-148,Level A
317,smalldreams 2009.08.07,1027,1,1,8,165,13,-152,Level A
351,kybrai 2009.12.16,891,1,0,8,203,38,-165,Level A
368,Langan 2009.11.05,1085,1,0,8,185,13,-172,Level A
371,Admirn 2009.11.27,995,1,1,8,212,38,-174,Level A
377,brickell 2009.08.21,946,1,1,8,176,0,-176,Level A
456,Kleppi 2009.08.13,1034,1,0,8,237,25,-212,Level A
508,Konta 2009.08.05,1081,1,1,8,246,13,-233,Level A
511,niCeMoovez 2009.10.26,903,1,0,8,248,13,-235,Level A
530,nathy 2009.12.28,722,1,0,8,283,38,-245,Level A
538,markhodges 2009.07.27,1116,1,1,8,260,13,-247,Level A
544,GMenBigBlue 2009.09.05,916,1,0,8,248,0,-248,Level A
625,ktinfl 2009.07.27,863,1,0,8,289,0,-289,Level A
660,saipanislandboy 2009.10.30,721,1,0,8,336,13,-323,Level A
684,HareBrain 2009.08.04,1001,1,0,8,347,0,-347,Level A
688,onomatopeia 2009.09.27,1066,1,1,8,349,0,-349,Level A
689,niCeMoovez 2009.10.05,908,1,0,8,351,0,-351,Level A
693,SkyMeadow 2009.11.07,955,1,0,8,370,13,-357,Level A
718,duesse 2009.11.06,729,1,0,8,424,13,-411,Level A
724,nathy 2009.09.27,775,2,1,8,444,13,-431,Level A
