Name,Rating,Games,Result,Moves,CPL,MM,Sort Score,Analysis
wilz 2009.01.11,886,1,1,6,116,50,-66,A
wilz 2009.01.11,886,1,1,6,108,50,-58,B
Deadache 2009.01.11,1081,1,0,6,224,33,-191,A
Deadache 2009.01.11,1081,1,0,6,251,33,-218,B
fjjvh 2009.03.27,700,18,0.5,260,266,19,-247,A
fjjvh 2009.03.27,700,18,0.5,260,265,17,-248,B
tigerblue 2009.03.27,1142,18,17.5,220,157,22,-135,A
tigerblue 2009.03.27,1142,18,17.5,220,151,22,-129,B
robertpmntr 2009.03.26,900,2,2,39,186,28,-158,A
robertpmntr 2009.03.26,900,2,2,39,185,31,-154,B
treezen 2009.03.26,1033,2,0,36,119,31,-88,A
treezen 2009.03.26,1033,2,0,36,124,31,-93,B
BMANMILES 2009.03.26,974,1,1,14,197,21,-176,A
BMANMILES 2009.03.26,974,1,1,14,187,14,-173,B
awen 2009.03.26,940,2,1,19,162,32,-130,A
awen 2009.03.26,940,2,1,19,169,26,-143,B
LDopa 2009.01.16,1074,1,0,22,183,36,-147,A
LDopa 2009.01.16,1074,1,0,22,191,32,-159,B
JEFFMHOW 2009.01.16,921,1,1,19,190,37,-153,A
JEFFMHOW 2009.01.16,921,1,1,19,188,42,-146,B
LDopa 2009.01.13,1022,1,1,5,277,20,-257,A
LDopa 2009.01.13,1022,1,1,5,261,40,-221,B
Crashinator 2009.01.13,814,1,0,9,706,0,-706,A
Crashinator 2009.01.13,814,1,0,9,710,0,-710,B
vetteboy 2009.01.03,920,1,1,18,240,22,-218,A
vetteboy 2009.01.03,920,1,1,18,237,28,-209,B
HogSlayer 2009.01.03,923,1,0,17,221,41,-180,A
HogSlayer 2009.01.03,923,1,0,17,211,47,-164,B
JEFFMHOW 2009.01.15,945,2,1,54,135,33,-102,A
JEFFMHOW 2009.01.15,945,2,1,54,135,31,-104,B
ashwinshivani 2009.01.15,940,2,1,52,160,23,-137,A
ashwinshivani 2009.01.15,940,2,1,52,161,21,-140,B
gilandrew 2009.03.27,898,1,0.5,21,194,24,-170,A
gilandrew 2009.03.27,898,1,0.5,21,193,29,-164,B
nicholasjanssen 2009.03.27,988,1,0.5,23,228,26,-202,A
nicholasjanssen 2009.03.27,988,1,0.5,23,230,26,-204,B
FMH 2009.01.11,1115,1,1,11,93,9,-84,A
FMH 2009.01.11,1115,1,1,11,88,18,-70,B
Crashinator 2009.01.11,799,2,1,37,179,22,-157,A
Crashinator 2009.01.11,799,2,1,37,183,19,-164,B
DarthDaviz 2009.03.26,1005,2,1,10,286,30,-256,A
DarthDaviz 2009.03.26,1005,2,1,10,264,40,-224,B
PLUGZ 2009.03.26,988,2,1,9,190,33,-157,A
PLUGZ 2009.03.26,988,2,1,9,161,33,-128,B
paire 2009.03.13,1216,3,2.5,49,262,16,-246,A
paire 2009.03.13,1216,3,2.5,49,250,18,-232,B
fjjvh 2009.03.13,690,3,0.5,55,398,16,-382,A
fjjvh 2009.03.13,690,3,0.5,55,413,16,-397,B
fjjvh 2009.03.10,708,6,0,86,327,19,-308,A
fjjvh 2009.03.10,708,6,0,86,315,17,-298,B
JamesJohnson 2009.03.10,1236,1,1,6,157,17,-140,A
JamesJohnson 2009.03.10,1236,1,1,6,103,17,-86,B
Psao 2009.03.11,954,1,1,7,103,14,-89,A
Psao 2009.03.11,954,1,1,7,100,14,-86,B
Benly 2009.03.11,865,4,1,47,169,32,-137,A
Benly 2009.03.11,865,4,1,47,152,32,-120,B
Uncrowned 2009.02.21,917,1,1,11,178,0,-178,A
Uncrowned 2009.02.21,917,1,1,11,175,9,-166,B
Crashinator 2009.02.21,929,1,0,11,298,18,-280,A
Crashinator 2009.02.21,929,1,0,11,285,9,-276,B
Limzaroth 2009.03.30,791,1,0,10,173,0,-173,A
Limzaroth 2009.03.30,791,1,0,10,145,20,-125,B
thebigmac 2009.03.30,999,1,1,10,108,40,-68,A
thebigmac 2009.03.30,999,1,1,10,93,40,-53,B
jatwfn 2009.03.28,1073,3,3,44,159,30,-129,A
jatwfn 2009.03.28,1073,3,3,44,137,27,-110,B
fjjvh 2009.03.28,680,4,0,88,461,5,-456,A
fjjvh 2009.03.28,680,4,0,88,448,7,-441,B
ktinfl 2009.01.14,921,1,0,13,261,8,-253,A
ktinfl 2009.01.14,921,1,0,13,272,8,-264,B
vetteboy 2009.01.14,956,1,1,13,216,31,-185,A
vetteboy 2009.01.14,956,1,1,13,212,31,-181,B
AureA 2009.03.30,1003,3,1.5,39,163,41,-122,A
AureA 2009.03.30,1003,3,1.5,39,163,41,-122,B
Soilwork 2009.03.30,900,1,0,12,309,8,-301,A
Soilwork 2009.03.30,900,1,0,12,396,8,-388,B
vetteboy 2009.01.13,942,1,1,12,162,42,-120,A
vetteboy 2009.01.13,942,1,1,12,146,50,-96,B
Devekut 2009.01.13,985,1,0,15,475,13,-462,A
Devekut 2009.01.13,985,1,0,15,374,20,-354,B
PABOY 2009.01.04,881,1,1,15,296,20,-276,A
PABOY 2009.01.04,881,1,1,15,280,20,-260,B
mudbog 2009.01.04,1115,1,0,15,379,20,-359,A
mudbog 2009.01.04,1115,1,0,15,374,27,-347,B
pendaggie 2009.01.05,868,1,0,51,204,29,-175,A
pendaggie 2009.01.05,868,1,0,51,201,29,-172,B
fishmasters 2009.01.05,1079,1,1,49,178,26,-152,A
fishmasters 2009.01.05,1079,1,1,49,173,31,-142,B
jkkcole 2009.01.10,974,2,1.5,16,180,25,-155,A
jkkcole 2009.01.10,974,2,1.5,16,175,38,-137,B
pmineiro 2009.01.10,888,1,0.5,8,187,0,-187,A
pmineiro 2009.01.10,888,1,0.5,8,194,12,-182,B
fishmasters 2009.01.10,1031,1,0,11,238,9,-229,A
fishmasters 2009.01.10,1031,1,0,11,247,9,-238,B
vetteboy 2009.01.10,925,2,1,18,302,0,-302,A
vetteboy 2009.01.10,925,2,1,18,280,6,-274,B
vetteboy 2009.01.04,939,1,0,16,237,13,-224,A
vetteboy 2009.01.04,939,1,0,16,227,12,-215,B
FFDunn 2009.01.04,1051,1,1,13,128,31,-97,A
FFDunn 2009.01.04,1051,1,1,13,124,31,-93,B
awen 2009.03.24,964,1,0,14,231,21,-210,A
awen 2009.03.24,964,1,0,14,248,21,-227,B
vetteboy 2009.03.24,990,1,1,14,314,14,-300,A
vetteboy 2009.03.24,990,1,1,14,275,7,-268,B
RiverStyx 2009.03.23,891,2,1,9,415,11,-404,A
RiverStyx 2009.03.23,891,2,1,9,397,22,-375,B
teihlard 2009.03.23,1041,1,1,5,136,40,-96,A
teihlard 2009.03.23,1041,1,1,5,129,40,-89,B
Vaudevillian 2009.01.05,1054,1,0,16,222,25,-197,A
Vaudevillian 2009.01.05,1054,1,0,16,201,25,-176,B
gforced 2009.01.05,926,1,1,14,122,14,-108,A
gforced 2009.01.05,926,1,1,14,109,21,-88,B
elnekave 2009.03.20,896,1,0,8,297,12,-285,A
elnekave 2009.03.20,896,1,0,8,283,25,-258,B
pmineiro 2009.03.20,904,1,1,7,78,43,-35,A
pmineiro 2009.03.20,904,1,1,7,72,43,-29,B
plumbo 2009.03.30,848,1,1,14,106,43,-63,A
plumbo 2009.03.30,848,1,1,14,74,50,-24,B
caga 2009.03.28,1305,1,1,9,385,22,-363,A
caga 2009.03.28,1305,1,1,9,383,22,-361,B
lamell 2009.01.15,814,2,0,10,111,10,-101,A
lamell 2009.01.15,814,2,0,10,117,10,-107,B
AmpedAl 2009.01.15,1058,2,2,11,86,36,-50,A
AmpedAl 2009.01.15,1058,2,2,11,84,36,-48,B
MagicCube 2009.03.23,949,2,1,18,196,33,-163,A
MagicCube 2009.03.23,949,2,1,18,130,22,-108,B
PABOY 2009.03.23,1004,1,1,13,99,31,-68,A
PABOY 2009.03.23,1004,1,1,13,96,31,-65,B
maraman 2009.03.28,998,1,0,7,229,14,-215,A
maraman 2009.03.28,998,1,0,7,246,14,-232,B
LUPULEAC 2009.03.28,984,1,1,6,45,67,22,A
LUPULEAC 2009.03.28,984,1,1,6,49,67,18,B
JohnWinthrop 2009.01.12,1172,1,1,12,75,33,-42,A
JohnWinthrop 2009.01.12,1172,1,1,12,67,42,-25,B
Crashinator 2009.01.12,817,1,0,19,304,37,-267,A
Crashinator 2009.01.12,817,1,0,19,268,26,-242,B
fishmasters 2009.01.03,873,1,1,13,134,31,-103,A
fishmasters 2009.01.03,873,1,1,13,159,23,-136,B
brainllama 2009.01.03,983,1,0,9,165,33,-132,A
brainllama 2009.01.03,983,1,0,9,170,22,-148,B
Akio 2009.03.30,954,1,0.5,15,185,27,-158,A
Akio 2009.03.30,954,1,0.5,15,162,47,-115,B
AureA 2009.03.29,986,1,0.5,13,116,38,-78,A
AureA 2009.03.29,986,1,0.5,13,101,38,-63,B
Nifteind 2009.03.29,979,1,0.5,13,104,31,-73,A
Nifteind 2009.03.29,979,1,0.5,13,120,31,-89,B
Crashinator 2009.01.15,822,1,0,8,178,12,-166,A
Crashinator 2009.01.15,822,1,0,8,200,0,-200,B
fishmasters 2009.01.15,1037,1,1,7,133,14,-119,A
fishmasters 2009.01.15,1037,1,1,7,124,29,-95,B
AureA 2009.03.28,1035,1,1,33,151,18,-133,A
AureA 2009.03.28,1035,1,1,33,142,18,-124,B
plumbo 2009.03.28,908,1,0,33,141,39,-102,A
plumbo 2009.03.28,908,1,0,33,136,39,-97,B
Thorolas 2009.01.13,924,1,1,32,187,31,-156,A
Thorolas 2009.01.13,924,1,1,32,185,31,-154,B
ashwinshivani 2009.01.13,976,1,0,29,225,17,-208,A
ashwinshivani 2009.01.13,976,1,0,29,190,21,-169,B
Crashinator 2009.01.07,815,1,0,19,274,16,-258,A
Crashinator 2009.01.07,815,1,0,19,213,21,-192,B
SmashBrosBrawl 2009.01.07,1112,1,1,17,110,24,-86,A
SmashBrosBrawl 2009.01.07,1112,1,1,17,92,29,-63,B
fjjvh 2009.03.21,686,5,2.0,116,202,27,-175,A
fjjvh 2009.03.21,686,5,2.0,116,193,28,-165,B
chmpf 2009.03.21,947,5,3.0,110,190,28,-162,A
chmpf 2009.03.21,947,5,3.0,110,195,28,-167,B
jarnaud 2009.01.12,1076,1,0,12,214,25,-189,A
jarnaud 2009.01.12,1076,1,0,12,228,25,-203,B
Admirn 2009.01.12,908,1,1,11,246,18,-228,A
Admirn 2009.01.12,908,1,1,11,229,18,-211,B
AureA 2009.03.27,1108,1,0,6,235,33,-202,A
AureA 2009.03.27,1108,1,0,6,238,33,-205,B
BeauDog 2009.03.27,881,1,1,6,196,33,-163,A
BeauDog 2009.03.27,881,1,1,6,195,33,-162,B
IOOOOOWelcomesWeb 2009.03.23,1016,1,0,18,393,11,-382,A
IOOOOOWelcomesWeb 2009.03.23,1016,1,0,18,401,11,-390,B
awen 2009.03.23,962,2,1,22,400,23,-377,A
awen 2009.03.23,962,2,1,22,402,23,-379,B
Deltaprism 2009.03.11,1059,3,2,40,88,60,-28,A
Deltaprism 2009.03.11,1059,3,2,40,88,57,-31,B
Deltaprism 2009.03.11,1059,3,2,40,89,60,-29,C
Deltaprism 2009.03.11,1059,3,2,40,89,57,-32,D
paire 2009.03.10,1242,3,3,46,215,17,-198,A
paire 2009.03.10,1242,3,3,46,209,20,-189,B
Crashinator 2009.02.15,884,1,0,13,184,15,-169,A
Crashinator 2009.02.15,884,1,0,13,195,8,-187,B
Sebbel 2009.02.15,1035,1,1,10,71,50,-21,A
Sebbel 2009.02.15,1035,1,1,10,49,60,11,B
volodymyrrudyj 2009.01.06,1067,1,0,8,331,37,-294,A
volodymyrrudyj 2009.01.06,1067,1,0,8,275,38,-237,B
Beerbong 2009.01.06,932,2,1,23,215,22,-193,A
Beerbong 2009.01.06,932,2,1,23,211,30,-181,B
Sebbel 2009.01.06,900,1,1,12,117,25,-92,A
Sebbel 2009.01.06,900,1,1,12,110,33,-77,B
Soilwork 2009.03.26,916,1,1,18,258,28,-230,A
Soilwork 2009.03.26,916,1,1,18,372,22,-350,B
chesseeka 2009.03.26,1008,1,0,13,208,46,-162,A
chesseeka 2009.03.26,1008,1,0,13,216,38,-178,B
Ezeled 2009.03.23,1027,1,0,4,381,0,-381,A
Ezeled 2009.03.23,1027,1,0,4,300,0,-300,B
Beerbong 2009.01.09,955,1,0,26,128,31,-97,A
Beerbong 2009.01.09,955,1,0,26,129,35,-94,B
SunRaphi 2009.01.09,995,1,1,25,76,44,-32,A
SunRaphi 2009.01.09,995,1,1,25,79,48,-31,B
chadsmith 2009.03.26,1067,1,0,9,337,0,-337,A
chadsmith 2009.03.26,1067,1,0,9,397,11,-386,B
fjjvh 2009.03.19,691,12,1.5,183,360,10,-350,A
fjjvh 2009.03.19,691,12,1.5,183,354,11,-343,B
jatwfn 2009.03.19,1067,11,9.5,130,280,18,-262,A
jatwfn 2009.03.19,1067,11,9.5,130,277,15,-262,B
ohaighain 2009.03.18,1021,1,1,11,69,36,-33,A
ohaighain 2009.03.18,1021,1,1,11,57,36,-21,B
biplobibeginner 2009.03.18,968,1,0,12,125,8,-117,A
biplobibeginner 2009.03.18,968,1,0,12,133,17,-116,B
Sebbel 2009.01.03,921,1,0,24,94,29,-65,A
Sebbel 2009.01.03,921,1,0,24,79,42,-37,B
acmauroe 2009.01.03,909,1,1,23,49,52,3,A
acmauroe 2009.01.03,909,1,1,23,51,39,-12,B
robertpmntr 2009.03.21,955,1,0,43,183,26,-157,A
robertpmntr 2009.03.21,955,1,0,43,191,26,-165,B
IWON 2009.03.21,1016,1,1,40,96,45,-51,A
IWON 2009.03.21,1016,1,1,40,112,48,-64,B
mclaro 2009.01.08,1047,1,0,14,248,0,-248,A
mclaro 2009.01.08,1047,1,0,14,326,0,-326,B
PABOY 2009.01.08,918,1,1,9,110,22,-88,A
PABOY 2009.01.08,918,1,1,9,130,22,-108,B
chmpf 2009.03.20,951,1,0,16,361,25,-336,A
chmpf 2009.03.20,951,1,0,16,363,25,-338,B
ccf 2009.03.20,1005,1,1,12,152,42,-110,A
ccf 2009.03.20,1005,1,1,12,156,42,-114,B
PABOY 2009.01.06,897,1,0.5,18,167,44,-123,A
PABOY 2009.01.06,897,1,0.5,18,167,50,-117,B
ktinfl 2009.01.06,981,1,0.5,10,180,30,-150,A
ktinfl 2009.01.06,981,1,0.5,10,154,50,-104,B
chmpf 2009.03.16,960,2,1.5,10,120,30,-90,A
chmpf 2009.03.16,960,2,1.5,10,115,30,-85,B
fjjvh 2009.03.16,693,3,1.5,25,406,20,-386,A
fjjvh 2009.03.16,693,3,1.5,25,409,16,-393,B
golmman 2008.12.27,1044,1,1,6,172,17,-155,A
golmman 2008.12.27,1044,1,1,6,155,33,-122,B
Crashinator 2008.12.27,790,1,0,7,204,29,-175,A
Crashinator 2008.12.27,790,1,0,7,207,29,-178,B
Melkzedech 2009.01.02,1119,1,1,19,183,32,-151,A
Melkzedech 2009.01.02,1119,1,1,19,178,42,-136,B
fishmasters 2009.01.02,819,1,0,21,299,24,-275,A
fishmasters 2009.01.02,819,1,0,21,300,19,-281,B
awen 2009.03.18,891,1,0,10,348,10,-338,A
awen 2009.03.18,891,1,0,10,350,10,-340,B
LzVandy 2009.03.18,1062,1,1,9,107,56,-51,A
LzVandy 2009.03.18,1062,1,1,9,156,56,-100,B
ktinfl 2009.01.03,998,1,1,13,103,23,-80,A
ktinfl 2009.01.03,998,1,1,13,94,31,-63,B
jkkcole 2009.01.03,986,1,0,15,151,27,-124,A
jkkcole 2009.01.03,986,1,0,15,150,27,-123,B
fjjvh 2009.03.20,686,2,0.5,23,371,22,-349,A
fjjvh 2009.03.20,686,2,0.5,23,378,22,-356,B
paire 2009.03.20,1208,1,1,11,296,27,-269,A
paire 2009.03.20,1208,1,1,11,320,27,-293,B
fjjvh 2009.03.12,689,5,0.5,122,293,22,-271,A
fjjvh 2009.03.12,689,5,0.5,122,299,20,-279,B
chmpf 2009.03.12,961,3,2.5,62,307,29,-278,A
chmpf 2009.03.12,961,3,2.5,62,268,31,-237,B
Avisharv 2009.03.21,1020,1,0,17,251,24,-227,A
Avisharv 2009.03.21,1020,1,0,17,244,24,-220,B
awen 2009.03.21,885,1,1,15,151,47,-104,A
awen 2009.03.21,885,1,1,15,153,40,-113,B
fjjvh 2009.03.17,710,7,0,102,364,9,-355,A
fjjvh 2009.03.17,710,7,0,102,348,8,-340,B
jatwfn 2009.03.17,1045,7,7,88,273,13,-260,A
jatwfn 2009.03.17,1045,7,7,88,269,11,-258,B
paire 2009.03.15,1226,3,2.5,33,358,33,-325,A
paire 2009.03.15,1226,3,2.5,33,327,30,-297,B
fjjvh 2009.03.15,689,3,0.5,29,373,28,-345,A
fjjvh 2009.03.15,689,3,0.5,29,264,31,-233,B
Akio 2009.03.12,967,1,0,17,148,29,-119,A
Akio 2009.03.12,967,1,0,17,173,24,-149,B
Benly 2009.03.12,999,1,1,18,304,22,-282,A
Benly 2009.03.12,999,1,1,18,296,33,-263,B
jatwfn 2009.03.20,1071,1,0.5,9,168,44,-124,A
jatwfn 2009.03.20,1071,1,0.5,9,182,33,-149,B
Vosman 2009.03.18,1146,1,0.5,3,21,33,12,A
Vosman 2009.03.18,1146,1,0.5,3,63,33,-30,B
fjjvh 2009.03.18,689,2,0.5,12,413,0,-413,A
fjjvh 2009.03.18,689,2,0.5,12,308,0,-308,B
fjjvh 2009.03.08,726,12,1.0,238,409,11,-398,A
fjjvh 2009.03.08,726,12,1.0,238,391,13,-378,B
jatwfn 2009.03.08,1026,11,10.0,214,377,15,-362,A
jatwfn 2009.03.08,1026,11,10.0,214,368,14,-354,B
DaveMiddled 2009.03.05,853,1,1,7,201,57,-144,A
DaveMiddled 2009.03.05,853,1,1,7,220,29,-191,B
brainllama 2009.03.05,1020,1,0,6,48,50,2,A
brainllama 2009.03.05,1020,1,0,6,54,33,-21,B
lepomis 2009.02.26,953,1,1,22,52,27,-25,A
lepomis 2009.02.26,953,1,1,22,54,23,-31,B
KoalieAwe 2009.02.26,1009,1,0,25,59,40,-19,A
KoalieAwe 2009.02.26,1009,1,0,25,65,36,-29,B
Melvill 2009.02.07,981,1,0,11,137,36,-101,A
Melvill 2009.02.07,981,1,0,11,130,36,-94,B
LisbonNightTrain 2009.02.07,967,1,1,11,130,18,-112,A
LisbonNightTrain 2009.02.07,967,1,1,11,130,18,-112,B
Fukiyama 2009.02.18,834,1,1,20,204,20,-184,A
Fukiyama 2009.02.18,834,1,1,20,195,15,-180,B
Melvill 2009.02.18,1022,1,0,19,163,21,-142,A
Melvill 2009.02.18,1022,1,0,19,156,21,-135,B
paire 2009.03.19,1209,1,1,12,94,42,-52,A
paire 2009.03.19,1209,1,1,12,108,33,-75,B
IrishRottie 2009.03.13,990,1,1,27,125,33,-92,A
IrishRottie 2009.03.13,990,1,1,27,124,33,-91,B
Akio 2009.03.13,908,1,0,26,126,23,-103,A
Akio 2009.03.13,908,1,0,26,128,27,-101,B
jatwfn 2009.03.18,1063,1,1,3,108,33,-75,A
jatwfn 2009.03.18,1063,1,1,3,50,0,-50,B
jatwfn 2009.03.11,1040,6,6,84,292,15,-277,A
jatwfn 2009.03.11,1040,6,6,84,294,17,-277,B
fjjvh 2009.03.11,699,8,0.5,175,362,23,-339,A
fjjvh 2009.03.11,699,8,0.5,175,359,22,-337,B
paire 2009.03.09,1277,3,3,33,271,27,-244,A
paire 2009.03.09,1277,3,3,33,255,21,-234,B
fjjvh 2009.03.09,713,3,0,47,529,19,-510,A
fjjvh 2009.03.09,713,3,0,47,513,15,-498,B
elnekave 2009.02.26,916,1,0,11,257,27,-230,A
elnekave 2009.02.26,916,1,0,11,278,27,-251,B
ginjaninja 2009.02.26,1083,1,1,9,270,33,-237,A
ginjaninja 2009.02.26,1083,1,1,9,248,33,-215,B
paire 2009.03.14,1231,1,1,6,284,33,-251,A
paire 2009.03.14,1231,1,1,6,273,33,-240,B
fjjvh 2009.03.14,694,1,0,6,390,17,-373,A
fjjvh 2009.03.14,694,1,0,6,314,33,-281,B
chmpf 2009.03.11,975,2,1.5,57,368,19,-349,A
chmpf 2009.03.11,975,2,1.5,57,383,19,-364,B
Vosman 2009.03.12,1197,1,1,8,88,25,-63,A
Vosman 2009.03.12,1197,1,1,8,110,12,-98,B
procussionaire 2009.03.13,1061,1,1,11,177,54,-123,A
procussionaire 2009.03.13,1061,1,1,11,181,54,-127,B
titusm 2009.03.13,770,1,0,16,300,38,-262,A
titusm 2009.03.13,770,1,0,16,299,31,-268,B
paire 2009.03.12,1246,1,1,40,275,22,-253,A
paire 2009.03.12,1246,1,1,40,285,25,-260,B
paire 2009.03.16,1219,1,0,17,328,18,-310,A
paire 2009.03.16,1219,1,0,17,310,12,-298,B
JackPacman 2009.03.13,885,1,0,13,320,31,-289,A
JackPacman 2009.03.13,885,1,0,13,156,38,-118,B
Deltaprism 2009.03.13,1007,1,1,12,103,58,-45,A
Deltaprism 2009.03.13,1007,1,1,12,71,58,-13,B
jatwfn 2009.03.10,1036,2,2,27,317,15,-302,A
jatwfn 2009.03.10,1036,2,2,27,298,11,-287,B
vetteboy 2009.02.25,980,1,1,15,112,40,-72,A
vetteboy 2009.02.25,980,1,1,15,108,40,-68,B
Crashinator 2009.02.25,956,1,0,15,202,27,-175,A
Crashinator 2009.02.25,956,1,0,15,178,33,-145,B
ifuwurarabitidnmu 2009.02.17,1054,1,1,15,246,20,-226,A
ifuwurarabitidnmu 2009.02.17,1054,1,1,15,178,13,-165,B
chokefetuschoke 2009.02.17,910,1,0,17,250,29,-221,A
chokefetuschoke 2009.02.17,910,1,0,17,239,35,-204,B
bluepen 2009.03.12,857,1,0,12,164,33,-131,A
bluepen 2009.03.12,857,1,0,12,144,25,-119,B
TonyHappyChess 2009.03.12,1107,1,1,10,104,40,-64,A
TonyHappyChess 2009.03.12,1107,1,1,10,93,30,-63,B
fjjvh 2009.03.05,736,2,0,31,432,16,-416,A
fjjvh 2009.03.05,736,2,0,31,447,13,-434,B
jatwfn 2009.03.05,1017,2,2,36,503,11,-492,A
jatwfn 2009.03.05,1017,2,2,36,525,11,-514,B
JedTed 2009.02.10,1099,2,2,34,217,18,-199,A
JedTed 2009.02.10,1099,2,2,34,206,15,-191,B
ManWhoKilledDeer 2009.02.10,854,2,0,36,254,22,-232,A
ManWhoKilledDeer 2009.02.10,854,2,0,36,244,25,-219,B
paire 2009.03.08,1228,1,1,21,437,14,-423,A
paire 2009.03.08,1228,1,1,21,417,14,-403,B
Admirn 2009.02.28,970,1,1,24,127,29,-98,A
Admirn 2009.02.28,970,1,1,24,136,25,-111,B
Sirenus 2009.02.28,955,1,0,23,160,22,-138,A
Sirenus 2009.02.28,955,1,0,23,172,22,-150,B
Crashinator 2009.02.18,867,1,0,11,399,36,-363,A
Crashinator 2009.02.18,867,1,0,11,401,36,-365,B
pmineiro 2009.02.18,902,1,1,10,277,20,-257,A
pmineiro 2009.02.18,902,1,1,10,263,20,-243,B
indbug 2009.02.05,956,2,0.5,36,164,44,-120,A
indbug 2009.02.05,956,2,0.5,36,163,36,-127,B
indbug 2009.02.05,956,2,0.5,36,170,39,-131,C
staljin 2009.02.05,971,2,1.5,33,83,67,-16,A
staljin 2009.02.05,971,2,1.5,33,86,61,-25,B
staljin 2009.02.05,971,2,1.5,33,88,58,-30,C
sekulla 2009.01.29,857,3,0,24,325,17,-308,A
sekulla 2009.01.29,857,3,0,24,340,21,-319,B
Killerhoernchen 2009.01.29,1147,1,1,4,214,25,-189,A
Killerhoernchen 2009.01.29,1147,1,1,4,232,25,-207,B
fjjvh 2009.03.07,725,6,1.0,132,425,14,-411,A
fjjvh 2009.03.07,725,6,1.0,132,404,14,-390,B
jatwfn 2009.03.07,1026,6,5.0,121,291,19,-272,A
jatwfn 2009.03.07,1026,6,5.0,121,283,18,-265,B
gforced 2009.03.08,984,1,0,53,94,47,-47,A
gforced 2009.03.08,984,1,0,53,100,47,-53,B
churrcuz 2009.03.08,1015,1,1,54,87,43,-44,A
churrcuz 2009.03.08,1015,1,1,54,90,41,-49,B
awen 2009.03.08,883,1,0,6,197,33,-164,A
awen 2009.03.08,883,1,0,6,185,33,-152,B
genekhayyam 2009.03.08,1023,1,1,6,76,50,-26,A
genekhayyam 2009.03.08,1023,1,1,6,68,50,-18,B
Deadache 2009.03.06,1200,1,1,9,191,33,-158,A
Deadache 2009.03.06,1200,1,1,9,160,33,-127,B
fjjvh 2009.03.06,733,2,0,38,267,21,-246,A
fjjvh 2009.03.06,733,2,0,38,264,16,-248,B
nicksun 2009.01.25,981,2,1,51,109,33,-76,A
nicksun 2009.01.25,981,2,1,51,102,29,-73,B
RangoBango 2009.01.25,1002,1,1,26,73,50,-23,A
RangoBango 2009.01.25,1002,1,1,26,88,31,-57,B
jarnaud 2009.01.29,1051,1,1,6,280,0,-280,A
jarnaud 2009.01.29,1051,1,1,6,270,0,-270,B
achieve 2009.03.07,1067,1,1,10,141,40,-101,A
achieve 2009.03.07,1067,1,1,10,150,30,-120,B
MishaG 2009.03.07,915,1,0,10,235,0,-235,A
MishaG 2009.03.07,915,1,0,10,238,0,-238,B
Fukiyama 2009.03.05,975,1,1,11,243,18,-225,A
Fukiyama 2009.03.05,975,1,1,11,236,18,-218,B
pmineiro 2009.03.05,933,1,0,13,299,15,-284,A
pmineiro 2009.03.05,933,1,0,13,287,15,-272,B
chmpf 2009.03.04,956,1,1,24,226,8,-218,A
chmpf 2009.03.04,956,1,1,24,217,12,-205,B
fjjvh 2009.03.04,729,1,0,36,348,22,-326,A
fjjvh 2009.03.04,729,1,0,36,330,22,-308,B
insanemew 2009.02.25,1011,1,1,8,196,25,-171,A
insanemew 2009.02.25,1011,1,1,8,203,38,-165,B
Fukiyama 2009.02.25,984,1,0,9,363,22,-341,A
Fukiyama 2009.02.25,984,1,0,9,374,22,-352,B
jatwfn 2009.03.06,1023,1,1,26,210,27,-183,A
jatwfn 2009.03.06,1023,1,1,26,211,27,-184,B
Traenexx 2009.03.04,915,1,0.5,54,104,35,-69,A
Traenexx 2009.03.04,915,1,0.5,54,104,39,-65,B
Fukiyama 2009.03.04,913,1,0.5,50,91,38,-53,A
Fukiyama 2009.03.04,913,1,0.5,50,87,40,-47,B
Fukiyama 2009.02.21,776,1,0.5,11,180,18,-162,A
Fukiyama 2009.02.21,776,1,0.5,11,177,18,-159,B
TacticalDiligence 2009.02.21,1053,1,0.5,20,267,25,-242,A
TacticalDiligence 2009.02.21,1053,1,0.5,20,301,20,-281,B
Limzaroth 2009.02.20,936,2,1,27,304,26,-278,A
Limzaroth 2009.02.20,936,2,1,27,292,15,-277,B
chokefetuschoke 2009.02.20,885,2,1,26,285,12,-273,A
chokefetuschoke 2009.02.20,885,2,1,26,290,15,-275,B
jabziii 2009.02.18,1087,1,1,15,124,33,-91,A
jabziii 2009.02.18,1087,1,1,15,134,40,-94,B
Xillion 2009.02.18,909,1,0,15,188,27,-161,A
Xillion 2009.02.18,909,1,0,15,186,27,-159,B
bigjturner 2009.02.04,997,1,0.5,33,216,24,-192,A
bigjturner 2009.02.04,997,1,0.5,33,174,30,-144,B
rafaelpadua 2009.02.04,985,1,0.5,31,123,39,-84,A
rafaelpadua 2009.02.04,985,1,0.5,31,94,39,-55,B
Sirenus 2009.02.24,885,1,1,17,206,24,-182,A
Sirenus 2009.02.24,885,1,1,17,222,18,-204,B
ChessterQKnightly 2009.02.24,1111,1,0,16,259,31,-228,A
ChessterQKnightly 2009.02.24,1111,1,0,16,244,38,-206,B
ifuwurarabitidnmu 2009.02.21,1037,1,0.5,8,252,25,-227,A
ifuwurarabitidnmu 2009.02.21,1037,1,0.5,8,222,25,-197,B
chokefetuschoke 2009.02.21,885,1,0.5,9,429,11,-418,A
chokefetuschoke 2009.02.21,885,1,0.5,9,397,22,-375,B
MikeTheMaverick 2009.02.10,1039,1,1,5,63,80,17,A
MikeTheMaverick 2009.02.10,1039,1,1,5,57,80,23,B
sekulla 2009.02.10,799,1,0,6,369,17,-352,A
sekulla 2009.02.10,799,1,0,6,355,17,-338,B
texasroots 2009.02.08,967,1,1,25,139,24,-115,A
texasroots 2009.02.08,967,1,1,25,114,32,-82,B
bluepen 2009.02.08,997,1,0,25,128,28,-100,A
bluepen 2009.02.08,997,1,0,25,128,28,-100,B
uberpao 2009.02.04,1050,1,1,19,212,21,-191,A
uberpao 2009.02.04,1050,1,1,19,196,26,-170,B
Killerhoernchen 2009.02.04,983,2,0,28,260,18,-242,A
Killerhoernchen 2009.02.04,983,2,0,28,258,18,-240,B
PatatZonder 2009.01.29,1132,1,1,12,237,17,-220,A
PatatZonder 2009.01.29,1132,1,1,12,236,33,-203,B
treezen 2009.03.03,998,1,0.5,52,136,31,-105,A
treezen 2009.03.03,998,1,0.5,52,133,35,-98,B
Fukiyama 2009.03.03,905,1,0.5,49,113,37,-76,A
Fukiyama 2009.03.03,905,1,0.5,49,121,41,-80,B
kebax 2009.02.20,1128,1,1,7,119,14,-105,A
kebax 2009.02.20,1128,1,1,7,102,14,-88,B
Fukiyama 2009.02.20,817,1,0,8,159,12,-147,A
Fukiyama 2009.02.20,817,1,0,8,226,12,-214,B
sitkaak 2009.02.09,892,1,1,3,188,0,-188,A
sitkaak 2009.02.09,892,1,1,3,188,0,-188,B
lancearmstrong 2009.02.09,988,2,0,15,359,20,-339,A
lancearmstrong 2009.02.09,988,2,0,15,351,20,-331,B
chmpf 2009.02.07,966,1,0,10,284,40,-244,A
chmpf 2009.02.07,966,1,0,10,304,40,-264,B
ccf 2009.02.07,1005,1,1,9,230,33,-197,A
ccf 2009.02.07,1005,1,1,9,236,33,-203,B
JaysonE 2009.01.24,1052,1,1,31,130,52,-78,A
JaysonE 2009.01.24,1052,1,1,31,125,52,-73,B
JaysonE 2009.01.24,1052,1,1,31,133,48,-85,C
ktinfl 2009.01.24,897,1,0,30,183,23,-160,A
ktinfl 2009.01.24,897,1,0,30,181,20,-161,B
ktinfl 2009.01.24,897,1,0,30,181,20,-161,C
cweatherbe 2009.02.19,1020,1,0,17,351,29,-322,A
cweatherbe 2009.02.19,1020,1,0,17,289,35,-254,B
Crashinator 2009.02.19,857,1,1,13,182,61,-121,A
Crashinator 2009.02.19,857,1,1,13,156,46,-110,B
bigjturner 2009.02.14,984,1,1,10,99,30,-69,A
bigjturner 2009.02.14,984,1,1,10,108,20,-88,B
vetteboy 2009.02.14,1014,1,0,12,194,25,-169,A
vetteboy 2009.02.14,1014,1,0,12,252,25,-227,B
jmoon 2009.02.07,907,1,0,10,128,40,-88,A
jmoon 2009.02.07,907,1,0,10,159,40,-119,B
yoyojim 2009.02.07,1043,1,1,9,25,56,31,A
yoyojim 2009.02.07,1043,1,1,9,28,56,28,B
msbillions 2009.01.25,923,1,0,28,225,25,-200,A
msbillions 2009.01.25,923,1,0,28,167,25,-142,B
vcrazy 2009.01.11,1189,1,0,26,222,27,-195,A
vcrazy 2009.01.11,1189,1,0,26,215,23,-192,B
Giulietta 2008.09.14,1017,1,0,20,255,15,-240,A
Giulietta 2008.09.14,1017,1,0,20,266,15,-251,B
vetteboy 2008.09.14,875,1,1,21,406,10,-396,A
vetteboy 2008.09.14,875,1,1,21,373,10,-363,B
noncsi 2008.11.27,920,1,1,8,163,12,-151,A
noncsi 2008.11.27,920,1,1,8,174,12,-162,B
agfa 2008.11.27,1049,1,0,9,245,33,-212,A
agfa 2008.11.27,1049,1,0,9,262,33,-229,B
deeprince 2009.01.22,872,2,0,35,265,26,-239,A
deeprince 2009.01.22,872,2,0,35,263,26,-237,B
jaydottaylor 2009.01.22,1114,1,1,27,285,18,-267,A
jaydottaylor 2009.01.22,1114,1,1,27,296,22,-274,B
PABOY 2009.02.16,966,1,1,7,190,29,-161,A
PABOY 2009.02.16,966,1,1,7,166,29,-137,B
zhouzhaowu 2009.02.16,933,1,0,8,535,0,-535,A
zhouzhaowu 2009.02.16,933,1,0,8,425,12,-413,B
noncsi 2008.12.27,1008,1,1,13,203,15,-188,A
noncsi 2008.12.27,1008,1,1,13,190,15,-175,B
fishmasters 2008.12.27,854,1,0,15,305,20,-285,A
fishmasters 2008.12.27,854,1,0,15,320,13,-307,B
Crashinator 2009.02.01,845,3,0,56,349,13,-336,A
Crashinator 2009.02.01,845,3,0,56,328,16,-312,B
Admirn 2009.02.01,929,1,1,9,50,56,6,A
Admirn 2009.02.01,929,1,1,9,61,56,-5,B
calexander 2008.12.26,979,1,1,5,215,20,-195,A
calexander 2008.12.26,979,1,1,5,223,20,-203,B
tkfmffmdml 2008.12.26,949,1,0,4,284,25,-259,A
tkfmffmdml 2008.12.26,949,1,0,4,280,25,-255,B
Fukiyama 2009.02.24,1031,1,1,13,153,15,-138,A
Fukiyama 2009.02.24,1031,1,1,13,129,23,-106,B
elnekave 2009.02.24,916,1,0,12,149,25,-124,A
elnekave 2009.02.24,916,1,0,12,132,25,-107,B
EgyVoltron 2009.01.30,1163,1,0,13,368,31,-337,A
EgyVoltron 2009.01.30,1163,1,0,13,388,31,-357,B
deeprince 2009.01.30,801,2,2,23,101,43,-58,A
deeprince 2009.01.30,801,2,2,23,81,48,-33,B
Sebbel 2008.08.05,839,1,1,16,77,38,-39,A
Sebbel 2008.08.05,839,1,1,16,48,38,-10,B
Sinickas 2008.08.05,973,1,0,16,120,25,-95,A
Sinickas 2008.08.05,973,1,0,16,122,19,-103,B
Crashinator 2009.02.20,903,1,1,20,228,25,-203,A
Crashinator 2009.02.20,903,1,1,20,240,25,-215,B
Admirn 2009.02.20,974,1,0,20,299,15,-284,A
Admirn 2009.02.20,974,1,0,20,301,15,-286,B
JackPacman 2009.01.30,964,1,0,16,212,31,-181,A
JackPacman 2009.01.30,964,1,0,16,237,25,-212,B
nicksun 2009.01.30,1030,1,1,13,303,15,-288,A
nicksun 2009.01.30,1030,1,1,13,222,8,-214,B
munon 2009.01.29,993,1,1,43,78,37,-41,A
munon 2009.01.29,993,1,1,43,84,33,-51,B
luoyun 2009.01.29,864,1,0,43,81,42,-39,A
luoyun 2009.01.29,864,1,0,43,131,33,-98,B
gforced 2009.02.09,947,1,1,9,88,56,-32,A
gforced 2009.02.09,947,1,1,9,78,44,-34,B
jaydottaylor 2009.01.24,961,1,1,44,163,32,-131,A
jaydottaylor 2009.01.24,961,1,1,44,154,30,-124,B
minhhuan 2009.01.24,1027,1,0,45,229,18,-211,A
minhhuan 2009.01.24,1027,1,0,45,223,18,-205,B
JooBoo 2009.02.04,916,1,1,8,36,62,26,A
JooBoo 2009.02.04,916,1,1,8,43,62,19,B
majesticmagix 2009.01.30,1101,1,0,19,256,26,-230,A
majesticmagix 2009.01.30,1101,1,0,19,256,26,-230,B
geodezu 2009.01.18,980,1,0.5,23,124,26,-98,A
geodezu 2009.01.18,980,1,0.5,23,115,30,-85,B
JohntheChristian 2009.01.18,1014,1,0.5,22,90,36,-54,A
JohntheChristian 2009.01.18,1014,1,0.5,22,85,27,-58,B
Awais 2009.02.01,992,2,2,40,205,32,-173,A
Awais 2009.02.01,992,2,2,40,209,38,-171,B
caskakacastro 2009.01.27,935,1,0,16,277,31,-246,A
caskakacastro 2009.01.27,935,1,0,16,220,31,-189,B
nicksun 2009.01.27,1024,1,1,15,232,40,-192,A
nicksun 2009.01.27,1024,1,1,15,212,40,-172,B
Sebbel 2008.10.20,970,1,1,21,60,48,-12,A
Sebbel 2008.10.20,970,1,1,21,57,48,-9,B
JabZ 2008.10.20,927,1,0,20,98,25,-73,A
JabZ 2008.10.20,927,1,0,20,100,25,-75,B
skiparooni 2009.02.02,1059,1,0,31,200,45,-155,A
skiparooni 2009.02.02,1059,1,0,31,205,39,-166,B
DREZIO 2009.02.02,876,1,1,29,138,38,-100,A
DREZIO 2009.02.02,876,1,1,29,152,34,-118,B
Miggidy 2009.01.27,1158,1,1,8,86,62,-24,A
Miggidy 2009.01.27,1158,1,1,8,97,62,-35,B
Traenexx 2009.01.27,833,2,0,40,328,20,-308,A
Traenexx 2009.01.27,833,2,0,40,302,23,-279,B
gorkietalkie 2009.01.27,1100,1,1,31,304,29,-275,A
gorkietalkie 2009.01.27,1100,1,1,31,276,26,-250,B
OBAMAnyofacebitch 2009.01.22,1131,1,1,6,41,50,9,A
OBAMAnyofacebitch 2009.01.22,1131,1,1,6,90,17,-73,B
geodezu 2009.01.24,942,1,1,22,127,50,-77,A
geodezu 2009.01.24,942,1,1,22,115,59,-56,B
geodezu 2009.01.24,942,1,1,22,124,54,-70,C
vawaverunner 2009.01.24,1018,1,0,22,225,27,-198,A
vawaverunner 2009.01.24,1018,1,0,22,154,32,-122,B
vawaverunner 2009.01.24,1018,1,0,22,209,27,-182,C
nicksun 2009.01.23,984,1,0,17,292,18,-274,A
nicksun 2009.01.23,984,1,0,17,281,18,-263,B
kiwa 2009.01.23,993,1,1,14,159,43,-116,A
kiwa 2009.01.23,993,1,1,14,137,43,-94,B
sekulla 2009.01.22,958,1,0,11,270,18,-252,A
sekulla 2009.01.22,958,1,0,11,267,18,-249,B
Awais 2009.01.22,989,1,1,13,288,31,-257,A
Awais 2009.01.22,989,1,1,13,294,23,-271,B
Malfunction 2009.04.17,1081,2,1,25,232,24,-208,A
Malfunction 2009.04.17,1081,2,1,25,269,20,-249,B
jdchopra 2009.04.17,835,7,4,98,193,33,-160,A
jdchopra 2009.04.17,835,7,4,98,200,32,-168,B
rsrdjan 2009.07.26,999,1,1,15,85,27,-58,A
rsrdjan 2009.07.26,999,1,1,15,73,40,-33,B
nathy 2009.07.26,746,1,0,15,158,40,-118,A
nathy 2009.07.26,746,1,0,15,154,33,-121,B
Booyens 2009.07.03,982,3,0,34,368,15,-353,A
Booyens 2009.07.03,982,3,0,34,358,15,-343,B
GoGoYubari 2009.07.03,968,3,3,28,223,21,-202,A
GoGoYubari 2009.07.03,968,3,3,28,210,21,-189,B
Dlegend 2009.06.24,901,3,1,46,248,30,-218,A
Dlegend 2009.06.24,901,3,1,46,246,35,-211,B
borovo 2009.06.24,1040,3,2,46,279,30,-249,A
borovo 2009.06.24,1040,3,2,46,275,30,-245,B
natenael 2009.04.17,835,1,0,18,379,0,-379,A
natenael 2009.04.17,835,1,0,18,315,0,-315,B
SassySasha 2009.04.06,1039,1,1,19,215,16,-199,A
SassySasha 2009.04.06,1039,1,1,19,190,16,-174,B
elnekave 2009.04.06,884,1,0,22,376,27,-349,A
elnekave 2009.04.06,884,1,0,22,373,27,-346,B
Hazardo 2009.07.14,958,2,0,26,327,38,-289,A
Hazardo 2009.07.14,958,2,0,26,305,35,-270,B
Dicemice 2009.07.14,1026,2,2,24,186,25,-161,A
Dicemice 2009.07.14,1026,2,2,24,188,21,-167,B
SimSima 2007.01.31,962,1,1,21,151,52,-99,A
SimSima 2007.01.31,962,1,1,21,128,57,-71,B
SimSima 2007.01.31,962,1,1,21,114,57,-57,C
Jia 2007.01.31,1001,1,0,26,178,23,-155,A
Jia 2007.01.31,1001,1,0,26,163,27,-136,B
Jia 2007.01.31,1001,1,0,26,198,27,-171,C
Lelouchshinji 2009.06.24,869,2,0,12,367,33,-334,A
Lelouchshinji 2009.06.24,869,2,0,12,353,42,-311,B
dhally 2009.06.24,1152,1,1,4,134,50,-84,A
dhally 2009.06.24,1152,1,1,4,125,50,-75,B
Naym 2009.04.03,863,2,1,69,117,30,-87,A
Naym 2009.04.03,863,2,1,69,119,36,-83,B
gaangster 2009.04.03,1111,1,0,19,233,26,-207,A
gaangster 2009.04.03,1111,1,0,19,240,16,-224,B
badstep 2009.04.17,996,1,0,9,367,0,-367,A
badstep 2009.04.17,996,1,0,9,422,0,-422,B
MartyMcFlyyy 2009.04.14,1072,1,0,8,69,50,-19,A
MartyMcFlyyy 2009.04.14,1072,1,0,8,172,50,-122,B
chokefetuschoke 2009.04.14,907,1,1,14,258,29,-229,A
chokefetuschoke 2009.04.14,907,1,1,14,268,21,-247,B
NomadicEntropy 2009.04.07,873,2,0,23,359,17,-342,A
NomadicEntropy 2009.04.07,873,2,0,23,370,13,-357,B
herbkleiman 2009.04.07,1075,2,2,20,220,40,-180,A
herbkleiman 2009.04.07,1075,2,2,20,237,35,-202,B
Booyens 2009.07.25,970,3,0.5,60,156,33,-123,A
Booyens 2009.07.25,970,3,0.5,60,150,28,-122,B
andrejas 2009.07.25,969,3,2.5,58,175,40,-135,A
andrejas 2009.07.25,969,3,2.5,58,172,38,-134,B
GodsWrath 2009.04.17,1006,1,1,12,62,58,-4,A
GodsWrath 2009.04.17,1006,1,1,12,69,58,-11,B
badstep 2009.04.12,988,1,0.5,8,230,25,-205,A
badstep 2009.04.12,988,1,0.5,8,242,38,-204,B
petitwinnie 2009.04.12,1064,2,0.5,21,369,14,-355,A
petitwinnie 2009.04.12,1064,2,0.5,21,390,19,-371,B
Avisharv 2009.04.18,944,1,0,40,340,15,-325,A
Avisharv 2009.04.18,944,1,0,40,350,20,-330,B
jdchopra 2009.04.18,1003,1,1,34,190,41,-149,A
jdchopra 2009.04.18,1003,1,1,34,194,41,-153,B
thefourthhorseman 2009.04.13,990,1,0,11,242,27,-215,A
thefourthhorseman 2009.04.13,990,1,0,11,259,27,-232,B
chessboyjazz 2009.04.13,995,1,1,9,179,67,-112,A
chessboyjazz 2009.04.13,995,1,1,9,175,56,-119,B
jdchopra 2009.04.19,1072,1,1,20,145,25,-120,A
jdchopra 2009.04.19,1072,1,1,20,137,25,-112,B
Astronomas 2009.04.19,917,1,0,19,179,16,-163,A
Astronomas 2009.04.19,917,1,0,19,169,16,-153,B
Hazardo 2009.07.31,906,1,0,13,254,38,-216,A
Hazardo 2009.07.31,906,1,0,13,224,23,-201,B
badstep 2009.07.31,1027,1,1,15,367,13,-354,A
badstep 2009.07.31,1027,1,1,15,320,7,-313,B
stota 2009.07.29,927,1,0,35,199,23,-176,A
stota 2009.07.29,927,1,0,35,190,20,-170,B
SimonDedalus 2009.07.29,1061,1,1,34,204,15,-189,A
SimonDedalus 2009.07.29,1061,1,1,34,194,12,-182,B
SecondQueen 2009.07.28,1197,2,2,9,78,33,-45,A
SecondQueen 2009.07.28,1197,2,2,9,74,33,-41,B
Loran 2009.07.28,791,2,0,11,178,18,-160,A
Loran 2009.07.28,791,2,0,11,197,9,-188,B
nathy 2009.07.25,756,3,0,48,154,31,-123,A
nathy 2009.07.25,756,3,0,48,144,31,-113,B
maramures 2009.07.25,1010,3,3,42,127,31,-96,A
maramures 2009.07.25,1010,3,3,42,119,29,-90,B
Loran 2009.07.24,782,1,0.5,21,184,43,-141,A
Loran 2009.07.24,782,1,0.5,21,199,43,-156,B
Cgrittz 2009.07.24,1161,1,0.5,20,157,30,-127,A
Cgrittz 2009.07.24,1161,1,0.5,20,150,30,-120,B
nathy 2009.07.20,835,4,0,33,333,15,-318,A
nathy 2009.07.20,835,4,0,33,352,15,-337,B
chessboyjazz 2009.07.20,1050,1,1,6,58,50,-8,A
chessboyjazz 2009.07.20,1050,1,1,6,42,50,8,B
dubaddict 2009.04.17,893,2,0,31,212,23,-189,A
dubaddict 2009.04.17,893,2,0,31,214,16,-198,B
Hazardo 2009.04.17,934,1,1,9,107,33,-74,A
Hazardo 2009.04.17,934,1,1,9,105,33,-72,B
Traenexx 2009.04.11,880,1,1,23,318,22,-296,A
Traenexx 2009.04.11,880,1,1,23,305,22,-283,B
chesseeka 2009.04.11,1017,1,0,20,210,20,-190,A
chesseeka 2009.04.11,1017,1,0,20,188,20,-168,B
JHLD 2009.07.29,1057,2,2,33,99,45,-54,A
JHLD 2009.07.29,1057,2,2,33,93,46,-47,B
Loran 2009.07.29,782,2,0,42,197,24,-173,A
Loran 2009.07.29,782,2,0,42,195,12,-183,B
LavAzza 2009.07.29,760,2,1,28,186,29,-157,A
LavAzza 2009.07.29,760,2,1,28,201,25,-176,B
GoGoYubari 2009.07.29,1070,2,1,28,208,29,-179,A
GoGoYubari 2009.07.29,1070,2,1,28,209,29,-180,B
robocoop 2009.04.16,1048,1,1,6,110,17,-93,A
robocoop 2009.04.16,1048,1,1,6,72,33,-39,B
jdchopra 2009.04.16,875,1,0,8,348,25,-323,A
jdchopra 2009.04.16,875,1,0,8,339,25,-314,B
LisbonNightTrain 2009.04.13,983,1,1,34,69,38,-31,A
LisbonNightTrain 2009.04.13,983,1,1,34,69,35,-34,B
gilandrew 2009.04.13,912,1,0,36,133,25,-108,A
gilandrew 2009.04.13,912,1,0,36,140,25,-115,B
Flupkes 2009.04.17,1101,1,1,12,165,42,-123,A
Flupkes 2009.04.17,1101,1,1,12,166,33,-133,B
Hazardo 2009.04.16,913,1,1,5,54,60,6,A
Hazardo 2009.04.16,913,1,1,5,32,60,28,B
ukpfc 2009.04.16,866,1,0,5,337,20,-317,A
ukpfc 2009.04.16,866,1,0,5,314,20,-294,B
gameplan 2009.04.12,1143,1,1,9,116,44,-72,A
gameplan 2009.04.12,1143,1,1,9,112,44,-68,B
Drewan 2009.04.12,810,2,1,16,100,44,-56,A
Drewan 2009.04.12,810,2,1,16,114,38,-76,B
Fnorgmuffin 2009.04.08,772,1,0,10,263,10,-253,A
Fnorgmuffin 2009.04.08,772,1,0,10,240,20,-220,B
Jia 2009.04.08,1142,1,1,9,158,22,-136,A
Jia 2009.04.08,1142,1,1,9,147,22,-125,B
nathy 2009.07.28,734,1,0,22,337,18,-319,A
nathy 2009.07.28,734,1,0,22,333,18,-315,B
andrejas 2009.07.28,964,1,1,15,297,47,-250,A
andrejas 2009.07.28,964,1,1,15,296,33,-263,B
DaveMiddled 2009.04.13,900,1,1,12,59,33,-26,A
DaveMiddled 2009.04.13,900,1,1,12,61,33,-28,B
Crashinator 2009.04.13,1006,1,0,12,147,42,-105,A
Crashinator 2009.04.13,1006,1,0,12,180,25,-155,B
sterum 2009.04.12,1124,1,1,48,107,40,-67,A
sterum 2009.04.12,1124,1,1,48,100,38,-62,B
Fnorgmuffin 2009.04.12,734,1,0,53,171,40,-131,A
Fnorgmuffin 2009.04.12,734,1,0,53,183,42,-141,B
Crashinator 2009.04.08,980,1,1,6,178,17,-161,A
Crashinator 2009.04.08,980,1,1,6,151,17,-134,B
chessboyjazz 2009.04.08,991,1,0,7,363,29,-334,A
chessboyjazz 2009.04.08,991,1,0,7,347,14,-333,B
markhodges 2009.04.09,1137,1,1,21,172,33,-139,A
markhodges 2009.04.09,1137,1,1,21,137,33,-104,B
Fnorgmuffin 2009.04.09,757,1,0,21,196,29,-167,A
Fnorgmuffin 2009.04.09,757,1,0,21,151,29,-122,B
robertpmntr 2009.04.07,1031,1,0,25,152,20,-132,A
robertpmntr 2009.04.07,1031,1,0,25,142,28,-114,B
Akio 2009.04.07,925,1,1,21,75,48,-27,A
Akio 2009.04.07,925,1,1,21,65,43,-22,B
Waggaristo 2009.04.13,1070,1,0,30,153,30,-123,A
Waggaristo 2009.04.13,1070,1,0,30,153,37,-116,B
insanemew 2009.04.13,918,1,1,28,91,32,-59,A
insanemew 2009.04.13,918,1,1,28,94,36,-58,B
tigerblue 2009.04.05,1154,1,1,7,70,43,-27,A
tigerblue 2009.04.05,1154,1,1,7,79,29,-50,B
fjjvh 2009.04.05,660,1,0,7,261,0,-261,A
fjjvh 2009.04.05,660,1,0,7,285,0,-285,B
cjmaeder 2009.04.04,754,1,1,22,212,27,-185,A
cjmaeder 2009.04.04,754,1,1,22,235,27,-208,B
Mrachni 2009.04.04,1040,1,0,22,277,18,-259,A
Mrachni 2009.04.04,1040,1,0,22,282,18,-264,B
ktinfl 2009.07.27,863,1,1,13,118,15,-103,A
ktinfl 2009.07.27,863,1,1,13,116,31,-85,B
Bmoresoldier 2009.07.27,967,1,0,16,294,19,-275,A
Bmoresoldier 2009.07.27,967,1,0,16,354,12,-342,B
fjjvh 2009.04.02,669,2,0.5,25,437,4,-433,A
fjjvh 2009.04.02,669,2,0.5,25,426,4,-422,B
tigerblue 2009.04.02,1152,1,1,6,300,17,-283,A
tigerblue 2009.04.02,1152,1,1,6,329,17,-312,B
catfu 2009.07.31,1024,1,1,21,191,38,-153,A
catfu 2009.07.31,1024,1,1,21,205,33,-172,B
ANDYTASTIC 2009.07.31,969,1,0,17,189,41,-148,A
ANDYTASTIC 2009.07.31,969,1,0,17,120,35,-85,B
stota 2009.07.30,915,1,0,32,140,31,-109,A
stota 2009.07.30,915,1,0,32,140,31,-109,B
gasparegg 2009.07.30,1052,1,1,31,100,39,-61,A
gasparegg 2009.07.30,1052,1,1,31,97,39,-58,B
chmpf 2009.04.02,939,1,0.5,7,143,43,-100,A
chmpf 2009.04.02,939,1,0.5,7,153,43,-110,B
Hazardo 2009.07.30,905,1,0,12,171,25,-146,A
Hazardo 2009.07.30,905,1,0,12,154,25,-129,B
smalldreams 2009.07.30,1028,2,2,17,157,35,-122,A
smalldreams 2009.07.30,1028,2,2,17,155,41,-114,B
nathy 2009.07.29,741,1,0,5,309,20,-289,A
nathy 2009.07.29,741,1,0,5,306,20,-286,B
paderboots 2009.07.29,879,1,1,4,84,50,-34,A
paderboots 2009.07.29,879,1,1,4,118,25,-93,B
krishnak 2009.04.03,1128,1,1,50,111,34,-77,A
krishnak 2009.04.03,1128,1,1,50,106,36,-70,B
Bhunt 2009.07.20,1091,1,1,7,343,29,-314,A
Bhunt 2009.07.20,1091,1,1,7,231,29,-202,B
stota 2009.07.16,973,1,0,9,264,33,-231,A
stota 2009.07.16,973,1,0,9,284,22,-262,B
BadfishToo 2009.07.16,1022,1,1,6,50,33,-17,A
BadfishToo 2009.07.16,1022,1,1,6,61,50,-11,B
nathy 2009.07.21,802,7,0,80,289,16,-273,A
nathy 2009.07.21,802,7,0,80,266,21,-245,B
LaurentDelaon 2009.07.21,1051,1,1,6,293,33,-260,A
LaurentDelaon 2009.07.21,1051,1,1,6,260,33,-227,B
Drvanger 2009.07.20,1064,1,0,31,142,29,-113,A
Drvanger 2009.07.20,1064,1,0,31,130,29,-101,B
SoloBaric 2009.07.20,931,1,1,39,280,28,-252,A
SoloBaric 2009.07.20,931,1,1,39,290,28,-262,B
nathy 2009.07.17,976,4,0,59,263,29,-234,A
nathy 2009.07.17,976,4,0,59,266,24,-242,B
wbartlett 2009.07.17,1059,1,1,4,48,75,27,A
wbartlett 2009.07.17,1059,1,1,4,76,75,-1,B
ANDYTASTIC 2009.07.30,990,2,1,49,244,24,-220,A
ANDYTASTIC 2009.07.30,990,2,1,49,235,20,-215,B
scoroyale 2009.07.30,851,1,1,24,133,37,-96,A
scoroyale 2009.07.30,851,1,1,24,120,29,-91,B
nathy 2009.07.19,879,6,0,85,265,19,-246,A
nathy 2009.07.19,879,6,0,85,261,21,-240,B
Sirenus 2009.07.19,1082,1,1,5,84,60,-24,A
Sirenus 2009.07.19,1082,1,1,5,84,60,-24,B
LavAzza 2009.07.11,874,1,0,15,515,7,-508,A
LavAzza 2009.07.11,874,1,0,15,503,20,-483,B
GoGoYubari 2009.07.11,1025,2,1,19,369,32,-337,A
GoGoYubari 2009.07.11,1025,2,1,19,348,32,-316,B
projectlife 2009.06.23,973,1,0,17,276,18,-258,A
projectlife 2009.06.23,973,1,0,17,283,24,-259,B
vincentkellner 2009.06.23,940,1,1,15,189,33,-156,A
vincentkellner 2009.06.23,940,1,1,15,193,33,-160,B
nathy 2009.07.30,750,1,0,7,405,0,-405,A
nathy 2009.07.30,750,1,0,7,390,0,-390,B
stota 2009.07.28,929,1,0,8,131,25,-106,A
stota 2009.07.28,929,1,0,8,145,25,-120,B
Bhunt 2009.07.28,1051,1,1,9,239,22,-217,A
Bhunt 2009.07.28,1051,1,1,9,246,22,-224,B
Traenexx 2009.04.05,884,1,0,13,116,38,-78,A
Traenexx 2009.04.05,884,1,0,13,132,31,-101,B
richsilver 2009.04.05,1105,1,1,12,148,50,-98,A
richsilver 2009.04.05,1105,1,1,12,144,50,-94,B
Gleelee 2009.07.24,1208,1,1,42,136,31,-105,A
Gleelee 2009.07.24,1208,1,1,42,140,31,-109,B
xDieInAFirex 2009.07.24,693,3,0,67,224,25,-199,A
xDieInAFirex 2009.07.24,693,3,0,67,217,27,-190,B
lhoward 2009.07.19,1075,2,2,24,49,42,-7,A
lhoward 2009.07.19,1075,2,2,24,56,33,-23,B
Loran 2009.07.15,795,4,0,50,242,16,-226,A
Loran 2009.07.15,795,4,0,50,230,18,-212,B
catfu 2009.07.15,1086,2,2,28,109,43,-66,A
catfu 2009.07.15,1086,2,2,28,114,46,-68,B
Mels 2009.06.11,1053,1,0,10,319,10,-309,A
Mels 2009.06.11,1053,1,0,10,317,10,-307,B
HeliosMax 2009.06.11,907,3,2,43,221,23,-198,A
HeliosMax 2009.06.11,907,3,2,43,215,26,-189,B
Fukiyama 2009.06.09,1037,1,1,11,235,9,-226,A
Fukiyama 2009.06.09,1037,1,1,11,226,9,-217,B
Kundeohmar 2009.06.09,939,1,0,11,301,18,-283,A
Kundeohmar 2009.06.09,939,1,0,11,282,27,-255,B
Rastaluke 2009.06.02,729,2,0,61,210,31,-179,A
Rastaluke 2009.06.02,729,2,0,61,222,23,-199,B
JAYDENBLANE 2009.06.02,1137,2,2,59,158,25,-133,A
JAYDENBLANE 2009.06.02,1137,2,2,59,157,29,-128,B
stota 2009.07.31,907,1,1,16,113,56,-57,A
stota 2009.07.31,907,1,1,16,86,50,-36,B
scoroyale 2009.07.31,1002,1,0,18,261,22,-239,A
scoroyale 2009.07.31,1002,1,0,18,262,28,-234,B
smalldreams 2009.07.31,1048,1,1,7,91,57,-34,A
smalldreams 2009.07.31,1048,1,1,7,71,57,-14,B
nathy 2009.07.31,757,1,0,12,297,0,-297,A
nathy 2009.07.31,757,1,0,12,283,0,-283,B
smalldreams 2009.07.27,1029,3,2,48,126,46,-80,A
smalldreams 2009.07.27,1029,3,2,48,137,42,-95,B
Hazardo 2009.07.27,913,2,0,20,298,10,-288,A
Hazardo 2009.07.27,913,2,0,20,305,10,-295,B
stota 2009.07.26,916,3,1,41,209,27,-182,A
stota 2009.07.26,916,3,1,41,190,34,-156,B
woodpuscher 2009.07.26,1064,2,2,12,54,42,-12,A
woodpuscher 2009.07.26,1064,2,2,12,62,42,-20,B
chokefetuschoke 2009.07.22,911,1,0,34,267,21,-246,A
chokefetuschoke 2009.07.22,911,1,0,34,272,18,-254,B
ifuwurarabitidnmu 2009.07.22,936,1,1,35,296,20,-276,A
ifuwurarabitidnmu 2009.07.22,936,1,1,35,299,14,-285,B
nathy 2009.07.22,774,4,0,50,394,20,-374,A
nathy 2009.07.22,774,4,0,50,358,14,-344,B
RyanBall 2009.07.22,1030,1,1,12,371,8,-363,A
RyanBall 2009.07.22,1030,1,1,12,451,8,-443,B
LavAzza 2009.07.13,802,1,0,18,313,22,-291,A
LavAzza 2009.07.13,802,1,0,18,285,28,-257,B
GoGoYubari 2009.07.13,1033,1,1,17,139,47,-92,A
GoGoYubari 2009.07.13,1033,1,1,17,154,47,-107,B
franzgabo 2009.06.14,923,1,0,8,88,50,-38,A
franzgabo 2009.06.14,923,1,0,8,86,50,-36,B
yaroshan 2009.06.14,1074,1,1,7,27,43,16,A
yaroshan 2009.06.14,1074,1,1,7,31,29,-2,B
mcco 2009.07.30,1003,1,0,21,192,33,-159,A
mcco 2009.07.30,1003,1,0,21,199,33,-166,B
stota 2009.07.24,929,1,0,11,231,27,-204,A
stota 2009.07.24,929,1,0,11,210,36,-174,B
openmyeyes 2009.07.24,1041,1,1,10,264,10,-254,A
openmyeyes 2009.07.24,1041,1,1,10,247,10,-237,B
stota 2009.07.27,919,1,1,28,128,54,-74,A
stota 2009.07.27,919,1,1,28,127,54,-73,B
stota 2009.07.27,919,1,1,28,116,57,-59,C
badstep 2009.07.26,1077,1,0,29,247,34,-213,A
badstep 2009.07.26,1077,1,0,29,221,34,-187,B
RichardJohnson 2009.07.24,1261,2,2,26,232,27,-205,A
RichardJohnson 2009.07.24,1261,2,2,26,223,23,-200,B
sigggih 2009.07.22,1024,1,1,8,66,50,-16,A
sigggih 2009.07.22,1024,1,1,8,48,50,2,B
dafics 2009.07.21,1099,1,1,9,87,33,-54,A
dafics 2009.07.21,1099,1,1,9,87,33,-54,B
jpirie 2009.07.20,1059,1,1,4,192,25,-167,A
jpirie 2009.07.20,1059,1,1,4,121,25,-96,B
Booyens 2009.07.26,951,2,0,18,298,22,-276,A
Booyens 2009.07.26,951,2,0,18,286,17,-269,B
andrejas 2009.07.26,979,2,2,14,163,36,-127,A
andrejas 2009.07.26,979,2,2,14,167,36,-131,B
OrionsDog 2009.07.22,927,1,1,10,108,10,-98,A
OrionsDog 2009.07.22,927,1,1,10,75,40,-35,B
Demolishor 2009.07.22,1056,1,0,11,247,27,-220,A
Demolishor 2009.07.22,1056,1,0,11,243,27,-216,B
Drvanger 2009.07.19,1024,1,1,18,217,28,-189,A
Drvanger 2009.07.19,1024,1,1,18,213,28,-185,B
Hazardo 2009.07.16,940,1,0.5,4,62,50,-12,A
Hazardo 2009.07.16,940,1,0.5,4,92,25,-67,B
nathy 2009.07.16,954,1,0.5,4,307,50,-257,A
nathy 2009.07.16,954,1,0.5,4,312,50,-262,B
btbkorg 2009.07.11,869,1,0,4,215,50,-165,A
btbkorg 2009.07.11,869,1,0,4,228,50,-178,B
kylekyle 2009.07.11,1033,1,1,4,53,75,22,A
kylekyle 2009.07.11,1033,1,1,4,73,75,2,B
ziglag 2009.07.04,1184,1,1,6,52,33,-19,A
ziglag 2009.07.04,1184,1,1,6,52,33,-19,B
Loran 2009.07.04,803,1,0,6,156,0,-156,A
Loran 2009.07.04,803,1,0,6,138,17,-121,B
petsocietyrocks 2009.06.24,1249,4,2.5,125,171,31,-140,A
petsocietyrocks 2009.06.24,1249,4,2.5,125,177,30,-147,B
dahuigou 2009.06.24,706,4,1.5,130,225,30,-195,A
dahuigou 2009.06.24,706,4,1.5,130,223,25,-198,B
GoGoYubari 2009.06.05,974,1,0,13,202,46,-156,A
GoGoYubari 2009.06.05,974,1,0,13,186,62,-124,B
Avisharv 2009.06.05,964,1,1,8,263,37,-226,A
Avisharv 2009.06.05,964,1,1,8,242,38,-204,B
PieceMover 2009.07.21,1117,2,2,14,68,43,-25,A
PieceMover 2009.07.21,1117,2,2,14,81,36,-45,B
Dicemice 2009.07.21,1055,1,1,9,187,22,-165,A
Dicemice 2009.07.21,1055,1,1,9,221,22,-199,B
GoGoYubari 2009.07.17,1103,1,1,10,190,30,-160,A
GoGoYubari 2009.07.17,1103,1,1,10,173,30,-143,B
MikEms 2009.07.12,957,1,1,7,121,14,-107,A
MikEms 2009.07.12,957,1,1,7,99,29,-70,B
GoGoYubari 2009.07.12,1018,1,0,7,288,29,-259,A
GoGoYubari 2009.07.12,1018,1,0,7,282,29,-253,B
Jia 2009.06.28,951,1,1,5,148,60,-88,A
Jia 2009.06.28,951,1,1,5,151,60,-91,B
antharas 2009.06.28,982,1,0,5,483,0,-483,A
antharas 2009.06.28,982,1,0,5,464,0,-464,B
Loran 2009.06.26,870,5,0,51,354,12,-342,A
Loran 2009.06.26,870,5,0,51,377,12,-365,B
jcizzle 2009.06.26,1096,1,1,9,153,33,-120,A
jcizzle 2009.06.26,1096,1,1,9,157,33,-124,B
jpirie 2009.07.22,1147,1,1,10,162,30,-132,A
jpirie 2009.07.22,1147,1,1,10,206,10,-196,B
Alphacentury 2009.07.15,1155,2,2,17,130,41,-89,A
Alphacentury 2009.07.15,1155,2,2,17,112,41,-71,B
Bhunt 2009.07.21,1073,1,1,16,70,38,-32,A
Bhunt 2009.07.21,1073,1,1,16,65,50,-15,B
raysfan 2009.07.22,1069,1,1,13,193,31,-162,A
raysfan 2009.07.22,1069,1,1,13,204,23,-181,B
lousychess 2009.07.20,1094,1,1,8,296,37,-259,A
lousychess 2009.07.20,1094,1,1,8,196,38,-158,B
Operatics 2009.07.17,1071,1,1,18,149,39,-110,A
Operatics 2009.07.17,1071,1,1,18,151,39,-112,B
smalldreams 2009.07.19,1013,2,2,28,276,18,-258,A
smalldreams 2009.07.19,1013,2,2,28,279,18,-261,B
ktinfl 2009.07.23,846,1,1,18,168,33,-135,A
ktinfl 2009.07.23,846,1,1,18,172,28,-144,B
ZfromDtownCO 2009.07.23,1110,1,0,19,242,21,-221,A
ZfromDtownCO 2009.07.23,1110,1,0,19,225,26,-199,B
IOOOOOWelcomesWeb 2009.07.21,1041,1,1,15,124,47,-77,A
IOOOOOWelcomesWeb 2009.07.21,1041,1,1,15,122,47,-75,B
vincentkellner 2009.06.24,1130,1,1,7,282,29,-253,A
vincentkellner 2009.06.24,1130,1,1,7,271,43,-228,B
Fukiyama 2009.06.29,1014,1,0,14,201,43,-158,A
Fukiyama 2009.06.29,1014,1,0,14,192,36,-156,B
antharas 2009.06.29,976,1,1,12,105,58,-47,A
antharas 2009.06.29,976,1,1,12,89,58,-31,B
sarabande 2009.07.01,1131,1,1,5,190,40,-150,A
sarabande 2009.07.01,1131,1,1,5,144,40,-104,B
Loran 2009.07.01,811,1,0,5,270,20,-250,A
Loran 2009.07.01,811,1,0,5,221,0,-221,B
Booyens 2009.07.09,946,1,1,5,467,20,-447,A
Booyens 2009.07.09,946,1,1,5,483,40,-443,B
loyadrummer 2009.07.09,968,1,0,5,704,0,-704,A
loyadrummer 2009.07.09,968,1,0,5,731,0,-731,B
SassySasha 2009.06.26,1093,3,3,14,48,43,-5,A
SassySasha 2009.06.26,1093,3,3,14,35,50,15,B
PieceMover 2009.06.25,1059,1,1,13,262,31,-231,A
PieceMover 2009.06.25,1059,1,1,13,246,38,-208,B
SviSe 2009.06.25,831,1,0,16,517,13,-504,A
SviSe 2009.06.25,831,1,0,16,461,12,-449,B
Rhizy 2009.07.09,874,1,1,22,126,36,-90,A
Rhizy 2009.07.09,874,1,1,22,125,36,-89,B
sigggih 2009.07.09,1123,1,0,23,204,39,-165,A
sigggih 2009.07.09,1123,1,0,23,207,35,-172,B
Fukiyama 2009.06.26,1021,1,1,15,291,27,-264,A
Fukiyama 2009.06.26,1021,1,1,15,312,27,-285,B
robertpmntr 2009.06.14,1093,1,1,24,180,42,-138,A
robertpmntr 2009.06.14,1093,1,1,24,176,42,-134,B
robertpmntr 2009.06.14,1093,1,1,24,196,38,-158,C
paderboots 2009.06.14,887,1,0,23,172,48,-124,A
paderboots 2009.06.14,887,1,0,23,178,56,-122,B
paderboots 2009.06.14,887,1,0,23,191,56,-135,C
Rhizy 2009.07.17,968,1,1,13,98,46,-52,A
Rhizy 2009.07.17,968,1,1,13,92,38,-54,B
Bmoresoldier 2009.06.22,934,1,0,36,411,19,-392,A
Bmoresoldier 2009.06.22,934,1,0,36,412,17,-395,B
zqnzt 2009.06.22,1032,1,1,30,368,23,-345,A
zqnzt 2009.06.22,1032,1,1,30,337,20,-317,B
Buildingwings 2009.07.04,1064,1,1,13,133,31,-102,A
Buildingwings 2009.07.04,1064,1,1,13,134,31,-103,B
masif 2009.07.04,822,1,0,14,240,14,-226,A
masif 2009.07.04,822,1,0,14,239,7,-232,B
chmpf 2009.07.03,984,1,0,7,138,14,-124,A
chmpf 2009.07.03,984,1,0,7,142,14,-128,B
Xoppo 2009.07.03,941,1,1,7,3,86,83,A
Xoppo 2009.07.03,941,1,1,7,10,86,76,B
elpascoe 2009.06.22,992,1,1,14,147,36,-111,A
elpascoe 2009.06.22,992,1,1,14,178,29,-149,B
PieceMover 2009.06.22,973,2,1,18,191,39,-152,A
PieceMover 2009.06.22,973,2,1,18,195,33,-162,B
HeliosMax 2009.06.14,893,1,0,20,146,30,-116,A
HeliosMax 2009.06.14,893,1,0,20,160,35,-125,B
ToomuchforUtoo 2009.06.14,1101,1,1,19,127,16,-111,A
ToomuchforUtoo 2009.06.14,1101,1,1,19,105,21,-84,B
MikEms 2009.07.11,805,1,1,9,345,22,-323,A
MikEms 2009.07.11,805,1,1,9,301,44,-257,B
robertpmntr 2009.07.04,1118,1,1,10,123,30,-93,A
robertpmntr 2009.07.04,1118,1,1,10,144,30,-114,B
ktinfl 2009.07.04,866,1,0,12,296,17,-279,A
ktinfl 2009.07.04,866,1,0,12,325,17,-308,B
HeliosMax 2009.06.30,866,1,1,44,97,48,-49,A
HeliosMax 2009.06.30,866,1,1,44,103,43,-60,B
robertpmntr 2009.06.30,1106,1,0,45,142,33,-109,A
robertpmntr 2009.06.30,1106,1,0,45,149,22,-127,B
GoGoYubari 2009.07.10,1009,1,1,17,309,29,-280,A
GoGoYubari 2009.07.10,1009,1,1,17,319,29,-290,B
MikEms 2009.07.10,885,1,0,18,238,56,-182,A
MikEms 2009.07.10,885,1,0,18,260,44,-216,B
vpma 2009.07.15,1037,1,0,11,257,9,-248,A
vpma 2009.07.15,1037,1,0,11,230,9,-221,B
BadfishToo 2009.07.15,874,1,1,7,99,57,-42,A
BadfishToo 2009.07.15,874,1,1,7,94,57,-37,B
ToomuchforUtoo 2009.06.21,1111,1,1,5,266,40,-226,A
ToomuchforUtoo 2009.06.21,1111,1,1,5,302,40,-262,B
ktinfl 2009.06.21,867,1,0,5,261,40,-221,A
ktinfl 2009.06.21,867,1,0,5,270,40,-230,B
Kundeohmar 2009.07.01,977,1,0,31,336,26,-310,A
Kundeohmar 2009.07.01,977,1,0,31,354,29,-325,B
Booyens 2009.07.01,987,1,1,25,215,36,-179,A
Booyens 2009.07.01,987,1,1,25,207,36,-171,B
TooFar 2009.05.23,1224,1,1,9,333,11,-322,A
TooFar 2009.05.23,1224,1,1,9,338,11,-327,B
xDieInAFirex 2009.05.23,655,1,0,8,317,12,-305,A
xDieInAFirex 2009.05.23,655,1,0,8,324,12,-312,B
pajac 2009.05.21,952,1,1,13,160,8,-152,A
pajac 2009.05.21,952,1,1,13,101,31,-70,B
twobacca 2009.05.21,1003,1,0,13,207,15,-192,A
twobacca 2009.05.21,1003,1,0,13,186,23,-163,B
BillMac 2009.04.29,997,1,1,9,271,33,-238,A
BillMac 2009.04.29,997,1,1,9,246,44,-202,B
RickHfstz 2009.04.29,991,1,0,7,20,86,66,A
RickHfstz 2009.04.29,991,1,0,7,13,86,73,B
stota 2009.06.24,983,1,1,7,259,29,-230,A
stota 2009.06.24,983,1,1,7,203,29,-174,B
LeyZ 2009.06.24,1013,1,0,10,235,20,-215,A
LeyZ 2009.06.24,1013,1,0,10,240,20,-220,B
ktinfl 2009.06.14,898,1,1,8,226,25,-201,A
ktinfl 2009.06.14,898,1,1,8,252,25,-227,B
Jia 2009.06.14,1094,1,0,8,393,12,-381,A
Jia 2009.06.14,1094,1,0,8,430,12,-418,B
Dlegend 2009.06.11,825,2,1,46,185,39,-146,A
Dlegend 2009.06.11,825,2,1,46,191,37,-154,B
borovo 2009.06.11,1073,3,1,64,169,36,-133,A
borovo 2009.06.11,1073,3,1,64,169,39,-130,B
GeorgiaCohen 2009.06.09,803,1,0.5,29,254,21,-233,A
GeorgiaCohen 2009.06.09,803,1,0.5,29,266,24,-242,B
Booyens 2009.06.09,1018,1,0.5,25,141,24,-117,A
Booyens 2009.06.09,1018,1,0.5,25,146,24,-122,B
Kundeohmar 2009.05.20,989,1,1,4,33,75,42,A
Kundeohmar 2009.05.20,989,1,1,4,62,50,-12,B
paderboots 2009.05.20,923,2,1,11,283,18,-265,A
paderboots 2009.05.20,923,2,1,11,295,18,-277,B
Kotimatka 2009.05.10,943,2,2,20,114,40,-74,A
Kotimatka 2009.05.10,943,2,2,20,90,35,-55,B
Hazardo 2009.05.10,956,2,0,23,190,22,-168,A
Hazardo 2009.05.10,956,2,0,23,169,26,-143,B
Hazardo 2009.04.21,964,2,1,18,366,17,-349,A
Hazardo 2009.04.21,964,2,1,18,363,22,-341,B
scosta 2009.04.21,936,2,1,18,370,11,-359,A
scosta 2009.04.21,936,2,1,18,366,11,-355,B
Loran 2009.06.18,884,1,1,15,308,33,-275,A
Loran 2009.06.18,884,1,1,15,273,33,-240,B
Yanulya 2009.06.18,1001,1,0,13,263,23,-240,A
Yanulya 2009.06.18,1001,1,0,13,197,23,-174,B
Rastaluke 2009.05.25,803,2,0,29,256,24,-232,A
Rastaluke 2009.05.25,803,2,0,29,263,24,-239,B
JAYDENBLANE 2009.05.25,1151,2,2,25,168,36,-132,A
JAYDENBLANE 2009.05.25,1151,2,2,25,178,28,-150,B
Kundeohmar 2009.05.24,977,2,0.5,12,227,17,-210,A
Kundeohmar 2009.05.24,977,2,0.5,12,222,0,-222,B
Hazardo 2009.05.24,946,1,0.5,9,364,0,-364,A
Hazardo 2009.05.24,946,1,0.5,9,345,0,-345,B
Nebri 2009.05.13,919,1,1,9,149,44,-105,A
Nebri 2009.05.13,919,1,1,9,133,44,-89,B
paperchasdvincent 2009.05.13,1043,1,0,10,273,40,-233,A
paperchasdvincent 2009.05.13,1043,1,0,10,236,40,-196,B
sangkyu 2009.05.08,928,1,0,12,187,42,-145,A
sangkyu 2009.05.08,928,1,0,12,206,25,-181,B
chmpf 2009.05.08,966,1,1,11,42,54,12,A
chmpf 2009.05.08,966,1,1,11,40,54,14,B
Xoppo 2009.06.24,969,1,0,30,136,33,-103,A
Xoppo 2009.06.24,969,1,0,30,155,27,-128,B
francod 2009.06.24,997,1,1,33,163,42,-121,A
francod 2009.06.24,997,1,1,33,167,42,-125,B
Ickis 2009.05.15,1007,1,1,23,92,44,-48,A
Ickis 2009.05.15,1007,1,1,23,93,44,-49,B
dadikuki 2009.05.15,930,1,0,23,168,17,-151,A
dadikuki 2009.05.15,930,1,0,23,154,22,-132,B
Mels 2009.05.10,848,1,0,5,121,40,-81,A
Mels 2009.05.10,848,1,0,5,146,40,-106,B
Astronomas 2009.05.10,889,1,1,5,71,40,-31,A
Astronomas 2009.05.10,889,1,1,5,53,60,7,B
Loran 2009.06.20,851,1,0,45,233,33,-200,A
Loran 2009.06.20,851,1,0,45,244,29,-215,B
RyanBall 2009.06.20,1071,1,1,48,275,25,-250,A
RyanBall 2009.06.20,1071,1,1,48,287,21,-266,B
checkmatenik 2009.05.26,1001,1,0.5,8,174,12,-162,A
checkmatenik 2009.05.26,1001,1,0.5,8,128,25,-103,B
WhateverAndStuf 2009.05.26,991,1,0.5,9,446,22,-424,A
WhateverAndStuf 2009.05.26,991,1,0.5,9,440,22,-418,B
borovo 2009.06.07,1026,1,0.5,18,174,17,-157,A
borovo 2009.06.07,1026,1,0.5,18,187,17,-170,B
HeliosMax 2009.06.07,955,1,0.5,21,228,33,-195,A
HeliosMax 2009.06.07,955,1,0.5,21,253,33,-220,B
Dlegend 2009.06.17,873,2,1,67,119,36,-83,A
Dlegend 2009.06.17,873,2,1,67,155,33,-122,B
borovo 2009.06.17,1038,2,1,70,175,29,-146,A
borovo 2009.06.17,1038,2,1,70,186,30,-156,B
dubaddict 2009.05.06,823,1,0,20,186,30,-156,A
dubaddict 2009.05.06,823,1,0,20,193,30,-163,B
Koerdis 2009.05.06,1095,1,1,19,123,37,-86,A
Koerdis 2009.05.06,1095,1,1,19,117,42,-75,B
markhodges 2009.05.01,1073,2,1,55,324,20,-304,A
markhodges 2009.05.01,1073,2,1,55,320,22,-298,B
checkraiseallin 2009.05.01,896,4,1,64,252,27,-225,A
checkraiseallin 2009.05.01,896,4,1,64,237,25,-212,B
ktinfl 2009.06.19,865,1,1,26,238,12,-226,A
ktinfl 2009.06.19,865,1,1,26,247,15,-232,B
IrishRottie 2009.06.19,1070,1,0,27,305,11,-294,A
IrishRottie 2009.06.19,1070,1,0,27,316,11,-305,B
JAYDENBLANE 2009.05.17,1119,1,1,17,47,53,6,A
JAYDENBLANE 2009.05.17,1119,1,1,17,45,47,2,B
Rastaluke 2009.05.17,868,1,0,17,111,53,-58,A
Rastaluke 2009.05.17,868,1,0,17,108,53,-55,B
Mels 2009.05.11,848,1,0,6,379,17,-362,A
Mels 2009.05.11,848,1,0,6,376,17,-359,B
stephenbyers 2009.05.11,1051,1,1,4,94,25,-69,A
stephenbyers 2009.05.11,1051,1,1,4,85,25,-60,B
PABOY 2008.11.25,825,1,1,14,242,21,-221,A
PABOY 2008.11.25,825,1,1,14,234,21,-213,B
nicksun 2008.11.25,881,1,0,13,278,23,-255,A
nicksun 2008.11.25,881,1,0,13,268,23,-245,B
Fukiyama 2009.06.04,1008,1,1,23,355,26,-329,A
Fukiyama 2009.06.04,1008,1,1,23,343,26,-317,B
Hazardo 2009.06.04,986,1,0,17,142,53,-89,A
Hazardo 2009.06.04,986,1,0,17,142,53,-89,B
GoGoYubari 2009.06.04,976,1,0,19,188,47,-141,A
GoGoYubari 2009.06.04,976,1,0,19,199,37,-162,B
borovo 2009.06.04,997,1,1,18,200,22,-178,A
borovo 2009.06.04,997,1,1,18,168,22,-146,B
zuugor 2009.06.11,1062,1,1,10,102,30,-72,A
zuugor 2009.06.11,1062,1,1,10,92,30,-62,B
HeliosMax 2009.06.15,855,1,0,22,349,23,-326,A
HeliosMax 2009.06.15,855,1,0,22,363,18,-345,B
jubilado 2009.06.15,874,1,1,13,129,38,-91,A
jubilado 2009.06.15,874,1,1,13,118,46,-72,B
francod 2009.06.07,968,1,1,4,46,25,-21,A
francod 2009.06.07,968,1,1,4,62,50,-12,B
Hazardo 2009.06.07,978,1,0,4,335,25,-310,A
Hazardo 2009.06.07,978,1,0,4,344,25,-319,B
Loran 2009.06.19,912,1,0,7,291,29,-262,A
Loran 2009.06.19,912,1,0,7,292,29,-263,B
RationalSkeptik 2009.06.19,991,1,1,5,117,40,-77,A
RationalSkeptik 2009.06.19,991,1,1,5,90,60,-30,B
robertpmntr 2009.06.22,1087,1,0,4,180,25,-155,A
robertpmntr 2009.06.22,1087,1,0,4,195,25,-170,B
RichardJohnson 2009.05.27,1254,2,1.5,18,56,44,-12,A
RichardJohnson 2009.05.27,1254,2,1.5,18,47,44,-3,B
xDieInAFirex 2009.05.27,651,2,0.5,22,184,27,-157,A
xDieInAFirex 2009.05.27,651,2,0.5,22,157,32,-125,B
RichardJohnson 2009.05.14,1054,3,3,37,134,19,-115,A
RichardJohnson 2009.05.14,1054,3,3,37,124,19,-105,B
xDieInAFirex 2009.05.14,830,3,0,43,241,21,-220,A
xDieInAFirex 2009.05.14,830,3,0,43,221,16,-205,B
Borgohain 2009.06.19,1112,1,0,11,80,36,-44,A
Borgohain 2009.06.19,1112,1,0,11,140,18,-122,B
HeliosMax 2009.06.19,830,1,1,10,64,10,-54,A
HeliosMax 2009.06.19,830,1,1,10,120,30,-90,B
borovo 2009.06.12,1049,1,1,28,110,54,-56,A
borovo 2009.06.12,1049,1,1,28,114,54,-60,B
borovo 2009.06.12,1049,1,1,28,109,50,-59,C
Kundeohmar 2009.06.12,898,1,0,27,184,37,-147,A
Kundeohmar 2009.06.12,898,1,0,27,192,41,-151,B
Kundeohmar 2009.06.12,898,1,0,27,190,41,-149,C
RichardJohnson 2009.05.21,1221,2,2,13,172,46,-126,A
RichardJohnson 2009.05.21,1221,2,2,13,171,46,-125,B
xDieInAFirex 2009.05.21,676,3,0,38,373,18,-355,A
xDieInAFirex 2009.05.21,676,3,0,38,375,13,-362,B
Mels 2009.05.06,904,1,0,7,256,43,-213,A
Mels 2009.05.06,904,1,0,7,241,43,-198,B
badstep 2009.05.06,1049,1,1,7,305,29,-276,A
badstep 2009.05.06,1049,1,1,7,292,29,-263,B
spiderz 2009.06.01,1037,1,0,38,210,32,-178,A
spiderz 2009.06.01,1037,1,0,38,206,34,-172,B
borovo 2009.06.01,1027,2,1,50,151,30,-121,A
borovo 2009.06.01,1027,2,1,50,139,26,-113,B
francod 2009.06.03,968,1,0,14,266,29,-237,A
francod 2009.06.03,968,1,0,14,283,29,-254,B
GoGoYubari 2009.06.03,998,1,1,13,182,31,-151,A
GoGoYubari 2009.06.03,998,1,1,13,213,23,-190,B
Kundeohmar 2009.05.28,963,1,0,7,75,43,-32,A
Kundeohmar 2009.05.28,963,1,0,7,35,43,8,B
Hazardo 2009.05.28,967,1,1,7,151,14,-137,A
Hazardo 2009.05.28,967,1,1,7,92,14,-78,B
ZnBangash 2009.05.21,1143,1,1,19,198,16,-182,A
ZnBangash 2009.05.21,1143,1,1,19,188,21,-167,B
Caledonian 2009.05.17,817,1,0,16,140,31,-109,A
Caledonian 2009.05.17,817,1,0,16,138,38,-100,B
zqnzt 2009.05.17,1051,1,1,15,33,67,34,A
zqnzt 2009.05.17,1051,1,1,15,40,60,20,B
auglaize 2009.04.24,967,1,1,5,109,0,-109,A
auglaize 2009.04.24,967,1,1,5,127,20,-107,B
badstep 2009.04.24,1010,1,0,9,347,22,-325,A
badstep 2009.04.24,1010,1,0,9,367,11,-356,B
Hazardo 2009.06.08,970,1,1,7,88,43,-45,A
Hazardo 2009.06.08,970,1,1,7,78,29,-49,B
elpascoe 2009.06.08,1024,1,0,8,236,25,-211,A
elpascoe 2009.06.08,1024,1,0,8,243,12,-231,B
insanemew 2009.04.22,943,1,0,9,427,0,-427,A
insanemew 2009.04.22,943,1,0,9,427,0,-427,B
pmineiro 2009.04.22,996,1,1,9,344,22,-322,A
pmineiro 2009.04.22,996,1,1,9,363,22,-341,B
sexyricanlady 2009.05.09,1012,1,1,16,167,19,-148,A
sexyricanlady 2009.05.09,1012,1,1,16,168,19,-149,B
zqnzt 2009.05.09,849,1,0,16,266,25,-241,A
zqnzt 2009.05.09,849,1,0,16,229,25,-204,B
OttoTheDog 2009.04.21,1019,1,1,16,234,19,-215,A
OttoTheDog 2009.04.21,1019,1,1,16,218,25,-193,B
Crashinator 2009.04.21,973,1,0,16,260,25,-235,A
Crashinator 2009.04.21,973,1,0,16,242,25,-217,B
WillSmith 2009.06.03,928,1,0,8,232,25,-207,A
WillSmith 2009.06.03,928,1,0,8,228,12,-216,B
borovo 2009.06.03,982,1,1,5,252,20,-232,A
borovo 2009.06.03,982,1,1,5,225,0,-225,B
antharas 2009.06.01,1082,1,1,15,98,27,-71,A
antharas 2009.06.01,1082,1,1,15,86,40,-46,B
obamaworld 2009.05.16,1023,1,0,8,161,38,-123,A
obamaworld 2009.05.16,1023,1,0,8,188,38,-150,B
beijingchina 2009.05.16,969,1,1,9,226,33,-193,A
beijingchina 2009.05.16,969,1,1,9,248,44,-204,B
finestcuts 2009.05.30,950,1,0,19,131,26,-105,A
finestcuts 2009.05.30,950,1,0,19,130,26,-104,B
Xbozo 2009.05.30,1033,1,1,19,117,47,-70,A
Xbozo 2009.05.30,1033,1,1,19,124,58,-66,B
Hazardo 2009.05.26,951,1,1,14,230,36,-194,A
Hazardo 2009.05.26,951,1,1,14,228,43,-185,B
ToomuchforUtoo 2009.05.26,1009,1,0,12,277,25,-252,A
ToomuchforUtoo 2009.05.26,1009,1,0,12,336,0,-336,B
paderboots 2009.05.21,914,1,0,17,159,47,-112,A
paderboots 2009.05.21,914,1,0,17,166,41,-125,B
SecondQueen 2009.05.21,1060,1,1,18,261,17,-244,A
SecondQueen 2009.05.21,1060,1,1,18,252,22,-230,B
Kundeohmar 2009.05.25,963,2,1,41,157,29,-128,A
Kundeohmar 2009.05.25,963,2,1,41,158,29,-129,B
Hazardo 2009.05.25,959,2,1,42,189,26,-163,A
Hazardo 2009.05.25,959,2,1,42,188,24,-164,B
sterum 2009.05.23,1168,1,1,4,217,25,-192,A
sterum 2009.05.23,1168,1,1,4,162,25,-137,B
deeprince 2009.05.23,791,1,0,6,584,17,-567,A
deeprince 2009.05.23,791,1,0,6,540,17,-523,B
sexyricanlady 2009.05.24,937,1,1,5,246,40,-206,A
sexyricanlady 2009.05.24,937,1,1,5,253,40,-213,B
pokerfish 2009.05.23,1018,1,0,19,296,16,-280,A
pokerfish 2009.05.23,1018,1,0,19,249,10,-239,B
cesacsr 2009.05.23,921,1,1,19,171,42,-129,A
cesacsr 2009.05.23,921,1,1,19,156,42,-114,B
Traenexx 2009.04.23,876,1,1,15,212,33,-179,A
Traenexx 2009.04.23,876,1,1,15,214,33,-181,B
richsilver 2009.04.23,1081,1,0,14,168,36,-132,A
richsilver 2009.04.23,1081,1,0,14,171,36,-135,B
PLUGZ 2009.05.20,1068,2,0,29,184,31,-153,A
PLUGZ 2009.05.20,1068,2,0,29,178,31,-147,B
mupdegrove 2009.05.01,1093,2,2,16,131,31,-100,A
mupdegrove 2009.05.01,1093,2,2,16,114,31,-83,B
LaurentDelaon 2009.05.03,1109,1,1,12,239,33,-206,A
LaurentDelaon 2009.05.03,1109,1,1,12,254,33,-221,B
dubaddict 2009.05.03,850,1,0,12,265,33,-232,A
dubaddict 2009.05.03,850,1,0,12,278,33,-245,B
Mels 2009.05.19,835,1,1,13,138,54,-84,A
Mels 2009.05.19,835,1,1,13,139,54,-85,B
kukuykuyk 2009.05.19,1061,1,0,9,244,44,-200,A
kukuykuyk 2009.05.19,1061,1,0,9,248,33,-215,B
Fnorgmuffin 2009.04.23,709,1,0,17,197,24,-173,A
Fnorgmuffin 2009.04.23,709,1,0,17,182,24,-158,B
bialyhetman 2009.04.23,1184,1,1,15,98,40,-58,A
bialyhetman 2009.04.23,1184,1,1,15,105,33,-72,B
RichardJohnson 2009.05.06,1058,1,1,9,210,11,-199,A
RichardJohnson 2009.05.06,1058,1,1,9,188,11,-177,B
xDieInAFirex 2009.05.06,901,1,0,9,332,11,-321,A
xDieInAFirex 2009.05.06,901,1,0,9,317,11,-306,B
jajajajames 2009.05.05,965,1,1,7,462,14,-448,A
jajajajames 2009.05.05,965,1,1,7,471,14,-457,B
Hazardo 2009.05.05,995,1,0,5,284,40,-244,A
Hazardo 2009.05.05,995,1,0,5,248,40,-208,B
Hazardo 2009.04.25,1016,1,1,19,207,42,-165,A
Hazardo 2009.04.25,1016,1,1,19,215,42,-173,B
ukpfc 2009.04.25,790,1,0,19,238,21,-217,A
ukpfc 2009.04.25,790,1,0,19,237,21,-216,B
TylerTheWimp 2009.05.20,910,1,1,19,86,42,-44,A
TylerTheWimp 2009.05.20,910,1,1,19,83,42,-41,B
dubaddict 2009.04.29,818,1,0,5,280,20,-260,A
dubaddict 2009.04.29,818,1,0,5,232,20,-212,B
LaurentDelaon 2009.04.29,1100,1,1,4,89,50,-39,A
LaurentDelaon 2009.04.29,1100,1,1,4,38,50,12,B
Kundeohmar 2009.05.04,1008,1,0,24,162,38,-124,A
Kundeohmar 2009.05.04,1008,1,0,24,160,46,-114,B
Avisharv 2009.05.04,937,1,1,25,188,24,-164,A
Avisharv 2009.05.04,937,1,1,25,191,24,-167,B
cristidumitru 2009.04.24,1240,1,1,5,259,20,-239,A
cristidumitru 2009.04.24,1240,1,1,5,205,20,-185,B
Fnorgmuffin 2009.04.24,701,1,0,4,113,25,-88,A
Fnorgmuffin 2009.04.24,701,1,0,4,96,50,-46,B
Mels 2009.05.07,896,1,0,10,316,30,-286,A
Mels 2009.05.07,896,1,0,10,245,30,-215,B
DikkenPierre 2009.05.07,1039,1,1,9,109,44,-65,A
DikkenPierre 2009.05.07,1039,1,1,9,119,33,-86,B
badstep 2009.05.05,1040,1,1,6,175,0,-175,A
badstep 2009.05.05,1040,1,1,6,107,17,-90,B
dubaddict 2009.05.05,835,1,0,7,423,0,-423,A
dubaddict 2009.05.05,835,1,0,7,368,0,-368,B
Cofiez 2009.04.24,1061,1,1,15,97,47,-50,A
Cofiez 2009.04.24,1061,1,1,15,101,47,-54,B
Traenexx 2009.04.24,887,1,0,15,163,33,-130,A
Traenexx 2009.04.24,887,1,0,15,166,33,-133,B
vpma 2009.04.21,845,1,1,12,73,58,-15,A
vpma 2009.04.21,845,1,1,12,81,67,-14,B
chmpf 2009.04.21,963,1,0,13,239,23,-216,A
chmpf 2009.04.21,963,1,0,13,206,38,-168,B
vpma 2009.04.24,928,1,1,21,162,38,-124,A
vpma 2009.04.24,928,1,1,21,167,29,-138,B
Amarande 2009.04.24,1033,1,0,26,310,23,-287,A
Amarande 2009.04.24,1033,1,0,26,333,23,-310,B
