Name,Games,Result,Moves,CPL,MM,Sort Score,Analysis
Agenbite 1999.11.16,1,0,8,204,25,-179,A
Agenbite 1999.11.16,1,0,8,198,12,-186,B
CaptainAhab 1999.11.16,1,1,7,129,57,-72,A
CaptainAhab 1999.11.16,1,1,7,126,57,-69,B
DumbRedNeck 2009.07.30,3,1,33,342,18,-324,A
DumbRedNeck 2009.07.30,3,1,33,379,18,-361,B
Loran 2009.07.30,3,2,24,224,33,-191,A
Loran 2009.07.30,3,2,24,225,33,-192,B
LeyZ 2009.08.04,1,1,16,234,19,-215,A
LeyZ 2009.08.04,1,1,16,211,31,-180,B
nathy 2009.08.04,1,0,18,360,22,-338,A
nathy 2009.08.04,1,0,18,355,22,-333,B
dahuigou 2008.11.21,2,1.5,50,273,34,-239,A
dahuigou 2008.11.21,2,1.5,50,270,36,-234,B
Crashinator 2008.11.21,2,0.5,57,372,40,-332,A
Crashinator 2008.11.21,2,0.5,57,371,39,-332,B
zhouzhaowu 2009.04.05,1,1,7,320,14,-306,A
zhouzhaowu 2009.04.05,1,1,7,287,14,-273,B
fjjvh 2009.04.05,1,0,8,357,12,-345,A
fjjvh 2009.04.05,1,0,8,340,12,-328,B
DINOCO 2007.10.23,1,1,19,256,5,-251,A
DINOCO 2007.10.23,1,1,19,260,0,-260,B
louiswei 2007.10.23,1,0,21,300,10,-290,A
louiswei 2007.10.23,1,0,21,303,10,-293,B
HogODeath 2007.04.23,1,1,19,353,21,-332,A
HogODeath 2007.04.23,1,1,19,363,16,-347,B
greenqueenbrasil 2007.04.23,1,0,21,450,5,-445,A
greenqueenbrasil 2007.04.23,1,0,21,399,5,-394,B
nathy 2009.08.06,1,0,11,312,18,-294,A
nathy 2009.08.06,1,0,11,319,9,-310,B
ktinfl 2009.08.06,1,1,10,165,20,-145,A
ktinfl 2009.08.06,1,1,10,148,20,-128,B
fjjvh 2009.04.04,1,0,20,348,10,-338,A
fjjvh 2009.04.04,1,0,20,310,10,-300,B
zhouzhaowu 2009.04.04,1,1,17,218,0,-218,A
zhouzhaowu 2009.04.04,1,1,17,169,12,-157,B
chmpf 2009.04.02,1,1,5,19,80,61,A
chmpf 2009.04.02,1,1,5,35,60,25,B
fjjvh 2009.04.02,1,0,7,453,29,-424,A
fjjvh 2009.04.02,1,0,7,330,29,-301,B
Birgie 2008.12.27,1,1,10,103,30,-73,A
Birgie 2008.12.27,1,1,10,118,30,-88,B
Shagmaster 2008.12.27,1,0,11,192,46,-146,A
Shagmaster 2008.12.27,1,0,11,195,46,-149,B
fjjvh 2009.03.29,1,0,34,262,24,-238,A
fjjvh 2009.03.29,1,0,34,262,18,-244,B
chmpf 2009.03.29,1,1,33,256,24,-232,A
chmpf 2009.03.29,1,1,33,258,24,-234,B
Crashinator 2008.11.28,3,1.5,44,276,23,-253,A
Crashinator 2008.11.28,3,1.5,44,280,23,-257,B
dahuigou 2008.11.28,3,1.5,43,316,26,-290,A
dahuigou 2008.11.28,3,1.5,43,327,23,-304,B
Knighter 2000.01.15,2,1,71,247,15,-232,A
Knighter 2000.01.15,2,1,71,263,14,-249,B
mrfriday 2000.01.15,1,0,24,182,25,-157,A
mrfriday 2000.01.15,1,0,24,182,25,-157,B
Crashinator 2008.12.05,1,1,10,114,20,-94,A
Crashinator 2008.12.05,1,1,10,81,20,-61,B
dahuigou 2008.12.05,1,0,14,234,21,-213,A
dahuigou 2008.12.05,1,0,14,222,21,-201,B
gsuses 2006.12.25,1,0,7,649,14,-635,A
gsuses 2006.12.25,1,0,7,658,14,-644,B
jshumaker 2006.12.25,1,1,3,334,33,-301,A
jshumaker 2006.12.25,1,1,3,288,33,-255,B
bigouden 2006.12.07,1,0,14,239,21,-218,A
bigouden 2006.12.07,1,0,14,220,43,-177,B
SamuelJunior 2006.12.07,1,1,13,164,23,-141,A
SamuelJunior 2006.12.07,1,1,13,167,8,-159,B
Andreadoria 2006.12.23,1,1,5,264,20,-244,A
Andreadoria 2006.12.23,1,1,5,227,40,-187,B
gsuses 2006.12.23,1,0,6,522,17,-505,A
gsuses 2006.12.23,1,0,6,520,17,-503,B
hotwheela 2006.12.22,1,0,38,334,18,-316,A
hotwheela 2006.12.22,1,0,38,352,16,-336,B
jpiscool 2006.12.22,1,1,38,307,24,-283,A
jpiscool 2006.12.22,1,1,38,318,24,-294,B
jshumaker 2006.12.30,1,1,21,213,33,-180,A
jshumaker 2006.12.30,1,1,21,194,29,-165,B
Superdonut 2006.12.30,1,0,31,324,23,-301,A
Superdonut 2006.12.30,1,0,31,332,32,-300,B
Sevenkings 2006.12.28,1,0,21,221,29,-192,A
Sevenkings 2006.12.28,1,0,21,196,24,-172,B
ItIsLife 2006.12.28,1,1,20,131,20,-111,A
ItIsLife 2006.12.28,1,1,20,107,30,-77,B
faldur 2004.03.13,1,1,23,110,39,-71,A
faldur 2004.03.13,1,1,23,102,44,-58,B
GolfBob 2004.03.13,1,0,25,154,24,-130,A
GolfBob 2004.03.13,1,0,25,153,28,-125,B
zephrys 2006.11.12,1,1,9,232,56,-176,A
zephrys 2006.11.12,1,1,9,343,44,-299,B
feelm 2006.11.12,2,0,26,384,35,-349,A
feelm 2006.11.12,2,0,26,391,31,-360,B
Malca 2006.10.26,1,1,41,166,32,-134,A
Malca 2006.10.26,1,1,41,163,32,-131,B
SamuelJunior 2006.10.26,1,0,40,199,15,-184,A
SamuelJunior 2006.10.26,1,0,40,198,18,-180,B
Funditor 2006.09.27,1,1,22,48,45,-3,A
Funditor 2006.09.27,1,1,22,49,46,-3,B
Malca 2006.09.27,1,0,23,68,30,-38,A
Malca 2006.09.27,1,0,23,77,30,-47,B
Halfman 2005.12.21,1,0,32,175,28,-147,A
Halfman 2005.12.21,1,0,32,194,31,-163,B
ChessRio 2005.12.21,1,1,32,195,25,-170,A
ChessRio 2005.12.21,1,1,32,205,22,-183,B
dopeyone 2004.03.15,1,0,21,259,19,-240,A
dopeyone 2004.03.15,1,0,21,290,14,-276,B
fuss 2004.03.15,1,1,18,114,28,-86,A
fuss 2004.03.15,1,1,18,143,33,-110,B
JohnstonDJ 2006.12.08,1,0,24,217,25,-192,A
JohnstonDJ 2006.12.08,1,0,24,219,29,-190,B
oubobcat 2006.12.08,3,2,59,139,31,-108,A
oubobcat 2006.12.08,3,2,59,128,29,-99,B
racinebaby 2006.11.29,1,1,12,94,25,-69,A
racinebaby 2006.11.29,1,1,12,91,33,-58,B
harrypotar 2006.11.29,1,0,12,162,33,-129,A
harrypotar 2006.11.29,1,0,12,169,33,-136,B
dockson 2004.01.15,1,1,21,98,52,-46,A
dockson 2004.01.15,1,1,21,94,52,-42,B
dockson 2004.01.15,1,1,21,91,57,-34,C
PravinMamania 2004.01.15,1,0,21,173,19,-154,A
PravinMamania 2004.01.15,1,0,21,172,19,-153,B
PravinMamania 2004.01.15,1,0,21,153,19,-134,C
shechem 2004.03.03,1,1,26,141,31,-110,A
shechem 2004.03.03,1,1,26,127,31,-96,B
GolfBob 2004.03.03,1,0,28,201,21,-180,A
GolfBob 2004.03.03,1,0,28,194,21,-173,B
dockson 2004.02.04,1,0,5,553,0,-553,A
dockson 2004.02.04,1,0,5,581,0,-581,B
furexplity 2004.02.04,1,1,3,241,33,-208,A
furexplity 2004.02.04,1,1,3,208,33,-175,B
GlennaSarous 2003.10.29,1,1,18,208,28,-180,A
GlennaSarous 2003.10.29,1,1,18,229,33,-196,B
SavoySlim 2003.10.29,1,0,18,310,11,-299,A
SavoySlim 2003.10.29,1,0,18,348,6,-342,B
Rdick 2003.07.06,1,1,3,197,33,-164,A
Rdick 2003.07.06,1,1,3,159,33,-126,B
dumpyshubby 2003.07.06,1,0,5,513,40,-473,A
dumpyshubby 2003.07.06,1,0,5,515,40,-475,B
ASABOTO 2004.03.12,1,1,28,119,46,-73,A
ASABOTO 2004.03.12,1,1,28,114,46,-68,B
GolfBob 2004.03.12,1,0,31,201,23,-178,A
GolfBob 2004.03.12,1,0,31,219,23,-196,B
RandyRoo 2006.12.09,3,0,23,255,35,-220,A
RandyRoo 2006.12.09,3,0,23,257,26,-231,B
lksharma 2006.12.09,2,2,18,77,17,-60,A
lksharma 2006.12.09,2,2,18,110,17,-93,B
HGBoone 2006.11.14,1,1,12,76,50,-26,A
HGBoone 2006.11.14,1,1,12,62,58,-4,B
sneakypawn 2006.11.14,1,0,14,211,14,-197,A
sneakypawn 2006.11.14,1,0,14,209,14,-195,B
sneakypawn 2006.10.27,1,0,12,286,8,-278,A
sneakypawn 2006.10.27,1,0,12,224,17,-207,B
walnutwally 2006.10.27,1,1,10,56,50,-6,A
walnutwally 2006.10.27,1,1,10,54,40,-14,B
stickyfinger 2003.12.01,1,0,9,482,33,-449,A
stickyfinger 2003.12.01,1,0,9,448,22,-426,B
radicalrichierich 2003.12.01,1,1,7,399,14,-385,A
radicalrichierich 2003.12.01,1,1,7,418,14,-404,B
dockson 2003.05.14,1,0,6,338,17,-321,A
dockson 2003.05.14,1,0,6,309,17,-292,B
Charolastra 2003.05.14,1,1,5,214,40,-174,A
Charolastra 2003.05.14,1,1,5,170,40,-130,B
rbb 2005.11.29,1,1,7,92,57,-35,A
rbb 2005.11.29,1,1,7,64,43,-21,B
forkboy 2005.11.29,1,0,9,371,44,-327,A
forkboy 2005.11.29,1,0,9,382,33,-349,B
augustuscaesar 2006.07.25,1,0,17,213,18,-195,A
augustuscaesar 2006.07.25,1,0,17,212,12,-200,B
TheCardinal 2006.07.25,1,1,15,162,27,-135,A
TheCardinal 2006.07.25,1,1,15,160,20,-140,B
selectorSimit 2006.12.06,1,1,11,67,54,-13,A
selectorSimit 2006.12.06,1,1,11,59,46,-13,B
hotwheelb 2006.12.06,1,0,12,282,17,-265,A
hotwheelb 2006.12.06,1,0,12,270,8,-262,B
GolfBob 2004.03.09,1,0,23,273,22,-251,A
GolfBob 2004.03.09,1,0,23,302,13,-289,B
shechem 2004.03.09,1,1,23,291,30,-261,A
shechem 2004.03.09,1,1,23,311,30,-281,B
DazedDj 2003.12.16,7,1.0,130,233,27,-206,A
DazedDj 2003.12.16,7,1.0,130,213,28,-185,B
BoardBoy 2003.12.16,7,6.0,111,139,39,-100,A
BoardBoy 2003.12.16,7,6.0,111,131,38,-93,B
BRubble 2003.07.05,1,1,10,40,70,30,A
BRubble 2003.07.05,1,1,10,42,70,28,B
dumpyshubby 2003.07.05,2,1,15,205,7,-198,A
dumpyshubby 2003.07.05,2,1,15,202,7,-195,B
Triplea 2003.03.29,3,2.5,48,205,23,-182,A
Triplea 2003.03.29,3,2.5,48,182,23,-159,B
pendragonz 2003.03.29,1,0.5,28,172,39,-133,A
pendragonz 2003.03.29,1,0.5,28,151,39,-112,B
supriyasodhi 2006.06.12,3,0,42,289,24,-265,A
supriyasodhi 2006.06.12,3,0,42,276,17,-259,B
hungerartist 2006.06.12,3,3,40,262,20,-242,A
hungerartist 2006.06.12,3,3,40,264,17,-247,B
iascrazyorioles 2006.12.18,1,1,33,68,33,-35,A
iascrazyorioles 2006.12.18,1,1,33,65,30,-35,B
hotwheela 2006.12.18,1,0,44,140,25,-115,A
hotwheela 2006.12.18,1,0,44,195,23,-172,B
dockson 2004.02.11,1,0,28,151,25,-126,A
dockson 2004.02.11,1,0,28,145,29,-116,B
shechem 2004.02.11,1,1,30,246,27,-219,A
shechem 2004.02.11,1,1,30,247,20,-227,B
Ironmeis 2006.10.28,1,0,6,182,17,-165,A
Ironmeis 2006.10.28,1,0,6,195,0,-195,B
DAarden 2006.10.28,1,1,5,169,0,-169,A
DAarden 2006.10.28,1,1,5,170,0,-170,B
chelletijn 2004.02.16,2,1,23,314,43,-271,A
chelletijn 2004.02.16,2,1,23,299,39,-260,B
Melko 2004.02.16,1,1,8,104,75,-29,A
Melko 2004.02.16,1,1,8,146,75,-71,B
onewords 2004.02.20,1,1,6,7,83,76,A
onewords 2004.02.20,1,1,6,8,83,75,B
chessshaq 2004.02.20,1,0,6,199,33,-166,A
chessshaq 2004.02.20,1,0,6,205,17,-188,B
jpiscool 2006.12.23,1,0,10,232,20,-212,A
jpiscool 2006.12.23,1,0,10,232,20,-212,B
hotwheela 2006.12.23,1,1,9,164,22,-142,A
hotwheela 2006.12.23,1,1,9,164,22,-142,B
dockson 2004.03.09,1,0,5,344,0,-344,A
dockson 2004.03.09,1,0,5,327,0,-327,B
voetbalfan 2004.03.09,1,1,4,179,0,-179,A
voetbalfan 2004.03.09,1,1,4,154,0,-154,B
DunnMark 2004.01.13,1,1,10,49,50,1,A
DunnMark 2004.01.13,1,1,10,43,50,7,B
CashCow 2004.01.13,1,0,10,139,10,-129,A
CashCow 2004.01.13,1,0,10,150,10,-140,B
yanto 2004.02.10,1,1,23,120,26,-94,A
yanto 2004.02.10,1,1,23,113,26,-87,B
yanto 2004.02.10,1,1,23,115,26,-89,C
dockson 2004.02.10,1,0,25,155,56,-99,A
dockson 2004.02.10,1,0,25,155,52,-103,B
dockson 2004.02.10,1,0,25,151,44,-107,C
sibil 2004.03.02,1,1,13,116,31,-85,A
sibil 2004.03.02,1,1,13,106,38,-68,B
WhiteSide 2004.03.02,2,1,33,208,27,-181,A
WhiteSide 2004.03.02,2,1,33,197,39,-158,B
hawklady 2004.01.09,1,0,8,279,12,-267,A
hawklady 2004.01.09,1,0,8,271,12,-259,B
justacityboy 2004.01.09,1,1,6,100,50,-50,A
justacityboy 2004.01.09,1,1,6,95,50,-45,B
jshumaker 2006.12.28,1,0,7,316,14,-302,A
jshumaker 2006.12.28,1,0,7,310,29,-281,B
Chessword 2006.12.28,1,1,6,120,33,-87,A
Chessword 2006.12.28,1,1,6,121,33,-88,B
Sevenkings 2006.10.26,2,2,19,203,21,-182,A
Sevenkings 2006.10.26,2,2,19,201,26,-175,B
sneakypawn 2006.10.26,2,0,22,361,9,-352,A
sneakypawn 2006.10.26,2,0,22,388,5,-383,B
dockson 2003.05.07,1,0,7,184,29,-155,A
dockson 2003.05.07,1,0,7,175,43,-132,B
dgreality 2003.05.07,1,1,7,192,29,-163,A
dgreality 2003.05.07,1,1,7,194,14,-180,B
Bryceman 2003.04.13,1,0,88,94,43,-51,A
Bryceman 2003.04.13,1,0,88,99,40,-59,B
Fitzakarle 2003.04.13,1,1,86,78,26,-52,A
Fitzakarle 2003.04.13,1,1,86,76,30,-46,B
Fitzakarle 2003.04.10,1,0,15,162,20,-142,A
Fitzakarle 2003.04.10,1,0,15,149,27,-122,B
pendragonz 2003.04.10,1,1,13,65,38,-27,A
pendragonz 2003.04.10,1,1,13,54,38,-16,B
Gamberetto 2006.12.10,1,1,4,38,25,-13,A
Gamberetto 2006.12.10,1,1,4,19,50,31,B
timmyotool 2006.12.10,1,0,4,309,0,-309,A
timmyotool 2006.12.10,1,0,4,300,0,-300,B
metallicguy 2006.10.05,1,1,8,118,62,-56,A
metallicguy 2006.10.05,1,1,8,147,62,-85,B
Funditor 2006.10.05,1,0,10,307,50,-257,A
Funditor 2006.10.05,1,0,10,342,10,-332,B
flinn 2003.05.02,1,0,14,168,43,-125,A
flinn 2003.05.02,1,0,14,141,43,-98,B
abeme 2003.05.02,1,1,11,90,27,-63,A
abeme 2003.05.02,1,1,11,60,54,-6,B
tujhbq 2006.10.02,1,1,11,6,82,76,A
tujhbq 2006.10.02,1,1,11,14,82,68,B
Elrocks 2006.10.02,1,0,11,153,18,-135,A
Elrocks 2006.10.02,1,0,11,157,27,-130,B
jmvbxx 2006.09.06,1,1,12,93,58,-35,A
jmvbxx 2006.09.06,1,1,12,98,58,-40,B
KnightLightning 2006.09.06,2,0.5,52,159,31,-128,A
KnightLightning 2006.09.06,2,0.5,52,140,33,-107,B
reddawgdead 2006.07.26,2,1,35,202,31,-171,A
reddawgdead 2006.07.26,2,1,35,195,34,-161,B
TeddySauyet 2006.07.26,2,1,46,266,28,-238,A
TeddySauyet 2006.07.26,2,1,46,258,28,-230,B
HGBoone 2005.10.10,1,1,5,66,40,-26,A
HGBoone 2005.10.10,1,1,5,48,60,12,B
smugknave 2005.10.10,2,0.5,22,320,27,-293,A
smugknave 2005.10.10,2,0.5,22,310,27,-283,B
Folinsbee 2004.03.02,1,0,18,173,28,-145,A
Folinsbee 2004.03.02,1,0,18,158,28,-130,B
bigouden 2006.12.09,1,0,40,109,43,-66,A
bigouden 2006.12.09,1,0,40,103,45,-58,B
uvrays 2006.12.09,1,1,36,87,39,-48,A
uvrays 2006.12.09,1,1,36,83,36,-47,B
onewords 2004.02.18,1,0,11,149,9,-140,A
onewords 2004.02.18,1,0,11,134,18,-116,B
chelletijn 2004.02.18,1,1,10,19,60,41,A
chelletijn 2004.02.18,1,1,10,15,60,45,B
zukerro 2004.02.16,1,0,12,139,42,-97,A
zukerro 2004.02.16,1,0,12,148,33,-115,B
encairo 2004.02.26,1,0,15,232,13,-219,A
encairo 2004.02.26,1,0,15,254,13,-241,B
Folinsbee 2004.02.26,1,1,11,87,46,-41,A
Folinsbee 2004.02.26,1,1,11,86,46,-40,B
pascalwilliams 2006.12.09,1,1,4,393,25,-368,A
pascalwilliams 2006.12.09,1,1,4,400,25,-375,B
hotwheelb 2006.12.02,1,0,17,156,24,-132,A
hotwheelb 2006.12.02,1,0,17,152,29,-123,B
FEDt 2006.12.02,1,1,15,66,33,-33,A
FEDt 2006.12.02,1,1,15,56,33,-23,B
nuthegoob 2006.10.18,1,0,18,239,28,-211,A
nuthegoob 2006.10.18,1,0,18,210,22,-188,B
pbanx 2006.10.18,1,1,23,242,35,-207,A
pbanx 2006.10.18,1,1,23,251,35,-216,B
rossx 2006.09.05,1,1,19,261,21,-240,A
rossx 2006.09.05,1,1,19,225,21,-204,B
Nackler 2006.09.05,1,0,19,223,21,-202,A
Nackler 2006.09.05,1,0,19,203,10,-193,B
LaVigne 2005.12.14,1,0,11,287,27,-260,A
LaVigne 2005.12.14,1,0,11,163,27,-136,B
pollbellini 2005.12.14,1,1,11,142,18,-124,A
pollbellini 2005.12.14,1,1,11,85,18,-67,B
wwdotti 2005.11.16,1,1,6,69,67,-2,A
wwdotti 2005.11.16,1,1,6,96,67,-29,B
americanista 2005.11.16,1,0,6,268,33,-235,A
americanista 2005.11.16,1,0,6,215,33,-182,B
NRking 2006.12.08,2,1,38,131,39,-92,A
NRking 2006.12.08,2,1,38,127,37,-90,B
voetbalfan 2004.02.15,1,1,18,148,33,-115,A
voetbalfan 2004.02.15,1,1,18,136,28,-108,B
chelletijn 2004.02.15,1,0,18,149,44,-105,A
chelletijn 2004.02.15,1,0,18,150,44,-106,B
Truelan 2006.10.28,2,0,55,190,27,-163,A
Truelan 2006.10.28,2,0,55,194,33,-161,B
SamuelJunior 2006.10.28,2,2,54,140,33,-107,A
SamuelJunior 2006.10.28,2,2,54,147,31,-116,B
subwoofer 2006.11.25,1,1,9,139,44,-95,A
subwoofer 2006.11.25,1,1,9,118,33,-85,B
hotwheelb 2006.11.25,1,0,9,310,0,-310,A
hotwheelb 2006.11.25,1,0,9,290,0,-290,B
GlennaSarous 2003.11.22,1,0,20,222,30,-192,A
GlennaSarous 2003.11.22,1,0,20,222,30,-192,B
gough 2003.11.22,1,1,19,207,32,-175,A
gough 2003.11.22,1,1,19,202,32,-170,B
wwdotti 2005.12.04,1,1,11,52,27,-25,A
wwdotti 2005.12.04,1,1,11,75,18,-57,B
FarooqBaloch 2005.12.04,1,0,12,221,25,-196,A
FarooqBaloch 2005.12.04,1,0,12,250,17,-233,B
HEARTLESSWIZARD 2005.11.05,1,0,14,292,14,-278,A
HEARTLESSWIZARD 2005.11.05,1,0,14,264,14,-250,B
KJett 2005.11.05,1,1,13,191,23,-168,A
KJett 2005.11.05,1,1,13,175,23,-152,B
supriyasodhi 2006.06.21,1,0,5,180,40,-140,A
supriyasodhi 2006.06.21,1,0,5,199,40,-159,B
unluckythirtyfive 2006.06.21,1,1,5,67,40,-27,A
unluckythirtyfive 2006.06.21,1,1,5,58,60,2,B
loccsta 2004.02.08,1,0,23,49,17,-32,A
loccsta 2004.02.08,1,0,23,44,13,-31,B
loccsta 2004.02.08,1,0,23,62,13,-49,C
PravinMamania 2004.02.08,1,1,22,22,50,28,A
PravinMamania 2004.02.08,1,1,22,18,41,23,B
PravinMamania 2004.02.08,1,1,22,18,41,23,C
feelm 2006.10.25,1,1,22,136,41,-95,A
feelm 2006.10.25,1,1,22,128,41,-87,B
hatrik 2006.10.25,1,0,28,285,32,-253,A
hatrik 2006.10.25,1,0,28,288,29,-259,B
feelm 2006.11.18,1,1,24,162,42,-120,A
feelm 2006.11.18,1,1,24,155,42,-113,B
VasTech 2006.11.18,1,0,24,253,25,-228,A
VasTech 2006.11.18,1,0,24,237,25,-212,B
BoardBoy 2004.01.04,1,0.5,18,265,11,-254,A
BoardBoy 2004.01.04,1,0.5,18,232,11,-221,B
DazedDj 2004.01.04,1,0.5,17,176,24,-152,A
DazedDj 2004.01.04,1,0.5,17,148,29,-119,B
tunacem 2006.11.12,1,1,13,101,46,-55,A
tunacem 2006.11.12,1,1,13,113,46,-67,B
DazedDj 2004.01.02,1,0,15,202,27,-175,A
DazedDj 2004.01.02,1,0,15,212,27,-185,B
BoardBoy 2004.01.02,1,1,12,117,50,-67,A
BoardBoy 2004.01.02,1,1,12,112,58,-54,B
AceDiamond 2003.12.16,1,1,21,93,29,-64,A
AceDiamond 2003.12.16,1,1,21,86,24,-62,B
churningpigskin 2003.12.16,1,0,21,103,52,-51,A
churningpigskin 2003.12.16,1,0,21,103,48,-55,B
bsliced 2006.10.21,1,1,4,112,50,-62,A
bsliced 2006.10.21,1,1,4,117,50,-67,B
Johnnyp 2006.10.21,1,0,4,340,25,-315,A
Johnnyp 2006.10.21,1,0,4,332,25,-307,B
Funditor 2006.10.04,2,0,43,161,40,-121,A
Funditor 2006.10.04,2,0,43,152,35,-117,B
tujhbq 2006.10.04,1,1,41,140,34,-106,A
tujhbq 2006.10.04,1,1,41,130,29,-101,B
Triplea 2003.05.01,1,0,13,187,46,-141,A
Triplea 2003.05.01,1,0,13,204,38,-166,B
DSSagent 2003.05.01,1,1,12,191,42,-149,A
DSSagent 2003.05.01,1,1,12,217,33,-184,B
uvrays 2006.10.31,1,1,18,54,33,-21,A
uvrays 2006.10.31,1,1,18,72,28,-44,B
nuthegoob 2006.10.31,1,0,20,105,25,-80,A
nuthegoob 2006.10.31,1,0,20,124,20,-104,B
ajwillington 2003.11.10,1,1,24,188,38,-150,A
ajwillington 2003.11.10,1,1,24,177,42,-135,B
WhiteSide 2003.11.10,1,0,25,275,44,-231,A
WhiteSide 2003.11.10,1,0,25,218,44,-174,B
celcius 2006.10.16,1,1,5,198,40,-158,A
celcius 2006.10.16,1,1,5,226,20,-206,B
Funditor 2006.10.16,1,0,5,480,20,-460,A
Funditor 2006.10.16,1,0,5,405,20,-385,B
nuthegoob 2006.10.17,2,1,29,238,10,-228,A
nuthegoob 2006.10.17,2,1,29,230,10,-220,B
DAarden 2006.10.17,1,1,20,256,25,-231,A
DAarden 2006.10.17,1,1,20,250,25,-225,B
mssronald 2003.04.15,1,0,5,484,0,-484,A
mssronald 2003.04.15,1,0,5,470,0,-470,B
eaglesloft 2003.04.15,1,1,3,147,33,-114,A
eaglesloft 2003.04.15,1,1,3,157,33,-124,B
eaglesloft 2003.03.29,2,2,22,251,27,-224,A
eaglesloft 2003.03.29,2,2,22,246,27,-219,B
mssronald 2003.03.29,2,0,28,284,21,-263,A
mssronald 2003.03.29,2,0,28,288,21,-267,B
marcuscole 2006.06.30,2,1.5,51,112,41,-71,A
marcuscole 2006.06.30,2,1.5,51,120,37,-83,B
Dkling 2006.06.30,2,0.5,47,132,43,-89,A
Dkling 2006.06.30,2,0.5,47,108,45,-63,B
BoardBoy 2003.12.12,1,0.5,15,273,20,-253,A
BoardBoy 2003.12.12,1,0.5,15,261,13,-248,B
DazedDj 2003.12.12,1,0.5,14,122,57,-65,A
DazedDj 2003.12.12,1,0.5,14,123,57,-66,B
uvrays 2006.10.17,1,0,8,368,0,-368,A
uvrays 2006.10.17,1,0,8,345,0,-345,B
FlatThird 2006.10.04,1,1,4,215,50,-165,A
FlatThird 2006.10.04,1,1,4,219,50,-169,B
Triplea 2003.04.20,2,2,30,111,33,-78,A
Triplea 2003.04.20,2,2,30,102,33,-69,B
KJett 2003.04.20,2,0,38,257,18,-239,A
KJett 2003.04.20,2,0,38,255,18,-237,B
SergB 2006.09.26,1,1,37,121,49,-72,A
SergB 2006.09.26,1,1,37,124,46,-78,B
uvrays 2006.09.26,1,0,35,95,43,-52,A
uvrays 2006.09.26,1,0,35,117,34,-83,B
blevente 2006.10.16,1,1,7,331,43,-288,A
blevente 2006.10.16,1,1,7,267,43,-224,B
nuthegoob 2006.10.16,2,0,27,429,15,-414,A
nuthegoob 2006.10.16,2,0,27,382,19,-363,B
PureC 2006.10.06,1,1,6,200,50,-150,A
PureC 2006.10.06,1,1,6,223,50,-173,B
fdh 2006.10.06,1,0,6,275,33,-242,A
fdh 2006.10.06,1,0,6,301,33,-268,B
DSSagent 2003.06.26,1,1,13,72,46,-26,A
DSSagent 2003.06.26,1,1,13,64,54,-10,B
churningpigskin 2003.06.26,1,0,13,169,15,-154,A
churningpigskin 2003.06.26,1,0,13,166,15,-151,B
HGBoone 2006.09.22,1,1,9,23,78,55,A
HGBoone 2006.09.22,1,1,9,45,44,-1,B
Funditor 2006.09.22,1,0,11,202,9,-193,A
Funditor 2006.09.22,1,0,11,209,18,-191,B
IMPeachyr 2006.08.31,1,0,5,308,20,-288,A
IMPeachyr 2006.08.31,1,0,5,317,20,-297,B
DaBob 2006.08.31,1,1,4,56,50,-6,A
DaBob 2006.08.31,1,1,4,48,50,2,B
HEARTLESSWIZARD 2005.12.03,1,1,35,164,23,-141,A
HEARTLESSWIZARD 2005.12.03,1,1,35,179,26,-153,B
intelinside 2005.12.03,1,0,35,204,43,-161,A
intelinside 2005.12.03,1,0,35,200,40,-160,B
KJett 2003.09.22,1,0.5,35,231,34,-197,A
KJett 2003.09.22,1,0.5,35,201,34,-167,B
dumpyshubby 2003.09.22,1,0.5,38,293,32,-261,A
dumpyshubby 2003.09.22,1,0.5,38,252,21,-231,B
metallicguy 2006.09.13,1,0,19,299,26,-273,A
metallicguy 2006.09.13,1,0,19,262,21,-241,B
rossx 2006.09.13,1,1,21,296,33,-263,A
rossx 2006.09.13,1,1,21,282,24,-258,B
Mikimouse 2003.03.31,1,0,12,299,25,-274,A
Mikimouse 2003.03.31,1,0,12,279,25,-254,B
Giuditta 2003.03.31,1,1,7,110,43,-67,A
Giuditta 2003.03.31,1,1,7,78,43,-35,B
PawnStarrz 2003.04.04,1,1,22,177,32,-145,A
PawnStarrz 2003.04.04,1,1,22,187,32,-155,B
KJett 2003.04.04,1,0,22,327,27,-300,A
KJett 2003.04.04,1,0,22,298,14,-284,B
wwdotti 2005.11.28,1,0,22,242,18,-224,A
wwdotti 2005.11.28,1,0,22,200,18,-182,B
HEARTLESSWIZARD 2005.11.28,1,1,21,160,38,-122,A
HEARTLESSWIZARD 2005.11.28,1,1,21,135,33,-102,B
joelbow 2003.03.29,2,0,23,305,17,-288,A
joelbow 2003.03.29,2,0,23,302,13,-289,B
forkboy 2005.11.30,1,1,10,85,60,-25,A
forkboy 2005.11.30,1,1,10,49,60,11,B
HEARTLESSWIZARD 2005.11.30,1,0,11,162,36,-126,A
HEARTLESSWIZARD 2005.11.30,1,0,11,160,36,-124,B
Lexus 2003.05.10,1,0.5,13,191,15,-176,A
Lexus 2003.05.10,1,0.5,13,190,23,-167,B
KJett 2003.05.10,1,0.5,12,85,42,-43,A
KJett 2003.05.10,1,0.5,12,86,42,-44,B
Lexus 2003.05.03,1,0,17,293,41,-252,A
Lexus 2003.05.03,1,0,17,271,41,-230,B
KJett 2003.05.03,1,1,17,334,24,-310,A
KJett 2003.05.03,1,1,17,280,18,-262,B
Thorstein 2006.09.24,1,1,5,127,60,-67,A
Thorstein 2006.09.24,1,1,5,150,60,-90,B
cuypeji 2006.09.24,1,0,5,365,0,-365,A
cuypeji 2006.09.24,1,0,5,382,0,-382,B
HerrGott 2006.08.21,1,0,8,276,12,-264,A
HerrGott 2006.08.21,1,0,8,258,12,-246,B
DEDEE 2006.08.21,1,1,7,149,29,-120,A
DEDEE 2006.08.21,1,1,7,137,43,-94,B
thomasrhymer 2005.10.23,1,1,5,70,60,-10,A
thomasrhymer 2005.10.23,1,1,5,66,60,-6,B
aadeeb 2005.10.23,2,0,30,274,17,-257,A
aadeeb 2005.10.23,2,0,30,247,23,-224,B
ferking 2006.05.31,4,3,56,204,34,-170,A
ferking 2006.05.31,4,3,56,195,32,-163,B
Memnochblue 2006.05.31,4,1,58,235,31,-204,A
Memnochblue 2006.05.31,4,1,58,230,28,-202,B
andrewpointone 2003.07.05,1,0,7,552,29,-523,A
andrewpointone 2003.07.05,1,0,7,552,14,-538,B
Tarish 2006.09.13,1,0,12,169,50,-119,A
Tarish 2006.09.13,1,0,12,174,42,-132,B
jmgamber 2006.09.13,1,1,11,147,18,-129,A
jmgamber 2006.09.13,1,1,11,126,27,-99,B
RandyRoo 2006.10.12,1,0,7,273,14,-259,A
RandyRoo 2006.10.12,1,0,7,276,14,-262,B
dolphinsfan 2006.10.12,1,1,5,65,60,-5,A
dolphinsfan 2006.10.12,1,1,5,58,60,2,B
Truelan 2006.10.16,1,1,18,310,22,-288,A
Truelan 2006.10.16,1,1,18,313,28,-285,B
dgreality 2003.04.11,1,0.5,13,206,38,-168,A
dgreality 2003.04.11,1,0.5,13,216,31,-185,B
ZEFER 2003.04.11,1,0.5,15,290,33,-257,A
ZEFER 2003.04.11,1,0.5,15,280,33,-247,B
KJett 2003.04.05,1,1,23,149,43,-106,A
KJett 2003.04.05,1,1,23,141,39,-102,B
dardanus 2003.04.05,1,0,20,151,20,-131,A
dardanus 2003.04.05,1,0,20,157,20,-137,B
badantony 2006.10.11,1,0,5,518,20,-498,A
badantony 2006.10.11,1,0,5,473,20,-453,B
nuthegoob 2006.10.11,1,1,3,205,33,-172,A
nuthegoob 2006.10.11,1,1,3,214,33,-181,B
redistribute 2006.10.03,1,0,18,210,11,-199,A
redistribute 2006.10.03,1,0,18,216,22,-194,B
Funditor 2006.10.03,1,1,16,120,31,-89,A
Funditor 2006.10.03,1,1,16,118,25,-93,B
Triplea 2003.04.12,1,1,22,83,41,-42,A
Triplea 2003.04.12,1,1,22,85,41,-44,B
Fitzakarle 2003.04.12,1,0,23,118,44,-74,A
Fitzakarle 2003.04.12,1,0,23,125,44,-81,B
Saldeeznuts 2006.09.28,1,1,15,170,27,-143,A
Saldeeznuts 2006.09.28,1,1,15,164,20,-144,B
Funditor 2006.09.28,1,0,15,279,33,-246,A
Funditor 2006.09.28,1,0,15,249,40,-209,B
nepvetm 2006.09.09,1,0,24,238,29,-209,A
nepvetm 2006.09.09,1,0,24,242,29,-213,B
shahar 2006.09.09,1,1,20,161,25,-136,A
shahar 2006.09.09,1,1,20,168,25,-143,B
pddchess 2005.12.14,1,0,18,202,28,-174,A
pddchess 2005.12.14,1,0,18,205,28,-177,B
azshtrdude 2005.12.14,1,1,15,167,33,-134,A
azshtrdude 2005.12.14,1,1,15,153,20,-133,B
sirkillalot 2003.04.10,1,1,7,122,43,-79,A
sirkillalot 2003.04.10,1,1,7,135,43,-92,B
joelbow 2003.04.10,1,0,7,245,29,-216,A
joelbow 2003.04.10,1,0,7,317,14,-303,B
eaglesloft 2003.03.18,1,1,4,199,25,-174,A
eaglesloft 2003.03.18,1,1,4,138,0,-138,B
mssronald 2003.03.18,1,0,4,490,25,-465,A
mssronald 2003.03.18,1,0,4,428,0,-428,B
hbengts 2006.06.09,1,1,22,109,32,-77,A
hbengts 2006.06.09,1,1,22,114,32,-82,B
supriyasodhi 2006.06.09,1,0,24,192,17,-175,A
supriyasodhi 2006.06.09,1,0,24,186,21,-165,B
Triplea 2003.02.01,1,0,19,339,32,-307,A
Triplea 2003.02.01,1,0,19,218,32,-186,B
brekneck 2003.02.01,1,1,20,216,40,-176,A
brekneck 2003.02.01,1,1,20,219,35,-184,B
SkarryLarry 2005.07.15,1,0,14,224,36,-188,A
SkarryLarry 2005.07.15,1,0,14,301,21,-280,B
Laddie 2005.07.15,1,1,11,134,36,-98,A
Laddie 2005.07.15,1,1,11,160,36,-124,B
iveyjr 2005.07.02,2,1,25,213,32,-181,A
iveyjr 2005.07.02,2,1,25,221,32,-189,B
MartyL 2005.07.02,2,1,37,211,27,-184,A
MartyL 2005.07.02,2,1,37,211,24,-187,B
jashevan 2005.12.09,1,1,19,119,37,-82,A
jashevan 2005.12.09,1,1,19,97,32,-65,B
clickoo 2005.12.09,1,0,20,218,35,-183,A
clickoo 2005.12.09,1,0,20,192,40,-152,B
bigrig 2005.12.04,1,1,11,126,36,-90,A
bigrig 2005.12.04,1,1,11,126,27,-99,B
clickoo 2005.12.04,1,0,11,170,46,-124,A
clickoo 2005.12.04,1,0,11,166,36,-130,B
Sunsfan 2006.07.26,1,1,15,263,20,-243,A
Sunsfan 2006.07.26,1,1,15,257,20,-237,B
VasTech 2006.07.26,1,0,11,373,9,-364,A
VasTech 2006.07.26,1,0,11,389,9,-380,B
eaglesloft 2003.02.15,1,1,17,259,24,-235,A
eaglesloft 2003.02.15,1,1,17,240,29,-211,B
mssronald 2003.02.15,1,0,19,384,16,-368,A
mssronald 2003.02.15,1,0,19,362,16,-346,B
dolphinsfan 2006.09.06,1,0.5,42,107,40,-67,A
dolphinsfan 2006.09.06,1,0.5,42,98,40,-58,B
Triplea 2003.03.22,1,1,12,117,50,-67,A
Triplea 2003.03.22,1,1,12,120,33,-87,B
Mikimouse 2003.03.22,1,0,13,171,31,-140,A
Mikimouse 2003.03.22,1,0,13,176,38,-138,B
darjos 2003.03.03,2,0,21,244,19,-225,A
darjos 2003.03.03,2,0,21,211,14,-197,B
brisham 2003.03.03,2,2,21,214,33,-181,A
brisham 2003.03.03,2,2,21,180,33,-147,B
claudiolozea 2003.02.09,1,1,6,60,67,7,A
claudiolozea 2003.02.09,1,1,6,45,67,22,B
Triplea 2003.02.09,1,0,7,467,0,-467,A
Triplea 2003.02.09,1,0,7,436,0,-436,B
LeFol 2006.06.11,1,1,8,48,62,14,A
LeFol 2006.06.11,1,1,8,33,62,29,B
twilc 2006.06.11,1,0,8,245,12,-233,A
twilc 2006.06.11,1,0,8,182,12,-170,B
pddchess 2005.12.12,1,1,5,127,20,-107,A
pddchess 2005.12.12,1,1,5,134,40,-94,B
erta 2005.12.12,1,0,5,274,20,-254,A
erta 2005.12.12,1,0,5,285,20,-265,B
aBlade 2006.08.19,1,1,4,193,25,-168,A
aBlade 2006.08.19,1,1,4,201,25,-176,B
jbuttler 2006.08.19,1,0,4,423,25,-398,A
jbuttler 2006.08.19,1,0,4,457,25,-432,B
achimdragos 2006.08.21,1,1,9,218,67,-151,A
achimdragos 2006.08.21,1,1,9,244,44,-200,B
hungerartist 2006.08.21,1,0,9,367,33,-334,A
hungerartist 2006.08.21,1,0,9,366,22,-344,B
milamores 2005.11.24,1,1,25,169,24,-145,A
milamores 2005.11.24,1,1,25,177,24,-153,B
uvrays 2005.11.24,1,0,24,189,17,-172,A
uvrays 2005.11.24,1,0,24,208,12,-196,B
astronomyguy 2005.11.30,1,1,23,129,52,-77,A
astronomyguy 2005.11.30,1,1,23,123,35,-88,B
Johnnyp 2005.11.30,1,0,28,234,32,-202,A
Johnnyp 2005.11.30,1,0,28,245,32,-213,B
dustbuni 2006.08.30,1,0,10,377,0,-377,A
dustbuni 2006.08.30,1,0,10,386,0,-386,B
cgorski 2006.08.30,1,1,7,61,71,10,A
cgorski 2006.08.30,1,1,7,60,71,11,B
americanista 2005.11.17,1,1,9,287,22,-265,A
americanista 2005.11.17,1,1,9,262,22,-240,B
mascota 2005.11.17,1,0,11,453,9,-444,A
mascota 2005.11.17,1,0,11,381,18,-363,B
rochon 2005.09.09,1,1,43,106,49,-57,A
rochon 2005.09.09,1,1,43,105,44,-61,B
unclebaal 2005.09.09,1,0,45,155,31,-124,A
unclebaal 2005.09.09,1,0,45,158,31,-127,B
LaFleurDeLys 2003.01.25,1,0,11,676,9,-667,A
LaFleurDeLys 2003.01.25,1,0,11,698,9,-689,B
Triplea 2003.01.25,3,2,38,217,32,-185,A
Triplea 2003.01.25,3,2,38,224,29,-195,B
abcc 2006.08.05,1,0,41,104,37,-67,A
abcc 2006.08.05,1,0,41,86,34,-52,B
Tizko 2006.08.05,1,1,41,75,44,-31,A
Tizko 2006.08.05,1,1,41,71,44,-27,B
pohlie 2005.11.24,1,1,25,167,36,-131,A
pohlie 2005.11.24,1,1,25,169,36,-133,B
HEARTLESSWIZARD 2005.11.24,1,0,27,239,33,-206,A
HEARTLESSWIZARD 2005.11.24,1,0,27,255,37,-218,B
TeddySauyet 2006.06.28,1,0,11,343,46,-297,A
TeddySauyet 2006.06.28,1,0,11,340,27,-313,B
SamuelJunior 2006.06.28,1,1,8,142,62,-80,A
SamuelJunior 2006.06.28,1,1,8,185,50,-135,B
Garzon 2006.07.26,1,1,16,299,19,-280,A
Garzon 2006.07.26,1,1,16,268,31,-237,B
augustuscaesar 2006.07.26,1,0,14,380,29,-351,A
augustuscaesar 2006.07.26,1,0,14,329,29,-300,B
LazyFIDERook 2006.08.22,1,0,33,204,36,-168,A
LazyFIDERook 2006.08.22,1,0,33,211,36,-175,B
netbrain 2006.08.22,1,1,26,164,35,-129,A
netbrain 2006.08.22,1,1,26,116,19,-97,B
Unknowner 2005.10.23,1,1,21,195,29,-166,A
Unknowner 2005.10.23,1,1,21,176,29,-147,B
HEARTLESSWIZARD 2005.11.27,1,0,11,238,18,-220,A
HEARTLESSWIZARD 2005.11.27,1,0,11,198,27,-171,B
DaveFromWazza 2005.11.27,1,1,15,233,40,-193,A
DaveFromWazza 2005.11.27,1,1,15,208,40,-168,B
cuzzer 2005.11.09,1,0,37,291,22,-269,A
cuzzer 2005.11.09,1,0,37,295,24,-271,B
kilkennycat 2005.11.09,1,1,36,270,22,-248,A
kilkennycat 2005.11.09,1,1,36,259,25,-234,B
BothFeet 2005.11.07,1,0,32,232,28,-204,A
BothFeet 2005.11.07,1,0,32,237,31,-206,B
BishopDaMan 2005.11.07,1,1,31,263,23,-240,A
BishopDaMan 2005.11.07,1,1,31,262,26,-236,B
dgreality 2003.03.22,1,0,25,351,12,-339,A
dgreality 2003.03.22,1,0,25,288,16,-272,B
KJett 2003.03.22,1,1,20,285,20,-265,A
KJett 2003.03.22,1,1,20,237,25,-212,B
KJett 2003.02.21,1,0,27,249,22,-227,A
KJett 2003.02.21,1,0,27,272,18,-254,B
gswiff 2003.02.21,1,1,25,188,36,-152,A
gswiff 2003.02.21,1,1,25,197,32,-165,B
coloradorover 2003.02.05,1,1,13,194,15,-179,A
coloradorover 2003.02.05,1,1,13,188,8,-180,B
Dusti 2003.02.05,1,0,13,326,23,-303,A
Dusti 2003.02.05,1,0,13,237,31,-206,B
AFMD 2006.07.19,1,0,11,228,27,-201,A
AFMD 2006.07.19,1,0,11,237,18,-219,B
twilc 2006.07.19,1,1,11,250,46,-204,A
twilc 2006.07.19,1,1,11,259,36,-223,B
Dkling 2006.06.29,2,0,42,186,24,-162,A
Dkling 2006.06.29,2,0,42,187,29,-158,B
marcuscole 2006.06.29,2,2,39,183,36,-147,A
marcuscole 2006.06.29,2,2,39,169,33,-136,B
jornf 2002.12.26,1,1,8,42,50,8,A
jornf 2002.12.26,1,1,8,48,50,2,B
coloradorover 2002.12.26,7,0,115,195,31,-164,A
coloradorover 2002.12.26,7,0,115,180,34,-146,B
philippeopr 2005.08.14,1,0.5,20,71,35,-36,A
philippeopr 2005.08.14,1,0.5,20,62,40,-22,B
SkarryLarry 2005.08.14,1,0.5,21,152,33,-119,A
SkarryLarry 2005.08.14,1,0.5,21,150,33,-117,B
Triplea 2003.03.16,1,1,10,216,20,-196,A
Triplea 2003.03.16,1,1,10,211,20,-191,B
Neeter 2003.03.16,1,0,12,366,25,-341,A
Neeter 2003.03.16,1,0,12,387,33,-354,B
bigrig 2005.10.10,1,0.5,17,225,35,-190,A
bigrig 2005.10.10,1,0.5,17,248,35,-213,B
coloradorover 2003.01.22,2,1,34,178,21,-157,A
coloradorover 2003.01.22,2,1,34,163,24,-139,B
mrudy 2003.01.22,1,1,18,209,28,-181,A
mrudy 2003.01.22,1,1,18,209,33,-176,B
puzzledmindLady 2005.08.07,1,1,8,134,25,-109,A
puzzledmindLady 2005.08.07,1,1,8,120,38,-82,B
bonillaice 2005.08.07,2,1,13,244,46,-198,A
bonillaice 2005.08.07,2,1,13,238,46,-192,B
xxYxxY 2006.05.09,1,1,10,59,40,-19,A
xxYxxY 2006.05.09,1,1,10,62,40,-22,B
DEDEE 2006.05.09,1,0,10,184,10,-174,A
DEDEE 2006.05.09,1,0,10,186,20,-166,B
apospap 2006.06.26,1,0,24,270,17,-253,A
apospap 2006.06.26,1,0,24,283,33,-250,B
TeddySauyet 2006.06.26,2,2,42,204,24,-180,A
TeddySauyet 2006.06.26,2,2,42,222,26,-196,B
Agee 2003.03.06,1,1,43,208,28,-180,A
Agee 2003.03.06,1,1,43,169,28,-141,B
KJett 2003.03.06,1,0,48,265,29,-236,A
KJett 2003.03.06,1,0,48,274,27,-247,B
eaglesloft 2003.03.04,1,1,8,160,12,-148,A
eaglesloft 2003.03.04,1,1,8,145,12,-133,B
flinn 2003.03.04,1,0,11,360,18,-342,A
flinn 2003.03.04,1,0,11,381,18,-363,B
trovillion 2005.09.07,1,1,11,381,18,-363,A
trovillion 2005.09.07,1,1,11,398,18,-380,B
rtgreen 2005.09.07,1,0,8,240,50,-190,A
rtgreen 2005.09.07,1,0,8,238,50,-188,B
TeddySauyet 2006.06.27,1,0,31,372,36,-336,A
TeddySauyet 2006.06.27,1,0,31,371,36,-335,B
SamuelJunior 2006.06.27,1,1,27,182,41,-141,A
SamuelJunior 2006.06.27,1,1,27,172,41,-131,B
supriyasodhi 2006.06.20,1,0,10,266,10,-256,A
supriyasodhi 2006.06.20,1,0,10,277,10,-267,B
ferking 2006.06.20,1,1,9,160,44,-116,A
ferking 2006.06.20,1,1,9,156,44,-112,B
Issaac 2003.02.28,1,0,8,184,12,-172,A
Issaac 2003.02.28,1,0,8,185,12,-173,B
dockson 2003.02.28,1,1,7,126,14,-112,A
dockson 2003.02.28,1,1,7,131,14,-117,B
nicolaus 2006.06.23,1,1,21,142,29,-113,A
nicolaus 2006.06.23,1,1,21,133,19,-114,B
Panzulo 2006.06.23,1,0,21,159,38,-121,A
Panzulo 2006.06.23,1,0,21,162,38,-124,B
Memnochblue 2006.05.26,4,1,59,227,27,-200,A
Memnochblue 2006.05.26,4,1,59,221,24,-197,B
jmlichtman 2006.05.26,2,1,14,219,14,-205,A
jmlichtman 2006.05.26,2,1,14,229,14,-215,B
FraserChapman 2005.08.28,1,0,12,232,8,-224,A
FraserChapman 2005.08.28,1,0,12,244,8,-236,B
Silicate 2005.08.28,1,1,14,204,21,-183,A
Silicate 2005.08.28,1,1,14,170,36,-134,B
LaFleurDeLys 2003.01.07,1,0,9,256,11,-245,A
LaFleurDeLys 2003.01.07,1,0,9,166,11,-155,B
coloradorover 2003.01.07,2,1,19,145,37,-108,A
coloradorover 2003.01.07,2,1,19,160,37,-123,B
Silicate 2005.08.29,1,0,22,146,36,-110,A
Silicate 2005.08.29,1,0,22,126,41,-85,B
DHunt 2005.08.29,1,1,26,236,19,-217,A
DHunt 2005.08.29,1,1,26,237,23,-214,B
SamuelJunior 2006.06.26,1,0,24,295,29,-266,A
SamuelJunior 2006.06.26,1,0,24,341,25,-316,B
paiura 2003.02.23,1,0,7,297,0,-297,A
paiura 2003.02.23,1,0,7,254,14,-240,B
PiNNO 2003.02.23,1,1,6,120,33,-87,A
PiNNO 2003.02.23,1,1,6,80,33,-47,B
Faydogg 2003.02.18,1,1,4,88,50,-38,A
Faydogg 2003.02.18,1,1,4,118,50,-68,B
KJett 2003.02.18,1,0,4,435,25,-410,A
KJett 2003.02.18,1,0,4,462,25,-437,B
KJett 2003.02.20,1,0,18,298,22,-276,A
KJett 2003.02.20,1,0,18,238,28,-210,B
claudiolozea 2003.02.20,1,1,17,167,29,-138,A
claudiolozea 2003.02.20,1,1,17,159,29,-130,B
KnightToRookSix 2003.02.02,1,1,30,71,37,-34,A
KnightToRookSix 2003.02.02,1,1,30,72,37,-35,B
WardBurtonfan 2003.02.02,1,0,32,127,31,-96,A
WardBurtonfan 2003.02.02,1,0,32,123,31,-92,B
WardBurtonfan 2003.01.24,1,0,8,166,38,-128,A
WardBurtonfan 2003.01.24,1,0,8,158,50,-108,B
CelticMoon 2003.01.24,2,2,15,300,13,-287,A
CelticMoon 2003.01.24,2,2,15,232,13,-219,B
crazycousins 2006.06.19,1,1,12,266,33,-233,A
crazycousins 2006.06.19,1,1,12,277,33,-244,B
twilc 2006.06.19,1,0,9,146,44,-102,A
twilc 2006.06.19,1,0,9,156,44,-112,B
WarlordNatick 2005.10.16,1,1,18,136,61,-75,A
WarlordNatick 2005.10.16,1,1,18,140,56,-84,B
rbb 2005.10.16,1,0,16,174,25,-149,A
rbb 2005.10.16,1,0,16,179,25,-154,B
KJett 2003.01.25,1,0,28,321,32,-289,A
KJett 2003.01.25,1,0,28,248,32,-216,B
Laddie 2002.12.26,2,2,23,94,43,-51,A
Laddie 2002.12.26,2,2,23,102,35,-67,B
skuller 2002.07.20,2,2,18,187,28,-159,A
skuller 2002.07.20,2,2,18,186,33,-153,B
aikloong 2002.07.20,2,0,20,303,30,-273,A
aikloong 2002.07.20,2,0,20,320,30,-290,B
ferking 2006.04.22,3,2.5,65,97,37,-60,A
ferking 2006.04.22,3,2.5,65,98,38,-60,B
Memnochblue 2006.04.22,3,0.5,68,144,34,-110,A
Memnochblue 2006.04.22,3,0.5,68,155,35,-120,B
pocheptsoff 2005.04.10,2,2,22,125,32,-93,A
pocheptsoff 2005.04.10,2,2,22,132,32,-100,B
talkymeat 2005.04.10,1,0,16,153,56,-97,A
talkymeat 2005.04.10,1,0,16,158,62,-96,B
lsilipo 2005.04.07,1,0,17,241,47,-194,A
lsilipo 2005.04.07,1,0,17,267,35,-232,B
Kyobutungi 2005.04.07,1,1,15,141,33,-108,A
Kyobutungi 2005.04.07,1,1,15,162,33,-129,B
counttell 2005.10.16,1,0.5,5,79,20,-59,A
counttell 2005.10.16,1,0.5,5,66,20,-46,B
TomJr 2005.10.16,1,0.5,6,491,33,-458,A
TomJr 2005.10.16,1,0.5,6,340,33,-307,B
mssronald 2003.02.13,1,0,16,283,25,-258,A
mssronald 2003.02.13,1,0,16,236,25,-211,B
eaglesloft 2003.02.13,1,1,13,129,8,-121,A
eaglesloft 2003.02.13,1,1,13,130,15,-115,B
Theodin 2005.10.20,1,0,24,198,42,-156,A
Theodin 2005.10.20,1,0,24,187,46,-141,B
rbb 2005.10.20,1,1,27,304,30,-274,A
rbb 2005.10.20,1,1,27,353,30,-323,B
jmlichtman 2006.06.07,1,0,4,246,0,-246,A
jmlichtman 2006.06.07,1,0,4,287,0,-287,B
fewral 2006.06.07,1,1,4,50,50,0,A
fewral 2006.06.07,1,1,4,68,25,-43,B
agathea 2006.05.31,1,1,15,169,27,-142,A
agathea 2006.05.31,1,1,15,184,27,-157,B
powendel 2006.05.31,1,0,14,290,14,-276,A
powendel 2006.05.31,1,0,14,246,14,-232,B
BishopDaMan 2005.10.08,1,0,15,233,20,-213,A
BishopDaMan 2005.10.08,1,0,15,219,33,-186,B
znode 2005.10.08,1,1,13,180,38,-142,A
znode 2005.10.08,1,1,13,195,38,-157,B
LaFleurDeLys 2003.01.24,1,0,9,476,22,-454,A
LaFleurDeLys 2003.01.24,1,0,9,499,11,-488,B
shipwrecked 2005.07.04,2,2,48,98,38,-60,A
shipwrecked 2005.07.04,2,2,48,111,37,-74,B
HEARTLESSWIZARD 2005.07.04,2,0,52,157,40,-117,A
HEARTLESSWIZARD 2005.07.04,2,0,52,178,38,-140,B
TLorD 2005.06.13,2,1,33,185,36,-149,A
TLorD 2005.06.13,2,1,33,194,30,-164,B
Shadax 2005.06.13,2,1,30,142,37,-105,A
Shadax 2005.06.13,2,1,30,138,43,-95,B
Trasimene 2002.08.11,1,1,5,337,20,-317,A
Trasimene 2002.08.11,1,1,5,302,20,-282,B
CashCow 2002.08.11,1,0,8,391,0,-391,A
CashCow 2002.08.11,1,0,8,378,0,-378,B
Paestka 2005.05.17,1,0,25,130,20,-110,A
Paestka 2005.05.17,1,0,25,125,20,-105,B
TEMH 2005.05.17,1,1,21,67,52,-15,A
TEMH 2005.05.17,1,1,21,69,43,-26,B
IvoSt 2006.06.09,1,1,9,18,89,71,A
IvoSt 2006.06.09,1,1,9,24,89,65,B
hungerartist 2006.06.09,1,0,9,218,33,-185,A
hungerartist 2006.06.09,1,0,9,201,33,-168,B
ModestNihilist 2005.09.28,1,1,13,159,23,-136,A
ModestNihilist 2005.09.28,1,1,13,181,23,-158,B
loserman 2005.09.28,1,0,13,246,38,-208,A
loserman 2005.09.28,1,0,13,263,31,-232,B
trovillion 2005.09.05,1,1,25,324,32,-292,A
trovillion 2005.09.05,1,1,25,302,32,-270,B
jcizotti 2005.09.05,1,0,24,358,25,-333,A
jcizotti 2005.09.05,1,0,24,370,25,-345,B
jonohelms 2005.09.26,1,1,19,177,21,-156,A
jonohelms 2005.09.26,1,1,19,168,16,-152,B
rtgreen 2005.09.26,1,0,19,192,21,-171,A
rtgreen 2005.09.26,1,0,19,171,21,-150,B
GolfBob 2006.05.23,1,1,35,112,43,-69,A
GolfBob 2006.05.23,1,1,35,125,37,-88,B
ferking 2006.05.23,1,0,41,263,24,-239,A
ferking 2006.05.23,1,0,41,273,24,-249,B
BothFeet 2005.08.26,1,0,31,286,32,-254,A
BothFeet 2005.08.26,1,0,31,287,29,-258,B
HEARTLESSWIZARD 2005.08.26,1,1,24,163,29,-134,A
HEARTLESSWIZARD 2005.08.26,1,1,24,175,21,-154,B
KirkB 2003.01.25,1,1,11,216,45,-171,A
KirkB 2003.01.25,1,1,11,224,36,-188,B
rochon 2005.09.18,1,0,12,214,33,-181,A
rochon 2005.09.18,1,0,12,199,42,-157,B
jcizotti 2005.09.18,1,1,10,281,10,-271,A
jcizotti 2005.09.18,1,1,10,259,10,-249,B
MartyL 2005.06.21,3,1,38,293,18,-275,A
MartyL 2005.06.21,3,1,38,291,16,-275,B
pohlie 2005.06.21,1,1,7,138,43,-95,A
pohlie 2005.06.21,1,1,7,144,57,-87,B
wreckncrew 2005.06.28,1,1,13,99,31,-68,A
wreckncrew 2005.06.28,1,1,13,92,31,-61,B
Rohein 2005.06.28,1,0,13,195,8,-187,A
Rohein 2005.06.28,1,0,13,201,8,-193,B
iansss 2006.04.27,1,0,13,200,38,-162,A
iansss 2006.04.27,1,0,13,218,46,-172,B
Breneric 2006.04.27,1,1,12,223,8,-215,A
Breneric 2006.04.27,1,1,12,229,17,-212,B
bigrig 2005.09.04,1,0,43,207,28,-179,A
bigrig 2005.09.04,1,0,43,205,30,-175,B
Silicate 2005.09.04,1,1,40,132,42,-90,A
Silicate 2005.09.04,1,1,40,131,45,-86,B
LaFleurDeLys 2003.01.22,1,0,20,231,20,-211,A
LaFleurDeLys 2003.01.22,1,0,20,245,15,-230,B
KaleidoscopeEyes 2002.12.30,1,0,11,244,36,-208,A
KaleidoscopeEyes 2002.12.30,1,0,11,221,36,-185,B
coloradorover 2002.12.30,1,1,10,120,20,-100,A
coloradorover 2002.12.30,1,1,10,95,30,-65,B
Silicate 2005.08.27,1,0,17,144,35,-109,A
Silicate 2005.08.27,1,0,17,144,35,-109,B
jrico 2005.08.27,1,1,16,96,19,-77,A
jrico 2005.08.27,1,1,16,105,19,-86,B
passports 2005.09.19,1,1,13,272,8,-264,A
passports 2005.09.19,1,1,13,255,15,-240,B
aadeeb 2005.09.19,1,0,11,258,18,-240,A
aadeeb 2005.09.19,1,0,11,240,18,-222,B
danielp 2006.05.27,1,1,20,104,60,-44,A
danielp 2006.05.27,1,1,20,113,50,-63,B
danielp 2006.05.27,1,1,20,115,45,-70,C
sixer 2006.05.27,1,0,21,198,24,-174,A
sixer 2006.05.27,1,0,21,202,29,-173,B
sixer 2006.05.27,1,0,21,212,29,-183,C
HEARTLESSWIZARD 2005.09.14,1,1,17,72,53,-19,A
HEARTLESSWIZARD 2005.09.14,1,1,17,53,53,0,B
GolfBob 2005.09.14,1,0,17,153,24,-129,A
GolfBob 2005.09.14,1,0,17,152,18,-134,B
BlackCavy 2003.01.30,1,1,5,95,20,-75,A
BlackCavy 2003.01.30,1,1,5,99,20,-79,B
Inasmuch 2003.01.30,1,0,6,436,0,-436,A
Inasmuch 2003.01.30,1,0,6,441,0,-441,B
Dehweh 2003.01.13,1,1,7,36,29,-7,A
Dehweh 2003.01.13,1,1,7,38,43,5,B
LaFleurDeLys 2003.01.13,1,0,8,270,0,-270,A
LaFleurDeLys 2003.01.13,1,0,8,233,0,-233,B
hfarnsworth 2005.10.05,1,0,10,424,10,-414,A
hfarnsworth 2005.10.05,1,0,10,268,20,-248,B
PacManVideoGame 2005.10.05,1,1,9,206,44,-162,A
PacManVideoGame 2005.10.05,1,1,9,213,22,-191,B
Silicate 2005.09.02,1,1,17,202,59,-143,A
Silicate 2005.09.02,1,1,17,200,59,-141,B
SChlebowski 2005.09.02,1,0,22,254,32,-222,A
SChlebowski 2005.09.02,1,0,22,258,32,-226,B
TomJr 2005.10.15,1,0,21,216,24,-192,A
TomJr 2005.10.15,1,0,21,215,24,-191,B
Unknowner 2005.10.15,1,1,20,169,35,-134,A
Unknowner 2005.10.15,1,1,20,165,35,-130,B
newbeeforu 2005.07.01,1,0,23,305,26,-279,A
newbeeforu 2005.07.01,1,0,23,297,39,-258,B
MartyL 2005.07.01,1,1,17,233,41,-192,A
MartyL 2005.07.01,1,1,17,160,47,-113,B
pinkdragon 2006.04.27,1,0,17,512,6,-506,A
pinkdragon 2006.04.27,1,0,17,534,0,-534,B
Ccannibal 2006.04.27,1,1,11,303,36,-267,A
Ccannibal 2006.04.27,1,1,11,178,36,-142,B
MischiMaestro 2005.04.20,6,4,76,160,37,-123,A
MischiMaestro 2005.04.20,6,4,76,164,34,-130,B
fboccardo 2005.04.20,10,4,118,192,33,-159,A
fboccardo 2005.04.20,10,4,118,185,34,-151,B
Silicate 2005.08.25,1,0,7,441,0,-441,A
Silicate 2005.08.25,1,0,7,403,0,-403,B
yellowbay 2005.08.25,1,1,5,105,60,-45,A
yellowbay 2005.08.25,1,1,5,94,60,-34,B
coloradorover 2003.01.08,1,1,9,257,0,-257,A
coloradorover 2003.01.08,1,1,9,194,0,-194,B
LaFleurDeLys 2003.01.08,1,0,12,424,8,-416,A
LaFleurDeLys 2003.01.08,1,0,12,435,0,-435,B
finsfan 2006.05.15,1,0.5,5,139,40,-99,A
finsfan 2006.05.15,1,0.5,5,139,40,-99,B
Tristania 2006.05.15,1,0.5,5,322,20,-302,A
Tristania 2006.05.15,1,0.5,5,283,20,-263,B
ferking 2006.05.26,2,2,40,210,40,-170,A
ferking 2006.05.26,2,2,40,197,35,-162,B
franciscotlima 2005.08.13,1,0,16,142,31,-111,A
franciscotlima 2005.08.13,1,0,16,137,38,-99,B
HGBoone 2005.08.13,1,1,15,82,47,-35,A
HGBoone 2005.08.13,1,1,15,79,40,-39,B
BlindRoundTower 2002.12.26,1,1,20,71,30,-41,A
BlindRoundTower 2002.12.26,1,1,20,92,30,-62,B
juwony 2005.08.07,1,0,4,534,0,-534,A
juwony 2005.08.07,1,0,4,528,0,-528,B
HEARTLESSWIZARD 2005.07.24,2,2,20,285,5,-280,A
HEARTLESSWIZARD 2005.07.24,2,2,20,271,5,-266,B
cjott 2005.07.24,2,0,21,292,33,-259,A
cjott 2005.07.24,2,0,21,265,38,-227,B
bttfman 2002.11.07,2,1.5,22,154,18,-136,A
bttfman 2002.11.07,2,1.5,22,151,18,-133,B
AceEvl 2002.11.07,2,0.5,24,158,33,-125,A
AceEvl 2002.11.07,2,0.5,24,149,25,-124,B
Faeriedragon 2003.01.10,1,1,19,172,32,-140,A
Faeriedragon 2003.01.10,1,1,19,171,32,-139,B
RDearman 2003.01.10,1,0,19,194,47,-147,A
RDearman 2003.01.10,1,0,19,201,47,-154,B
jbpuffer 2005.07.30,5,0,94,293,18,-275,A
jbpuffer 2005.07.30,5,0,94,284,18,-266,B
noogit 2005.07.30,3,3,58,175,26,-149,A
noogit 2005.07.30,3,3,58,164,22,-142,B
HEARTLESSWIZARD 2005.07.30,2,2,28,139,43,-96,A
HEARTLESSWIZARD 2005.07.30,2,2,28,136,36,-100,B
Ziggles 2005.07.30,1,0,18,142,28,-114,A
Ziggles 2005.07.30,1,0,18,121,33,-88,B
BothFeet 2005.07.13,2,2,23,136,43,-93,A
BothFeet 2005.07.13,2,2,23,120,43,-77,B
SkarryLarry 2005.07.13,2,0,27,296,15,-281,A
SkarryLarry 2005.07.13,2,0,27,282,19,-263,B
tuile 2005.07.02,1,1,4,179,25,-154,A
tuile 2005.07.02,1,1,4,255,25,-230,B
MikeRN 2002.11.13,1,1,4,210,25,-185,A
MikeRN 2002.11.13,1,1,4,115,25,-90,B
AceEvl 2002.11.13,2,0,31,286,23,-263,A
AceEvl 2002.11.13,2,0,31,263,19,-244,B
mrudy 2003.01.07,1,1,11,132,36,-96,A
mrudy 2003.01.07,1,1,11,129,27,-102,B
jujupieces 2005.09.02,1,0,24,318,29,-289,A
jujupieces 2005.09.02,1,0,24,342,21,-321,B
dafke 2005.09.02,1,1,20,230,15,-215,A
dafke 2005.09.02,1,1,20,234,15,-219,B
yihan 2002.12.26,2,2,39,108,33,-75,A
yihan 2002.12.26,2,2,39,100,33,-67,B
NathanBlair 2005.07.12,3,2,66,231,39,-192,A
NathanBlair 2005.07.12,3,2,66,212,36,-176,B
HEARTLESSWIZARD 2005.07.12,2,1,41,170,29,-141,A
HEARTLESSWIZARD 2005.07.12,2,1,41,163,24,-139,B
Ziggles 2005.07.27,1,1,18,203,22,-181,A
Ziggles 2005.07.27,1,1,18,197,22,-175,B
BothFeet 2005.07.27,1,0,18,283,28,-255,A
BothFeet 2005.07.27,1,0,18,250,33,-217,B
ooohtodd 2005.07.26,1,0,13,440,31,-409,A
ooohtodd 2005.07.26,1,0,13,411,23,-388,B
tmth 2005.07.26,1,1,11,196,54,-142,A
tmth 2005.07.26,1,1,11,211,54,-157,B
bonillaice 2005.08.15,1,1,7,267,29,-238,A
bonillaice 2005.08.15,1,1,7,268,29,-239,B
bigrig 2005.08.15,1,0,7,241,57,-184,A
bigrig 2005.08.15,1,0,7,239,57,-182,B
SaltzLynnMa 2006.05.03,1,0.5,49,138,45,-93,A
SaltzLynnMa 2006.05.03,1,0.5,49,133,43,-90,B
marcuscole 2006.05.03,1,0.5,45,130,33,-97,A
marcuscole 2006.05.03,1,0.5,45,115,36,-79,B
NathanBlair 2005.08.06,1,0.5,23,134,30,-104,A
NathanBlair 2005.08.06,1,0.5,23,128,35,-93,B
TravisBarker 2005.08.06,1,0.5,24,94,50,-44,A
TravisBarker 2005.08.06,1,0.5,24,100,46,-54,B
bigrig 2005.08.06,1,1,28,250,21,-229,A
bigrig 2005.08.06,1,1,28,248,21,-227,B
mascota 2005.08.06,1,0,27,205,33,-172,A
mascota 2005.08.06,1,0,27,194,33,-161,B
pohlie 2006.05.10,1,0,13,180,23,-157,A
pohlie 2006.05.10,1,0,13,173,15,-158,B
punkat 2006.05.10,1,1,11,84,36,-48,A
punkat 2006.05.10,1,1,11,81,36,-45,B
iansss 2006.05.05,1,1,8,231,25,-206,A
iansss 2006.05.05,1,1,8,165,25,-140,B
marcuscole 2006.05.05,1,0,8,246,50,-196,A
marcuscole 2006.05.05,1,0,8,226,50,-176,B
HEARTLESSWIZARD 2005.08.17,1,1,22,159,23,-136,A
HEARTLESSWIZARD 2005.08.17,1,1,22,172,23,-149,B
pezzissimo 2005.08.17,1,0,23,173,44,-129,A
pezzissimo 2005.08.17,1,0,23,171,44,-127,B
loserman 2006.04.29,1,1,4,37,50,13,A
loserman 2006.04.29,1,1,4,83,50,-33,B
Hsquare 2006.04.29,1,0,5,279,0,-279,A
Hsquare 2006.04.29,1,0,5,346,0,-346,B
iveyjr 2005.04.06,1,0,12,223,17,-206,A
iveyjr 2005.04.06,1,0,12,234,8,-226,B
Homki 2005.04.06,1,1,10,85,10,-75,A
Homki 2005.04.06,1,1,10,93,20,-73,B
tkdman 2005.07.29,1,1,4,178,0,-178,A
tkdman 2005.07.29,1,1,4,194,0,-194,B
jbpuffer 2005.07.29,1,0,6,446,0,-446,A
jbpuffer 2005.07.29,1,0,6,493,0,-493,B
iascrazyorioles 2006.05.07,1,1,5,180,20,-160,A
iascrazyorioles 2006.05.07,1,1,5,186,20,-166,B
DEDEE 2006.05.07,1,0,7,341,14,-327,A
DEDEE 2006.05.07,1,0,7,372,14,-358,B
ooohtodd 2005.07.12,1,0,20,300,40,-260,A
ooohtodd 2005.07.12,1,0,20,274,30,-244,B
LOZO 2005.08.14,1,0,48,122,38,-84,A
LOZO 2005.08.14,1,0,48,128,40,-88,B
jessmoll 2005.08.14,1,1,49,127,47,-80,A
jessmoll 2005.08.14,1,1,49,124,43,-81,B
pacetaker 2002.12.26,1,1,9,124,44,-80,A
pacetaker 2002.12.26,1,1,9,109,56,-53,B
Tibmag 2005.07.11,1,1,19,70,37,-33,A
Tibmag 2005.07.11,1,1,19,56,37,-19,B
MTSimkus 2005.07.11,1,0,20,112,25,-87,A
MTSimkus 2005.07.11,1,0,20,93,35,-58,B
Halfman 2006.04.24,1,1,12,78,25,-53,A
Halfman 2006.04.24,1,1,12,82,25,-57,B
wolfla 2006.04.24,1,0,12,161,17,-144,A
wolfla 2006.04.24,1,0,12,166,17,-149,B
fboccardo 2005.04.19,1,1,24,111,42,-69,A
fboccardo 2005.04.19,1,1,24,97,38,-59,B
giannhsk 2005.04.19,1,0,24,186,42,-144,A
giannhsk 2005.04.19,1,0,24,175,33,-142,B
garethcash 2005.04.20,3,1,36,167,33,-134,A
garethcash 2005.04.20,3,1,36,199,33,-166,B
HEARTLESSWIZARD 2005.07.22,1,1,14,101,21,-80,A
HEARTLESSWIZARD 2005.07.22,1,1,14,171,21,-150,B
iveyjr 2005.07.22,1,0,14,204,36,-168,A
iveyjr 2005.07.22,1,0,14,216,29,-187,B
artir 2005.06.21,1,0,14,64,50,-14,A
artir 2005.06.21,1,0,14,55,50,-5,B
TLorD 2005.06.08,1,1,24,94,54,-40,A
TLorD 2005.06.08,1,1,24,60,46,-14,B
HEARTLESSWIZARD 2005.06.08,1,0,28,121,25,-96,A
HEARTLESSWIZARD 2005.06.08,1,0,28,122,25,-97,B
doomie 2006.04.19,1,1,17,110,53,-57,A
doomie 2006.04.19,1,1,17,111,47,-64,B
ferking 2006.04.19,1,0,16,135,31,-104,A
ferking 2006.04.19,1,0,16,127,31,-96,B
iveyjr 2005.04.07,1,0,13,315,15,-300,A
iveyjr 2005.04.07,1,0,13,294,15,-279,B
DKG 2005.04.07,1,1,12,202,42,-160,A
DKG 2005.04.07,1,1,12,179,42,-137,B
BothFeet 2005.07.11,1,1,9,150,22,-128,A
BothFeet 2005.07.11,1,1,9,133,33,-100,B
bonillaice 2005.07.11,1,0,9,250,22,-228,A
bonillaice 2005.07.11,1,0,9,235,22,-213,B
Freakyflow 2005.07.30,1,1,7,72,14,-58,A
Freakyflow 2005.07.30,1,1,7,80,14,-66,B
zebrafish 2006.04.29,1,1,18,120,17,-103,A
zebrafish 2006.04.29,1,1,18,110,28,-82,B
aBlade 2006.04.29,1,0,19,205,37,-168,A
aBlade 2006.04.29,1,0,19,205,37,-168,B
pezzissimo 2005.06.13,1,0,19,225,21,-204,A
pezzissimo 2005.06.13,1,0,19,249,16,-233,B
johnoleary 2005.06.13,1,1,18,146,50,-96,A
johnoleary 2005.06.13,1,1,18,167,44,-123,B
iansss 2006.05.06,1,1,16,151,31,-120,A
iansss 2006.05.06,1,1,16,166,25,-141,B
morts 2006.05.06,1,0,19,339,47,-292,A
morts 2006.05.06,1,0,19,350,32,-318,B
Reeco 2005.07.23,1,1,19,320,26,-294,A
Reeco 2005.07.23,1,1,19,343,16,-327,B
bonillaice 2005.07.23,1,0,19,363,10,-353,A
bonillaice 2005.07.23,1,0,19,363,16,-347,B
doubleo 2005.06.29,1,0.5,28,193,25,-168,A
doubleo 2005.06.29,1,0.5,28,179,25,-154,B
BothFeet 2005.06.29,1,0.5,24,158,33,-125,A
BothFeet 2005.06.29,1,0.5,24,136,21,-115,B
bttfman 2002.11.13,1,1,25,217,16,-201,A
bttfman 2002.11.13,1,1,25,215,16,-199,B
undersoft 2005.06.23,1,1,11,255,36,-219,A
undersoft 2005.06.23,1,1,11,269,27,-242,B
MartyL 2005.06.23,1,0,14,456,7,-449,A
MartyL 2005.06.23,1,0,14,378,7,-371,B
ooohtodd 2005.07.15,1,0,16,224,19,-205,A
ooohtodd 2005.07.15,1,0,16,223,19,-204,B
mascota 2005.07.15,1,1,14,141,50,-91,A
mascota 2005.07.15,1,1,14,142,50,-92,B
ooohtodd 2005.07.18,1,1,14,201,29,-172,A
ooohtodd 2005.07.18,1,1,14,190,29,-161,B
BothFeet 2005.07.18,1,0,15,322,20,-302,A
BothFeet 2005.07.18,1,0,15,256,20,-236,B
caleas 2002.09.20,1,1,19,106,37,-69,A
caleas 2002.09.20,1,1,19,114,42,-72,B
younder 2002.09.20,1,0,18,114,33,-81,A
younder 2002.09.20,1,0,18,124,28,-96,B
wolfla 2006.04.25,2,1,28,279,21,-258,A
wolfla 2006.04.25,2,1,28,285,14,-271,B
nicolaus 2006.04.25,2,1,27,261,33,-228,A
nicolaus 2006.04.25,2,1,27,252,33,-219,B
hwm 2005.04.28,1,0,8,384,12,-372,A
hwm 2005.04.28,1,0,8,329,12,-317,B
Intredcode 2005.04.28,1,1,6,121,33,-88,A
Intredcode 2005.04.28,1,1,6,68,33,-35,B
iveyjr 2005.03.23,8,2,156,257,26,-231,A
iveyjr 2005.03.23,8,2,156,248,25,-223,B
FJB 2005.03.23,13,10.5,258,162,31,-131,A
FJB 2005.03.23,13,10.5,258,164,29,-135,B
FJB 2005.03.15,1,0,12,223,17,-206,A
FJB 2005.03.15,1,0,12,220,8,-212,B
dockson 2005.03.15,1,1,13,241,31,-210,A
dockson 2005.03.15,1,1,13,240,23,-217,B
Joinedup 2005.02.22,1,0,20,208,45,-163,A
Joinedup 2005.02.22,1,0,20,212,35,-177,B
ultradude 2005.02.22,1,1,20,249,20,-229,A
ultradude 2005.02.22,1,1,20,188,25,-163,B
HEARTLESSWIZARD 2005.07.02,1,0,18,231,11,-220,A
HEARTLESSWIZARD 2005.07.02,1,0,18,227,17,-210,B
ClaesF 2006.04.08,1,0,19,293,5,-288,A
ClaesF 2006.04.08,1,0,19,295,5,-290,B
Yesu 2006.04.08,1,1,17,202,29,-173,A
Yesu 2006.04.08,1,1,17,168,29,-139,B
nicknator 2006.05.04,1,1,9,155,22,-133,A
nicknator 2006.05.04,1,1,9,196,22,-174,B
Nemobxl 2006.05.04,1,0,9,266,22,-244,A
Nemobxl 2006.05.04,1,0,9,279,22,-257,B
MartyL 2005.06.26,1,1,9,128,44,-84,A
MartyL 2005.06.26,1,1,9,137,44,-93,B
Scottrick 2005.06.26,1,0,10,320,30,-290,A
Scottrick 2005.06.26,1,0,10,340,30,-310,B
Caledonian 2006.05.02,1,0,8,309,38,-271,A
Caledonian 2006.05.02,1,0,8,331,38,-293,B
tuile 2006.05.02,1,1,2,142,150,8,A
tuile 2006.05.02,1,1,2,0,100,100,B
pohlie 2005.06.30,1,1,32,157,34,-123,A
pohlie 2005.06.30,1,1,32,151,34,-117,B
shipwrecked 2005.06.30,1,0,29,137,45,-92,A
shipwrecked 2005.06.30,1,0,29,140,45,-95,B
matingrituals 2006.05.03,1,0,16,204,31,-173,A
matingrituals 2006.05.03,1,0,16,169,25,-144,B
Cybersun 2006.05.03,1,1,15,88,40,-48,A
Cybersun 2006.05.03,1,1,15,64,40,-24,B
amajouity 2002.08.02,1,0,30,273,33,-240,A
amajouity 2002.08.02,1,0,30,282,33,-249,B
Trasimene 2002.08.02,1,1,28,243,29,-214,A
Trasimene 2002.08.02,1,1,28,260,29,-231,B
schachmatze 2006.04.21,1,1,14,178,36,-142,A
schachmatze 2006.04.21,1,1,14,174,36,-138,B
Nemobxl 2006.04.21,1,0,21,367,19,-348,A
Nemobxl 2006.04.21,1,0,21,376,19,-357,B
lsilipo 2005.04.22,1,1,24,152,38,-114,A
lsilipo 2005.04.22,1,1,24,139,42,-97,B
pawnpeddler 2005.04.22,1,0,22,191,32,-159,A
pawnpeddler 2005.04.22,1,0,22,161,41,-120,B
pezzissimo 2005.06.14,1,0.5,81,115,32,-83,A
pezzissimo 2005.06.14,1,0.5,81,95,32,-63,B
Kyobutungi 2005.06.14,1,0.5,88,150,26,-124,A
Kyobutungi 2005.06.14,1,0.5,88,170,26,-144,B
knightscastle 2002.10.20,1,0,27,314,18,-296,A
knightscastle 2002.10.20,1,0,27,283,18,-265,B
chrisyacoub 2002.10.20,1,1,26,215,46,-169,A
chrisyacoub 2002.10.20,1,1,26,218,42,-176,B
youngrower 2005.05.06,2,2,12,59,50,-9,A
youngrower 2005.05.06,2,2,12,44,58,14,B
Paestka 2005.05.06,2,0,13,256,15,-241,A
Paestka 2005.05.06,2,0,13,234,15,-219,B
aafire 2006.04.19,1,1,21,55,43,-12,A
aafire 2006.04.19,1,1,21,50,48,-2,B
Cybersun 2006.04.19,1,0,24,187,17,-170,A
Cybersun 2006.04.19,1,0,24,193,17,-176,B
vav 2002.11.09,1,0,25,294,28,-266,A
vav 2002.11.09,1,0,25,290,32,-258,B
cutenuke 2002.11.09,1,1,22,226,14,-212,A
cutenuke 2002.11.09,1,1,22,242,18,-224,B
Paestka 2005.05.16,1,0,21,240,19,-221,A
Paestka 2005.05.16,1,0,21,217,24,-193,B
CooperW 2005.05.16,1,1,19,182,32,-150,A
CooperW 2005.05.16,1,1,19,159,32,-127,B
hwm 2005.04.30,1,0,17,284,29,-255,A
hwm 2005.04.30,1,0,17,276,41,-235,B
LEOUTSAKOS 2005.04.30,1,1,15,270,27,-243,A
LEOUTSAKOS 2005.04.30,1,1,15,238,33,-205,B
Kyobutungi 2005.04.25,1,0,27,178,41,-137,A
Kyobutungi 2005.04.25,1,0,27,192,41,-151,B
lsilipo 2005.04.25,1,1,21,96,43,-53,A
lsilipo 2005.04.25,1,1,21,92,38,-54,B
entanglement 2005.06.21,1,1,13,295,31,-264,A
entanglement 2005.06.21,1,1,13,266,31,-235,B
HEARTLESSWIZARD 2005.06.19,1,1,59,301,27,-274,A
HEARTLESSWIZARD 2005.06.19,1,1,59,302,32,-270,B
Schuerer 2005.06.19,1,0,52,200,27,-173,A
Schuerer 2005.06.19,1,0,52,211,31,-180,B
chrisyacoub 2002.08.09,1,0,17,300,35,-265,A
chrisyacoub 2002.08.09,1,0,17,286,47,-239,B
MikeRN 2002.08.09,1,1,14,188,29,-159,A
MikeRN 2002.08.09,1,1,14,183,29,-154,B
OboeDeity 2005.05.03,1,1,6,196,0,-196,A
OboeDeity 2005.05.03,1,1,6,166,0,-166,B
fboccardo 2005.05.03,1,0,7,434,0,-434,A
fboccardo 2005.05.03,1,0,7,440,0,-440,B
injunt 2005.04.10,1,0,5,245,40,-205,A
injunt 2005.04.10,1,0,5,260,60,-200,B
dldnjstjq 2005.05.02,1,0,12,169,25,-144,A
dldnjstjq 2005.05.02,1,0,12,157,33,-124,B
iveyjr 2005.05.02,1,1,11,120,18,-102,A
iveyjr 2005.05.02,1,1,11,101,27,-74,B
JWest 2002.07.30,1,1,8,204,62,-142,A
JWest 2002.07.30,1,1,8,194,62,-132,B
Trasimene 2002.07.30,1,0,7,337,14,-323,A
Trasimene 2002.07.30,1,0,7,345,14,-331,B
BlueKeyboard 2005.05.06,1,1,30,240,23,-217,A
BlueKeyboard 2005.05.06,1,1,30,248,23,-225,B
hwm 2005.05.06,1,0,34,351,21,-330,A
hwm 2005.05.06,1,0,34,383,26,-357,B
muselaers 2005.05.12,1,1,12,24,58,34,A
muselaers 2005.05.12,1,1,12,13,67,54,B
Paestka 2005.05.12,1,0,18,101,28,-73,A
Paestka 2005.05.12,1,0,18,125,22,-103,B
OboeDeity 2005.04.23,2,1,38,127,32,-95,A
OboeDeity 2005.04.23,2,1,38,109,37,-72,B
iveyjr 2005.04.23,2,1,40,142,35,-107,A
iveyjr 2005.04.23,2,1,40,131,30,-101,B
owenbagge 2002.07.24,1,1,7,143,14,-129,A
owenbagge 2002.07.24,1,1,7,140,29,-111,B
pacetaker 2002.07.24,1,0,7,260,29,-231,A
pacetaker 2002.07.24,1,0,7,256,43,-213,B
exaanil 2006.04.23,1,1,16,214,38,-176,A
exaanil 2006.04.23,1,1,16,219,38,-181,B
zebrafish 2006.04.23,1,0,16,285,25,-260,A
zebrafish 2006.04.23,1,0,16,289,25,-264,B
mcco 2005.04.20,1,1,6,172,33,-139,A
mcco 2005.04.20,1,1,6,179,33,-146,B
JuliusG 2006.03.30,1,1,25,191,36,-155,A
JuliusG 2006.03.30,1,1,25,190,24,-166,B
ferking 2006.03.30,1,0,26,254,19,-235,A
ferking 2006.03.30,1,0,26,257,19,-238,B
dustbuni 2006.04.25,1,0,8,416,0,-416,A
dustbuni 2006.04.25,1,0,8,404,0,-404,B
Cybersun 2006.04.25,1,1,7,236,14,-222,A
Cybersun 2006.04.25,1,1,7,208,29,-179,B
ferking 2006.04.24,1,1,11,132,0,-132,A
ferking 2006.04.24,1,1,11,125,9,-116,B
Memnochblue 2006.04.24,1,0,11,192,18,-174,A
Memnochblue 2006.04.24,1,0,11,208,18,-190,B
lager 2002.04.16,1,0,6,97,67,-30,A
lager 2002.04.16,1,0,6,130,50,-80,B
ReiJay 2002.04.16,1,1,6,170,17,-153,A
ReiJay 2002.04.16,1,1,6,154,17,-137,B
iveyjr 2005.03.26,1,0,19,276,21,-255,A
iveyjr 2005.03.26,1,0,19,270,16,-254,B
debateking 2005.03.26,1,1,16,320,25,-295,A
debateking 2005.03.26,1,1,16,387,19,-368,B
FJB 2005.03.17,5,1.5,70,168,27,-141,A
FJB 2005.03.17,5,1.5,70,168,20,-148,B
GolfBob 2005.03.17,1,0,20,173,10,-163,A
GolfBob 2005.03.17,1,0,20,178,10,-168,B
Cybersun 2006.04.24,1,0,17,305,18,-287,A
Cybersun 2006.04.24,1,0,17,275,18,-257,B
Bossdog 2006.04.24,1,1,19,404,10,-394,A
Bossdog 2006.04.24,1,1,19,419,16,-403,B
aikloong 2002.07.03,1,0,6,282,17,-265,A
aikloong 2002.07.03,1,0,6,258,17,-241,B
skuller 2002.07.03,1,1,5,21,80,59,A
skuller 2002.07.03,1,1,5,30,60,30,B
Memnochblue 2006.04.10,1,0,11,404,9,-395,A
Memnochblue 2006.04.10,1,0,11,408,18,-390,B
Nemobxl 2006.04.10,1,1,8,207,38,-169,A
Nemobxl 2006.04.10,1,1,8,209,25,-184,B
fboccardo 2005.04.18,5,1.0,124,146,32,-114,A
fboccardo 2005.04.18,5,1.0,124,135,33,-102,B
garethcash 2005.04.18,4,3.0,116,144,34,-110,A
garethcash 2005.04.18,4,3.0,116,144,31,-113,B
skuller 2002.07.07,1,1,5,426,0,-426,A
skuller 2002.07.07,1,1,5,467,0,-467,B
aikloong 2002.07.07,1,0,8,447,25,-422,A
aikloong 2002.07.07,1,0,8,465,38,-427,B
FJB 2005.04.01,1,0,5,430,20,-410,A
FJB 2005.04.01,1,0,5,453,0,-453,B
Mailo 2005.04.01,1,1,4,61,75,14,A
Mailo 2005.04.01,1,1,4,40,75,35,B
Bossdog 2006.04.10,1,1,20,214,30,-184,A
Bossdog 2006.04.10,1,1,20,215,30,-185,B
Etka 2006.04.10,1,0,16,274,25,-249,A
Etka 2006.04.10,1,0,16,263,31,-232,B
garethcash 2005.04.22,2,2,49,138,27,-111,A
garethcash 2005.04.22,2,2,49,131,29,-102,B
fboccardo 2005.04.22,2,0,54,216,31,-185,A
fboccardo 2005.04.22,2,0,54,220,33,-187,B
MischiMaestro 2005.04.18,1,1,8,253,12,-241,A
MischiMaestro 2005.04.18,1,1,8,242,12,-230,B
utsutso 2002.05.12,1,0,16,258,12,-246,A
utsutso 2002.05.12,1,0,16,233,19,-214,B
whatbomb 2002.05.12,1,1,14,92,50,-42,A
whatbomb 2002.05.12,1,1,14,58,50,-8,B
SpacedCadet 2002.01.25,3,2,31,226,23,-203,A
SpacedCadet 2002.01.25,3,2,31,222,23,-199,B
Gaby 2002.01.25,3,1,31,275,32,-243,A
Gaby 2002.01.25,3,1,31,276,32,-244,B
debateking 2005.03.27,1,1,18,223,50,-173,A
debateking 2005.03.27,1,1,18,161,50,-111,B
iveyjr 2005.03.27,2,0,34,240,29,-211,A
iveyjr 2005.03.27,2,0,34,241,32,-209,B
debateking 2005.03.24,1,1,12,179,17,-162,A
debateking 2005.03.24,1,1,12,169,17,-152,B
iveyjr 2005.03.24,2,1,28,235,25,-210,A
iveyjr 2005.03.24,2,1,28,209,36,-173,B
Kyobutungi 2005.03.24,1,0,15,193,13,-180,A
Kyobutungi 2005.03.24,1,0,15,164,20,-144,B
varchata 2002.06.07,1,0,23,336,26,-310,A
varchata 2002.06.07,1,0,23,277,26,-251,B
amajouity 2002.06.07,1,1,14,190,21,-169,A
amajouity 2002.06.07,1,1,14,192,29,-163,B
lsilipo 2005.04.10,1,0,13,264,23,-241,A
lsilipo 2005.04.10,1,0,13,273,23,-250,B
diamonds 2005.04.10,1,1,10,79,60,-19,A
diamonds 2005.04.10,1,1,10,54,60,6,B
Mxkuma 2005.03.23,5,0.5,130,227,24,-203,A
Mxkuma 2005.03.23,5,0.5,130,217,24,-193,B
danlei 2006.04.09,1,0.5,44,173,25,-148,A
danlei 2006.04.09,1,0.5,44,164,32,-132,B
Bossdog 2006.04.09,1,0.5,44,172,23,-149,A
Bossdog 2006.04.09,1,0.5,44,172,20,-152,B
FJB 2005.03.22,9,8,94,182,31,-151,A
FJB 2005.03.22,9,8,94,168,31,-137,B
Hamhawk 2005.03.22,2,0,19,391,5,-386,A
Hamhawk 2005.03.22,2,0,19,396,11,-385,B
cpinya 2006.03.29,3,2,29,181,31,-150,A
cpinya 2006.03.29,3,2,29,170,41,-129,B
schnootzer 2006.03.29,5,3,42,202,31,-171,A
schnootzer 2006.03.29,5,3,42,169,36,-133,B
iveyjr 2005.04.03,1,0,15,305,27,-278,A
iveyjr 2005.04.03,1,0,15,294,27,-267,B
FJB 2005.04.03,1,1,18,325,39,-286,A
FJB 2005.04.03,1,1,18,321,39,-282,B
lager 2002.04.12,1,0,17,384,29,-355,A
lager 2002.04.12,1,0,17,391,24,-367,B
Endymion 2002.04.12,1,1,15,277,27,-250,A
Endymion 2002.04.12,1,1,15,270,27,-243,B
Devonaster 2000.04.05,1,0,5,347,20,-327,A
Devonaster 2000.04.05,1,0,5,341,20,-321,B
chessmon 2000.04.05,1,1,4,268,25,-243,A
chessmon 2000.04.05,1,1,4,259,50,-209,B
HEARTLESSWIZARD 2004.10.09,1,1,22,173,27,-146,A
HEARTLESSWIZARD 2004.10.09,1,1,22,200,32,-168,B
drevilrocks 2004.10.09,1,0,31,407,23,-384,A
drevilrocks 2004.10.09,1,0,31,429,19,-410,B
mcgrail 2006.03.02,5,0,50,151,22,-129,A
mcgrail 2006.03.02,5,0,50,147,24,-123,B
toha 2006.03.02,1,1,4,19,75,56,A
toha 2006.03.02,1,1,4,8,75,67,B
Halfman 2006.03.01,3,3,35,132,43,-89,A
Halfman 2006.03.01,3,3,35,141,34,-107,B
mcgrail 2006.03.01,3,0.5,60,174,23,-151,A
mcgrail 2006.03.01,3,0.5,60,165,23,-142,B
americanista 2006.01.01,1,1,14,190,21,-169,A
americanista 2006.01.01,1,1,14,192,29,-163,B
Halfman 2006.01.01,1,0,14,210,43,-167,A
Halfman 2006.01.01,1,0,14,220,43,-177,B
medilein 2005.03.28,1,1,16,186,50,-136,A
medilein 2005.03.28,1,1,16,178,44,-134,B
iveyjr 2005.03.28,1,0,17,182,35,-147,A
iveyjr 2005.03.28,1,0,17,184,35,-149,B
iveyjr 2005.03.22,8,1,106,268,14,-254,A
iveyjr 2005.03.22,8,1,106,273,15,-258,B
FJB 2005.03.27,1,1,14,354,29,-325,A
FJB 2005.03.27,1,1,14,368,29,-339,B
JuliusG 2006.04.01,1,1,25,163,36,-127,A
JuliusG 2006.04.01,1,1,25,139,40,-99,B
ninox 2006.04.01,1,0,21,104,38,-66,A
ninox 2006.04.01,1,0,21,109,33,-76,B
LeCrabe 2002.06.07,1,1,29,176,28,-148,A
LeCrabe 2002.06.07,1,1,29,183,28,-155,B
Guuyver 2002.06.07,1,0,28,182,43,-139,A
Guuyver 2002.06.07,1,0,28,189,43,-146,B
HEARTLESSWIZARD 2005.03.25,1,0,17,190,24,-166,A
HEARTLESSWIZARD 2005.03.25,1,0,17,179,18,-161,B
GolfBob 2005.03.25,1,1,16,169,6,-163,A
GolfBob 2005.03.25,1,1,16,143,6,-137,B
loserman 2006.03.29,1,0,10,204,30,-174,A
loserman 2006.03.29,1,0,10,154,20,-134,B
nicolaus 2006.03.29,2,0,13,233,8,-225,A
nicolaus 2006.03.29,2,0,13,220,8,-212,B
Nemobxl 2006.03.30,1,0,19,177,32,-145,A
Nemobxl 2006.03.30,1,0,19,164,32,-132,B
Nemobxl 2006.03.30,1,0,19,184,32,-152,C
hydek 2006.03.30,1,1,20,201,40,-161,A
hydek 2006.03.30,1,1,20,202,50,-152,B
hydek 2006.03.30,1,1,20,210,45,-165,C
amajouity 2002.06.27,1,0,15,218,33,-185,A
amajouity 2002.06.27,1,0,15,221,33,-188,B
owenbagge 2002.06.27,1,1,10,61,60,-1,A
owenbagge 2002.06.27,1,1,10,64,50,-14,B
FJB 2005.03.21,7,5.5,88,176,26,-150,A
FJB 2005.03.21,7,5.5,88,169,25,-144,B
GolfBob 2005.03.21,1,0,7,347,43,-304,A
GolfBob 2005.03.21,1,0,7,365,29,-336,B
iveyjr 2005.03.21,6,1.5,87,202,30,-172,A
iveyjr 2005.03.21,6,1.5,87,189,30,-159,B
Guuyver 2002.05.17,1,0,41,120,24,-96,A
Guuyver 2002.05.17,1,0,41,120,22,-98,B
owlman 2002.05.17,1,1,42,112,14,-98,A
owlman 2002.05.17,1,1,42,108,29,-79,B
amajouity 2002.04.02,2,1,42,292,19,-273,A
amajouity 2002.04.02,2,1,42,263,21,-242,B
kingmicah 2002.04.02,2,1,41,273,27,-246,A
kingmicah 2002.04.02,2,1,41,268,27,-241,B
Kinkajou 2005.03.16,1,1,5,81,20,-61,A
Kinkajou 2005.03.16,1,1,5,99,20,-79,B
beeyes 2005.03.16,1,0,7,339,0,-339,A
beeyes 2005.03.16,1,0,7,371,0,-371,B
basitian 2005.03.14,2,0,44,214,27,-187,A
basitian 2005.03.14,2,0,44,216,23,-193,B
FJB 2005.03.14,4,2,57,222,28,-194,A
FJB 2005.03.14,4,2,57,198,26,-172,B
ferking 2006.03.16,1,0,20,281,10,-271,A
ferking 2006.03.16,1,0,20,307,10,-297,B
SUNNYMAN 2006.03.16,1,1,17,204,24,-180,A
SUNNYMAN 2006.03.16,1,1,17,181,24,-157,B
nosek 2005.03.17,2,1.5,25,88,56,-32,A
nosek 2005.03.17,2,1.5,25,86,48,-38,B
JuliusG 2006.03.26,1,0,26,168,27,-141,A
JuliusG 2006.03.26,1,0,26,148,23,-125,B
ninox 2006.03.26,1,1,25,121,28,-93,A
ninox 2006.03.26,1,1,25,106,36,-70,B
Kyobutungi 2005.03.22,1,1,14,196,29,-167,A
Kyobutungi 2005.03.22,1,1,14,188,21,-167,B
HOOT 2002.03.03,1,1,12,104,33,-71,A
HOOT 2002.03.03,1,1,12,82,50,-32,B
Cahta 2002.03.03,1,0,16,153,12,-141,A
Cahta 2002.03.03,1,0,16,157,25,-132,B
FJB 2005.03.16,1,1,30,325,27,-298,A
FJB 2005.03.16,1,1,30,318,23,-295,B
basitian 2005.03.16,1,0,27,359,30,-329,A
basitian 2005.03.16,1,0,27,278,33,-245,B
RoKStAR 2006.03.29,1,1,16,327,25,-302,A
RoKStAR 2006.03.29,1,1,16,325,31,-294,B
petergriffin 2006.03.22,1,1,26,137,35,-102,A
petergriffin 2006.03.22,1,1,26,137,35,-102,B
Tarish 2006.03.22,1,0,24,153,38,-115,A
Tarish 2006.03.22,1,0,24,163,25,-138,B
alexcardoso 2004.07.22,2,2,28,190,21,-169,A
alexcardoso 2004.07.22,2,2,28,183,25,-158,B
twno 2004.07.22,2,0,33,278,15,-263,A
twno 2004.07.22,2,0,33,265,15,-250,B
supertintin 2004.07.27,1,0.5,69,108,51,-57,A
supertintin 2004.07.27,1,0.5,69,123,52,-71,B
supertintin 2004.07.27,1,0.5,69,117,49,-68,C
southwestco 2004.07.27,1,0.5,52,79,23,-56,A
southwestco 2004.07.27,1,0.5,52,86,25,-61,B
southwestco 2004.07.27,1,0.5,52,98,25,-73,C
icman 2005.03.04,1,1,11,62,73,11,A
icman 2005.03.04,1,1,11,64,73,9,B
youngrower 2005.03.04,1,0,11,152,18,-134,A
youngrower 2005.03.04,1,0,11,154,9,-145,B
olzie 2005.03.17,1,1,12,150,25,-125,A
olzie 2005.03.17,1,1,12,141,17,-124,B
AaronH 2002.01.06,1,0,7,208,14,-194,A
AaronH 2002.01.06,1,0,7,207,14,-193,B
peruzzi 2002.01.06,1,1,6,52,17,-35,A
peruzzi 2002.01.06,1,1,6,50,33,-17,B
FJB 2005.03.11,2,0,30,268,10,-258,A
FJB 2005.03.11,2,0,30,263,13,-250,B
dockson 2005.03.11,1,1,21,118,24,-94,A
dockson 2005.03.11,1,1,21,111,24,-87,B
honte 2005.03.14,1,1,6,286,0,-286,A
honte 2005.03.14,1,1,6,298,0,-298,B
Krandall 2006.03.20,1,1,27,156,26,-130,A
Krandall 2006.03.20,1,1,27,144,26,-118,B
Halfman 2006.03.20,1,0,25,96,36,-60,A
Halfman 2006.03.20,1,0,25,100,40,-60,B
schnootzer 2006.03.28,2,0,34,192,44,-148,A
schnootzer 2006.03.28,2,0,34,198,35,-163,B
cpinya 2006.03.28,1,1,21,179,43,-136,A
cpinya 2006.03.28,1,1,21,164,48,-116,B
calibra 2001.12.27,1,1,10,99,40,-59,A
calibra 2001.12.27,1,1,10,67,30,-37,B
Gaby 2001.12.27,1,0,12,288,42,-246,A
Gaby 2001.12.27,1,0,12,273,42,-231,B
BollNCSU 2001.07.30,3,0,34,206,24,-182,A
BollNCSU 2001.07.30,3,0,34,235,21,-214,B
Gaby 2001.07.30,3,3,39,258,18,-240,A
Gaby 2001.07.30,3,3,39,246,21,-225,B
prowlerecmo 2001.05.21,1,1,5,50,40,-10,A
prowlerecmo 2001.05.21,1,1,5,42,40,-2,B
schorny 2001.05.21,1,0,5,275,0,-275,A
schorny 2001.05.21,1,0,5,272,0,-272,B
Damagical 2006.03.26,1,1,9,189,22,-167,A
Damagical 2006.03.26,1,1,9,218,11,-207,B
KoolBreez 2006.03.26,1,0,9,292,33,-259,A
KoolBreez 2006.03.26,1,0,9,304,22,-282,B
Kenchan 2001.10.06,1,1,6,55,67,12,A
Kenchan 2001.10.06,1,1,6,18,83,65,B
CashCow 2001.10.06,1,0,6,310,17,-293,A
CashCow 2001.10.06,1,0,6,272,17,-255,B
IIpawnII 2000.02.02,4,3.0,107,133,34,-99,A
IIpawnII 2000.02.02,4,3.0,107,124,32,-92,B
Knighter 2000.02.02,9,3.0,214,152,33,-119,A
Knighter 2000.02.02,9,3.0,214,145,31,-114,B
basitian 2005.03.17,1,1,8,86,38,-48,A
basitian 2005.03.17,1,1,8,66,38,-28,B
johnald 2006.03.28,2,1,20,214,10,-204,A
johnald 2006.03.28,2,1,20,214,15,-199,B
Breneric 2006.03.28,1,1,5,61,60,-1,A
Breneric 2006.03.28,1,1,5,62,60,-2,B
HEARTLESSWIZARD 2005.02.09,1,1,13,96,38,-58,A
HEARTLESSWIZARD 2005.02.09,1,1,13,97,31,-66,B
Rhiannontg 2005.02.09,1,0,12,82,58,-24,A
Rhiannontg 2005.02.09,1,0,12,103,33,-70,B
mcgrail 2006.03.05,5,0,62,166,32,-134,A
mcgrail 2006.03.05,5,0,62,157,37,-120,B
cpinya 2006.03.05,3,3,29,222,21,-201,A
cpinya 2006.03.05,3,3,29,209,31,-178,B
telaviv 2004.10.10,1,1,27,66,41,-25,A
telaviv 2004.10.10,1,1,27,59,44,-15,B
HEARTLESSWIZARD 2004.10.10,1,0,30,199,23,-176,A
HEARTLESSWIZARD 2004.10.10,1,0,30,194,17,-177,B
drstoen 2002.01.29,1,0,7,395,0,-395,A
drstoen 2002.01.29,1,0,7,410,0,-410,B
SpacedCadet 2002.01.29,1,1,5,160,20,-140,A
SpacedCadet 2002.01.29,1,1,5,182,20,-162,B
iascrazyorioles 2006.03.26,1,0,19,289,37,-252,A
iascrazyorioles 2006.03.26,1,0,19,235,26,-209,B
Lightmonster 2006.03.26,1,1,19,214,32,-182,A
Lightmonster 2006.03.26,1,1,19,213,32,-181,B
jcizotti 2005.03.14,1,1,7,206,14,-192,A
jcizotti 2005.03.14,1,1,7,196,29,-167,B
jpresley 2001.10.10,1,1,24,208,25,-183,A
jpresley 2001.10.10,1,1,24,213,25,-188,B
CashCow 2001.10.10,2,1,51,388,27,-361,A
CashCow 2001.10.10,2,1,51,341,24,-317,B
Gaby 2001.01.07,1,1,31,282,19,-263,A
Gaby 2001.01.07,1,1,31,309,23,-286,B
hitchhiker 2001.01.07,1,0,30,253,27,-226,A
hitchhiker 2001.01.07,1,0,30,293,13,-280,B
JasperGreene 2006.03.01,1,0.5,44,140,27,-113,A
JasperGreene 2006.03.01,1,0.5,44,138,30,-108,B
Halfman 2006.02.19,1,1,7,43,57,14,A
Halfman 2006.02.19,1,1,7,28,57,29,B
wiky 2006.02.19,1,0,8,281,25,-256,A
wiky 2006.02.19,1,0,8,249,25,-224,B
alexcardoso 2004.07.12,1,1,3,93,33,-60,A
alexcardoso 2004.07.12,1,1,3,79,33,-46,B
sammyCmtww 2004.07.12,3,2,46,141,43,-98,A
sammyCmtww 2004.07.12,3,2,46,138,33,-105,B
medilein 2005.03.11,1,1,2,310,50,-260,A
medilein 2005.03.11,1,1,2,400,0,-400,B
StrwberyNBanana 2000.02.16,1,1,9,214,22,-192,A
StrwberyNBanana 2000.02.16,1,1,9,202,22,-180,B
mwcommander 2000.02.16,1,0,11,358,9,-349,A
mwcommander 2000.02.16,1,0,11,338,18,-320,B
ShawnB 2006.02.14,2,0,65,194,32,-162,A
ShawnB 2006.02.14,2,0,65,192,32,-160,B
spudthedud 2006.02.14,2,2,66,193,24,-169,A
spudthedud 2006.02.14,2,2,66,182,23,-159,B
honte 2005.02.11,1,0,46,224,39,-185,A
honte 2005.02.11,1,0,46,210,33,-177,B
rickx 2005.02.11,1,1,42,204,31,-173,A
rickx 2005.02.11,1,1,42,188,31,-157,B
merka 2005.01.18,1,0,41,93,20,-73,A
merka 2005.01.18,1,0,41,105,20,-85,B
pajac 2005.01.18,1,1,39,57,41,-16,A
pajac 2005.01.18,1,1,39,70,38,-32,B
theonetrueface 2004.12.17,1,0,5,128,20,-108,A
theonetrueface 2004.12.17,1,0,5,146,20,-126,B
rockchalk 2004.12.17,1,1,4,126,25,-101,A
rockchalk 2004.12.17,1,1,4,144,25,-119,B
newwave 2001.10.10,1,0,30,373,23,-350,A
newwave 2001.10.10,1,0,30,374,20,-354,B
HappyCrap 2000.02.02,1,1,34,61,32,-29,A
HappyCrap 2000.02.02,1,1,34,63,29,-34,B
medilein 2005.02.21,1,1,8,576,0,-576,A
medilein 2005.02.21,1,1,8,515,0,-515,B
ultradude 2005.02.21,1,0,7,585,0,-585,A
ultradude 2005.02.21,1,0,7,524,0,-524,B
Joinedup 2005.02.03,1,0,8,360,25,-335,A
Joinedup 2005.02.03,1,0,8,401,25,-376,B
Proticon 2005.02.03,1,1,7,231,14,-217,A
Proticon 2005.02.03,1,1,7,277,14,-263,B
Xillion 2006.03.20,1,1,17,141,29,-112,A
Xillion 2006.03.20,1,1,17,103,29,-74,B
johnald 2006.03.20,1,0,18,263,28,-235,A
johnald 2006.03.20,1,0,18,217,28,-189,B
dbalparda 2006.03.02,1,1,18,36,50,14,A
dbalparda 2006.03.02,1,1,18,32,56,24,B
rbb 2006.03.25,1,1,20,204,25,-179,A
rbb 2006.03.25,1,1,20,200,30,-170,B
Halfman 2006.03.25,1,0,19,120,37,-83,A
Halfman 2006.03.25,1,0,19,133,37,-96,B
EliteHunter 2006.03.18,1,1,12,79,67,-12,A
EliteHunter 2006.03.18,1,1,12,66,58,-8,B
Krandall 2006.03.18,1,0,18,138,28,-110,A
Krandall 2006.03.18,1,0,18,125,33,-92,B
MassachusettsFats 2006.03.21,1,0,18,229,22,-207,A
MassachusettsFats 2006.03.21,1,0,18,218,17,-201,B
betsys 2006.03.21,1,1,15,212,33,-179,A
betsys 2006.03.21,1,1,15,248,20,-228,B
HEARTLESSWIZARD 2004.12.23,1,0,36,184,28,-156,A
HEARTLESSWIZARD 2004.12.23,1,0,36,190,31,-159,B
GolfBob 2004.12.23,1,1,34,137,24,-113,A
GolfBob 2004.12.23,1,1,34,152,24,-128,B
Bulochka 2005.01.05,1,0,17,197,24,-173,A
Bulochka 2005.01.05,1,0,17,187,29,-158,B
Nett 2005.01.05,1,1,15,76,33,-43,A
Nett 2005.01.05,1,1,15,78,40,-38,B
StrwberyNBanana 2000.04.06,1,0,16,159,38,-121,A
StrwberyNBanana 2000.04.06,1,0,16,157,44,-113,B
mwcommander 2000.04.06,1,1,16,96,44,-52,A
mwcommander 2000.04.06,1,1,16,97,50,-47,B
allgood 2000.03.27,2,2,18,130,22,-108,A
allgood 2000.03.27,2,2,18,147,17,-130,B
obao 2000.03.27,2,0,22,292,9,-283,A
obao 2000.03.27,2,0,22,310,9,-301,B
KellBell 2001.07.05,1,0,12,236,42,-194,A
KellBell 2001.07.05,1,0,12,236,42,-194,B
konovalov 2001.07.05,1,1,10,129,40,-89,A
konovalov 2001.07.05,1,1,10,138,30,-108,B
magicmaster 2000.03.19,2,0,12,273,0,-273,A
magicmaster 2000.03.19,2,0,12,288,0,-288,B
Buoy 2000.03.19,2,2,9,61,56,-5,A
Buoy 2000.03.19,2,2,9,68,56,-12,B
HEARTLESSWIZARD 2006.01.28,1,1,6,170,33,-137,A
HEARTLESSWIZARD 2006.01.28,1,1,6,188,33,-155,B
martinho 2006.01.28,1,0,6,293,33,-260,A
martinho 2006.01.28,1,0,6,321,33,-288,B
MMen 2004.05.11,1,0,13,176,15,-161,A
MMen 2004.05.11,1,0,13,176,15,-161,B
twno 2004.05.11,1,1,15,187,33,-154,A
twno 2004.05.11,1,1,15,176,33,-143,B
ZZandirt 2006.01.04,1,1,7,0,86,86,A
ZZandirt 2006.01.04,1,1,7,0,86,86,B
ChessRio 2006.01.04,2,1,27,114,30,-84,A
ChessRio 2006.01.04,2,1,27,123,30,-93,B
daChodeMan 2006.03.01,1,0,26,180,35,-145,A
daChodeMan 2006.03.01,1,0,26,179,35,-144,B
Halfman 2006.02.18,1,0,21,228,14,-214,A
Halfman 2006.02.18,1,0,21,204,14,-190,B
mickeyl 2006.02.18,2,1,29,259,31,-228,A
mickeyl 2006.02.18,2,1,29,237,31,-206,B
voetbalfan 2004.09.25,1,0,14,141,43,-98,A
voetbalfan 2004.09.25,1,0,14,151,43,-108,B
HEARTLESSWIZARD 2004.09.25,2,1,25,221,32,-189,A
HEARTLESSWIZARD 2004.09.25,2,1,25,280,28,-252,B
Knighter 2000.01.22,1,0,20,136,20,-116,A
Knighter 2000.01.22,1,0,20,133,20,-113,B
stefaan 2000.01.22,1,1,19,87,37,-50,A
stefaan 2000.01.22,1,1,19,83,37,-46,B
Knighter 1999.12.28,1,1,14,231,14,-217,A
Knighter 1999.12.28,1,1,14,216,14,-202,B
Chronoscepter 1999.12.28,1,0,12,147,42,-105,A
Chronoscepter 1999.12.28,1,0,12,134,50,-84,B
southwestco 2004.07.05,4,0,62,277,16,-261,A
southwestco 2004.07.05,4,0,62,280,16,-264,B
alexcardoso 2004.07.05,4,4,55,200,24,-176,A
alexcardoso 2004.07.05,4,4,55,201,20,-181,B
GaryP 2001.06.12,1,1,14,95,43,-52,A
GaryP 2001.06.12,1,1,14,83,43,-40,B
chessmoker 2001.06.12,1,0,14,176,29,-147,A
chessmoker 2001.06.12,1,0,14,166,29,-137,B
LuckyG 2006.03.13,1,1,20,137,30,-107,A
LuckyG 2006.03.13,1,1,20,155,35,-120,B
betsys 2006.03.13,1,0,20,145,30,-115,A
betsys 2006.03.13,1,0,20,175,30,-145,B
marioandluigi 2006.03.05,1,1,14,169,21,-148,A
marioandluigi 2006.03.05,1,1,14,186,14,-172,B
allgood 2000.03.28,1,1,24,300,29,-271,A
allgood 2000.03.28,1,1,24,306,33,-273,B
obao 2000.03.28,2,0,78,268,28,-240,A
obao 2000.03.28,2,0,78,250,29,-221,B
JuliusG 2006.03.14,1,1,6,154,33,-121,A
JuliusG 2006.03.14,1,1,6,197,17,-180,B
ferking 2006.03.14,1,0,12,281,50,-231,A
ferking 2006.03.14,1,0,12,284,50,-234,B
Chaemera 2006.03.14,1,1,6,204,0,-204,A
Chaemera 2006.03.14,1,1,6,194,0,-194,B
uvrays 2006.03.14,1,0,8,148,38,-110,A
uvrays 2006.03.14,1,0,8,165,12,-153,B
returnofcaz 2006.03.02,1,1,10,203,30,-173,A
returnofcaz 2006.03.02,1,1,10,200,20,-180,B
allgood 2000.04.02,1,1,10,48,50,2,A
allgood 2000.04.02,1,1,10,50,30,-20,B
obao 2000.04.02,1,0,10,219,10,-209,A
obao 2000.04.02,1,0,10,219,10,-209,B
mwcommander 2000.02.26,1,0,10,226,0,-226,A
mwcommander 2000.02.26,1,0,10,217,0,-217,B
MnM 2000.02.26,1,1,9,74,44,-30,A
MnM 2000.02.26,1,1,9,70,44,-26,B
Playlight 2000.03.28,1,1,55,144,44,-100,A
Playlight 2000.03.28,1,1,55,142,44,-98,B
spudthedud 2006.02.12,2,0,37,209,32,-177,A
spudthedud 2006.02.12,2,0,37,186,35,-151,B
stdonn 2006.02.12,1,1,12,178,17,-161,A
stdonn 2006.02.12,1,1,12,117,17,-100,B
createwaves 2001.07.02,1,0,8,334,12,-322,A
createwaves 2001.07.02,1,0,8,301,12,-289,B
gimpgoth 2001.07.02,1,1,7,266,0,-266,A
gimpgoth 2001.07.02,1,1,7,237,0,-237,B
IOMatrix 2001.01.21,1,0,35,166,34,-132,A
IOMatrix 2001.01.21,1,0,35,200,37,-163,B
Auerweck 2001.01.21,1,1,35,145,26,-119,A
Auerweck 2001.01.21,1,1,35,148,23,-125,B
gerard 2000.10.06,1,1,7,170,0,-170,A
gerard 2000.10.06,1,1,7,141,0,-141,B
Brooser 2000.10.06,1,0,7,314,0,-314,A
Brooser 2000.10.06,1,0,7,279,14,-265,B
benoz 2006.03.07,1,1,6,83,33,-50,A
benoz 2006.03.07,1,1,6,76,33,-43,B
mcgrail 2006.03.07,1,0,5,121,20,-101,A
mcgrail 2006.03.07,1,0,5,113,20,-93,B
HEARTLESSWIZARD 2004.10.22,1,0,29,175,17,-158,A
HEARTLESSWIZARD 2004.10.22,1,0,29,163,17,-146,B
spiZ 2004.10.22,1,1,26,116,54,-62,A
spiZ 2004.10.22,1,1,26,112,46,-66,B
mrfriday 2000.02.07,1,0,18,169,44,-125,A
mrfriday 2000.02.07,1,0,18,161,39,-122,B
aet 2000.02.07,1,1,17,95,35,-60,A
aet 2000.02.07,1,1,17,86,35,-51,B
surrencytw 2004.12.20,1,1,6,38,50,12,A
surrencytw 2004.12.20,1,1,6,28,67,39,B
theonetrueface 2004.12.20,1,0,6,240,17,-223,A
theonetrueface 2004.12.20,1,0,6,256,17,-239,B
ewrosenthal 2006.03.04,1,1,11,156,36,-120,A
ewrosenthal 2006.03.04,1,1,11,172,36,-136,B
mcgrail 2006.03.04,1,0,11,233,46,-187,A
mcgrail 2006.03.04,1,0,11,249,46,-203,B
ennil 2004.10.05,1,1,32,96,41,-55,A
ennil 2004.10.05,1,1,32,98,44,-54,B
telaviv 2004.10.05,1,0,33,146,42,-104,A
telaviv 2004.10.05,1,0,33,163,27,-136,B
Tarish 2006.03.01,3,0,81,219,28,-191,A
Tarish 2006.03.01,3,0,81,193,26,-167,B
gottago 2006.03.01,4,4,92,165,29,-136,A
gottago 2006.03.01,4,4,92,165,24,-141,B
wavewave 2006.03.05,1,1,23,111,30,-81,A
wavewave 2006.03.05,1,1,23,103,30,-73,B
Cortez 2000.02.02,1,0,17,48,29,-19,A
Cortez 2000.02.02,1,0,17,37,35,-2,B
mrfriday 2000.01.29,1,0,20,274,15,-259,A
mrfriday 2000.01.29,1,0,20,251,15,-236,B
Knighter 2000.01.29,1,1,17,167,35,-132,A
Knighter 2000.01.29,1,1,17,147,29,-118,B
SChlebowski 2006.02.13,1,1,18,291,22,-269,A
SChlebowski 2006.02.13,1,1,18,242,28,-214,B
spudthedud 2006.02.13,2,1,25,296,28,-268,A
spudthedud 2006.02.13,2,1,25,261,24,-237,B
StrwberyNBanana 2000.03.29,1,1,25,154,12,-142,A
StrwberyNBanana 2000.03.29,1,1,25,157,20,-137,B
mwcommander 2000.03.29,1,0,25,185,12,-173,A
mwcommander 2000.03.29,1,0,25,184,16,-168,B
ewrosenthal 2006.03.02,1,1,4,168,50,-118,A
ewrosenthal 2006.03.02,1,1,4,174,75,-99,B
StrwberyNBanana 2000.02.05,1,1,34,228,12,-216,A
StrwberyNBanana 2000.02.05,1,1,34,264,6,-258,B
mwcommander 2000.02.05,1,0,27,240,15,-225,A
mwcommander 2000.02.05,1,0,27,223,15,-208,B
freetraderbeowolf 2006.02.18,1,1,6,114,50,-64,A
freetraderbeowolf 2006.02.18,1,1,6,73,50,-23,B
twno 2004.07.16,2,0,18,229,11,-218,A
twno 2004.07.16,2,0,18,251,6,-245,B
alexcardoso 2004.07.16,2,2,18,129,17,-112,A
alexcardoso 2004.07.16,2,2,18,141,28,-113,B
RHankinsJr 2006.02.12,1,1,18,56,44,-12,A
RHankinsJr 2006.02.12,1,1,18,58,50,-8,B
twno 2004.04.04,1,1,17,120,41,-79,A
twno 2004.04.04,1,1,17,58,41,-17,B
hcube 2004.04.04,1,0,18,164,17,-147,A
hcube 2004.04.04,1,0,18,159,22,-137,B
HEARTLESSWIZARD 2004.08.29,2,0,18,206,17,-189,A
HEARTLESSWIZARD 2004.08.29,2,0,18,215,17,-198,B
leffub 2004.08.29,2,2,23,172,30,-142,A
leffub 2004.08.29,2,2,23,182,30,-152,B
ennil 2004.10.02,1,1,11,69,46,-23,A
ennil 2004.10.02,1,1,11,65,54,-11,B
caracaskid 2004.10.02,1,0,12,273,25,-248,A
caracaskid 2004.10.02,1,0,12,262,25,-237,B
Vox 2004.11.19,1,1,12,145,33,-112,A
Vox 2004.11.19,1,1,12,150,33,-117,B
EvilenasThrone 2004.11.19,1,0,14,203,36,-167,A
EvilenasThrone 2004.11.19,1,0,14,204,36,-168,B
vismaior 2006.03.02,1,1,14,173,21,-152,A
vismaior 2006.03.02,1,1,14,159,21,-138,B
wiky 2006.03.01,1,0,7,82,29,-53,A
wiky 2006.03.01,1,0,7,132,43,-89,B
surrencytw 2004.11.13,1,0,18,534,11,-523,A
surrencytw 2004.11.13,1,0,18,527,11,-516,B
ConditionZero 2004.11.13,1,1,13,350,31,-319,A
ConditionZero 2004.11.13,1,1,13,372,31,-341,B
Knighter 2000.01.30,2,2,18,126,22,-104,A
Knighter 2000.01.30,2,2,18,111,22,-89,B
BOKEN 2000.01.30,1,0,5,382,20,-362,A
BOKEN 2000.01.30,1,0,5,369,20,-349,B
fuz 2000.02.02,2,1,27,178,15,-163,A
fuz 2000.02.02,2,1,27,181,15,-166,B
loserman 2006.02.13,1,0,8,150,38,-112,A
loserman 2006.02.13,1,0,8,168,38,-130,B
knoSpain 2006.02.13,1,1,7,37,57,20,A
knoSpain 2006.02.13,1,1,7,12,71,59,B
ZeroKool 2000.02.06,1,0,26,158,23,-135,A
ZeroKool 2000.02.06,1,0,26,142,23,-119,B
aet 2000.02.06,1,1,25,92,36,-56,A
aet 2000.02.06,1,1,25,75,36,-39,B
spudthedud 2006.02.15,1,1,24,122,38,-84,A
spudthedud 2006.02.15,1,1,24,118,42,-76,B
Cybersun 2006.02.15,1,0,26,129,35,-94,A
Cybersun 2006.02.15,1,0,26,129,19,-110,B
Shuckey 2000.01.28,1,0,26,88,54,-34,A
Shuckey 2000.01.28,1,0,26,91,54,-37,B
Shuckey 2000.01.28,1,0,26,91,50,-41,C
Knighter 2000.01.28,1,1,26,112,38,-74,A
Knighter 2000.01.28,1,1,26,107,38,-69,B
Knighter 2000.01.28,1,1,26,105,42,-63,C
azshtrdude 2004.09.11,1,0,23,312,22,-290,A
azshtrdude 2004.09.11,1,0,23,309,17,-292,B
HEARTLESSWIZARD 2004.09.11,1,1,21,234,38,-196,A
HEARTLESSWIZARD 2004.09.11,1,1,21,235,33,-202,B
laconique 2000.01.15,1,1,36,85,36,-49,A
laconique 2000.01.15,1,1,36,75,31,-44,B
Tarish 2006.02.28,1,0,14,224,29,-195,A
Tarish 2006.02.28,1,0,14,176,29,-147,B
petergriffin 2006.02.28,1,1,12,84,42,-42,A
petergriffin 2006.02.28,1,1,12,80,42,-38,B
Knighter 2000.01.23,1,0,19,240,32,-208,A
Knighter 2000.01.23,1,0,19,248,37,-211,B
giles 2000.01.23,1,1,15,99,20,-79,A
giles 2000.01.23,1,1,15,100,20,-80,B
HEARTLESSWIZARD 2004.07.29,1,0,16,201,38,-163,A
HEARTLESSWIZARD 2004.07.29,1,0,16,194,44,-150,B
Zumon 2004.07.29,1,1,16,247,31,-216,A
Zumon 2004.07.29,1,1,16,224,31,-193,B
cubcadet 2006.02.13,1,0,9,390,11,-379,A
cubcadet 2006.02.13,1,0,9,438,11,-427,B
Halfman 2006.02.13,1,0,13,349,23,-326,A
Halfman 2006.02.13,1,0,13,358,23,-335,B
prodenter 2006.02.13,1,1,8,102,50,-52,A
prodenter 2006.02.13,1,1,8,142,25,-117,B
Knighter 2000.01.26,1,0,50,190,22,-168,A
Knighter 2000.01.26,1,0,50,188,14,-174,B
gnutz 2000.01.26,1,1,48,140,27,-113,A
gnutz 2000.01.26,1,1,48,145,23,-122,B
mrcapp 2004.04.17,1,0,23,209,26,-183,A
mrcapp 2004.04.17,1,0,23,204,26,-178,B
mcavoy 2004.04.17,1,1,20,131,40,-91,A
mcavoy 2004.04.17,1,1,20,122,40,-82,B
andermec 2006.01.07,1,1,16,113,38,-75,A
andermec 2006.01.07,1,1,16,117,38,-79,B
Halfman 2006.01.07,2,0,41,149,24,-125,A
Halfman 2006.01.07,2,0,41,157,27,-130,B
hwqa 2004.09.25,1,1,8,132,37,-95,A
hwqa 2004.09.25,1,1,8,131,38,-93,B
mrfriday 2000.01.27,1,0,30,140,37,-103,A
mrfriday 2000.01.27,1,0,30,133,30,-103,B
Knighter 2000.01.27,2,2,34,145,24,-121,A
Knighter 2000.01.27,2,2,34,139,21,-118,B
army 2000.01.29,1,0,17,172,18,-154,A
army 2000.01.29,1,0,17,168,18,-150,B
aet 2000.01.29,1,1,15,64,53,-11,A
aet 2000.01.29,1,1,15,52,47,-5,B
nspirit 2004.07.12,3,0.5,60,250,40,-210,A
nspirit 2004.07.12,3,0.5,60,243,35,-208,B
ChessProzac 2000.02.02,1,1,18,48,39,-9,A
ChessProzac 2000.02.02,1,1,18,35,50,15,B
vismaior 2006.02.20,1,0.5,22,150,41,-109,A
vismaior 2006.02.20,1,0.5,22,145,41,-104,B
kimida 2006.02.20,1,0.5,21,199,24,-175,A
kimida 2006.02.20,1,0.5,21,200,29,-171,B
slingdraw 2000.01.30,1,0,13,206,38,-168,A
slingdraw 2000.01.30,1,0,13,199,31,-168,B
maxmaz 2004.05.15,1,0,12,198,25,-173,A
maxmaz 2004.05.15,1,0,12,198,25,-173,B
twno 2004.05.15,2,2,32,207,31,-176,A
twno 2004.05.15,2,2,32,217,34,-183,B
twno 2004.05.04,1,0,5,95,60,-35,A
twno 2004.05.04,1,0,5,136,60,-76,B
BerntHertz 2004.05.04,1,1,6,485,0,-485,A
BerntHertz 2004.05.04,1,1,6,476,0,-476,B
ChessRio 2005.12.30,1,1,14,129,36,-93,A
ChessRio 2005.12.30,1,1,14,141,36,-105,B
Halfman 2005.12.30,1,0,14,199,36,-163,A
Halfman 2005.12.30,1,0,14,200,29,-171,B
HEARTLESSWIZARD 2004.09.02,1,0,22,194,9,-185,A
HEARTLESSWIZARD 2004.09.02,1,0,22,188,9,-179,B
GolfBob 2004.09.02,1,1,24,195,29,-166,A
GolfBob 2004.09.02,1,1,24,198,25,-173,B
Cybersun 2006.02.12,1,0,15,295,13,-282,A
Cybersun 2006.02.12,1,0,15,253,13,-240,B
Panzerkampfwagon 2006.02.12,1,1,14,187,43,-144,A
Panzerkampfwagon 2006.02.12,1,1,14,186,36,-150,B
WesternRed 1999.11.24,1,1,10,135,10,-125,A
WesternRed 1999.11.24,1,1,10,145,20,-125,B
Kimber 1999.11.24,1,0,11,289,27,-262,A
Kimber 1999.11.24,1,0,11,306,18,-288,B
colpitts 2004.09.05,1,1,8,236,25,-211,A
colpitts 2004.09.05,1,1,8,181,38,-143,B
Foufoutos 2004.09.05,1,0,10,406,10,-396,A
Foufoutos 2004.09.05,1,0,10,342,30,-312,B
twno 2004.07.15,1,0,9,502,0,-502,A
twno 2004.07.15,1,0,9,468,0,-468,B
collmemasteur 2004.07.15,1,1,7,307,29,-278,A
collmemasteur 2004.07.15,1,1,7,313,29,-284,B
southwestco 2004.07.14,1,0,15,179,13,-166,A
southwestco 2004.07.14,1,0,15,182,13,-169,B
alexcardoso 2004.07.14,1,1,12,122,17,-105,A
alexcardoso 2004.07.14,1,1,12,103,25,-78,B
arragorn 1999.12.13,1,1,13,215,15,-200,A
arragorn 1999.12.13,1,1,13,188,15,-173,B
Agenbite 1999.12.13,1,0,12,88,33,-55,A
Agenbite 1999.12.13,1,0,12,72,33,-39,B
Tarish 2006.02.11,1,0,6,359,17,-342,A
Tarish 2006.02.11,1,0,6,241,33,-208,B
ewrosenthal 2006.02.11,1,1,5,38,60,22,A
ewrosenthal 2006.02.11,1,1,5,9,80,71,B
southwestco 2004.07.15,1,0,22,140,23,-117,A
southwestco 2004.07.15,1,0,22,155,23,-132,B
vat 2004.07.15,1,1,20,37,55,18,A
vat 2004.07.15,1,1,20,46,45,-1,B
dbalparda 2006.02.10,1,0,7,252,14,-238,A
dbalparda 2006.02.10,1,0,7,274,14,-260,B
drekec 2006.02.10,1,1,6,117,33,-84,A
drekec 2006.02.10,1,1,6,102,33,-69,B
HEARTLESSWIZARD 2004.08.01,1,0,20,319,25,-294,A
HEARTLESSWIZARD 2004.08.01,1,0,20,341,30,-311,B
Derro 2004.08.01,1,1,21,310,29,-281,A
Derro 2004.08.01,1,1,21,373,24,-349,B
DanielKinney 2006.01.23,1,0,5,256,0,-256,A
DanielKinney 2006.01.23,1,0,5,259,0,-259,B
Halfman 2006.01.23,2,1,16,197,25,-172,A
Halfman 2006.01.23,2,1,16,205,19,-186,B
wolfla 2006.02.12,1,0,19,122,58,-64,A
wolfla 2006.02.12,1,0,19,108,58,-50,B
dbalparda 2006.02.12,1,1,20,229,30,-199,A
dbalparda 2006.02.12,1,1,20,179,35,-144,B
Guidi 2000.01.27,1,0,4,66,25,-41,A
Guidi 2000.01.27,1,0,4,64,25,-39,B
cybersmash 2004.06.08,1,1,16,178,12,-166,A
cybersmash 2004.06.08,1,1,16,155,12,-143,B
alexcardoso 2004.06.08,1,0,22,434,9,-425,A
alexcardoso 2004.06.08,1,0,22,341,18,-323,B
loserman 2006.01.30,1,0,5,273,20,-253,A
loserman 2006.01.30,1,0,5,276,20,-256,B
zLORDz 2006.01.30,1,1,5,120,20,-100,A
zLORDz 2006.01.30,1,1,5,70,40,-30,B
MMen 2004.05.12,1,0,16,165,6,-159,A
MMen 2004.05.12,1,0,16,195,6,-189,B
twno 2004.05.12,2,1,35,159,29,-130,A
twno 2004.05.12,2,1,35,163,34,-129,B
Parne 2004.05.15,1,0,13,143,46,-97,A
Parne 2004.05.15,1,0,13,136,46,-90,B
Tarish 2006.01.27,1,0,30,227,33,-194,A
Tarish 2006.01.27,1,0,30,237,37,-200,B
olinebeefs 2006.01.27,1,1,27,206,33,-173,A
olinebeefs 2006.01.27,1,1,27,221,37,-184,B
pddchess 2005.12.22,1,1,29,203,41,-162,A
pddchess 2005.12.22,1,1,29,199,34,-165,B
Nassor 2005.12.22,1,0,27,178,44,-134,A
Nassor 2005.12.22,1,0,27,175,41,-134,B
Turtleskies 2004.07.27,1,1,14,161,36,-125,A
Turtleskies 2004.07.27,1,1,14,154,36,-118,B
Farfarer 2004.07.27,1,0,18,181,33,-148,A
Farfarer 2004.07.27,1,0,18,197,33,-164,B
HEARTLESSWIZARD 2006.01.29,1,1,11,309,9,-300,A
HEARTLESSWIZARD 2006.01.29,1,1,11,297,9,-288,B
Johnnyp 2006.01.29,1,0,11,323,27,-296,A
Johnnyp 2006.01.29,1,0,11,308,36,-272,B
Nassor 2005.12.23,2,1,55,107,38,-69,A
Nassor 2005.12.23,2,1,55,106,40,-66,B
rnajerac 2005.12.23,2,1,55,129,49,-80,A
rnajerac 2005.12.23,2,1,55,127,45,-82,B
southwestco 2004.07.06,1,0,8,324,25,-299,A
southwestco 2004.07.06,1,0,8,334,25,-309,B
platyjoe 2004.07.06,1,1,6,123,33,-90,A
platyjoe 2004.07.06,1,1,6,124,33,-91,B
HEARTLESSWIZARD 2004.06.10,1,0,22,254,14,-240,A
HEARTLESSWIZARD 2004.06.10,1,0,22,241,18,-223,B
OwenDeathstalker 2004.06.10,1,1,20,166,45,-121,A
OwenDeathstalker 2004.06.10,1,1,20,158,45,-113,B
stalkerVision 2004.07.12,1,0.5,6,260,0,-260,A
stalkerVision 2004.07.12,1,0.5,6,228,0,-228,B
sammyCmtww 2004.07.09,1,1,11,185,18,-167,A
sammyCmtww 2004.07.09,1,1,11,175,27,-148,B
alexcardoso 2004.07.09,1,0,12,324,33,-291,A
alexcardoso 2004.07.09,1,0,12,347,25,-322,B
SkyReaper 2006.02.12,1,1,10,110,30,-80,A
SkyReaper 2006.02.12,1,1,10,85,30,-55,B
aalaptop 2006.02.12,1,0,11,328,27,-301,A
aalaptop 2006.02.12,1,0,11,284,27,-257,B
Armoral 2004.04.17,1,0,15,150,33,-117,A
Armoral 2004.04.17,1,0,15,160,33,-127,B
vibronic 2004.04.17,1,1,15,146,20,-126,A
vibronic 2004.04.17,1,1,15,143,20,-123,B
Halfman 2006.01.20,2,1,46,212,35,-177,A
Halfman 2006.01.20,2,1,46,217,28,-189,B
petergriffin 2006.01.20,2,1,41,156,22,-134,A
petergriffin 2006.01.20,2,1,41,157,24,-133,B
Kimber 1999.12.01,1,0,30,289,27,-262,A
Kimber 1999.12.01,1,0,30,278,20,-258,B
WesternRed 1999.12.01,1,1,30,237,23,-214,A
WesternRed 1999.12.01,1,1,30,251,17,-234,B
pddchess 2006.01.23,2,1,22,262,23,-239,A
pddchess 2006.01.23,2,1,22,267,14,-253,B
olinebeefs 2006.01.23,1,1,6,56,33,-23,A
olinebeefs 2006.01.23,1,1,6,30,50,20,B
ChessRio 2005.12.29,1,0,18,289,33,-256,A
ChessRio 2005.12.29,1,0,18,294,33,-261,B
americanista 2005.12.29,1,1,15,104,33,-71,A
americanista 2005.12.29,1,1,15,120,40,-80,B
Pancetta 2006.01.23,1,0,12,292,25,-267,A
Pancetta 2006.01.23,1,0,12,289,25,-264,B
GolfBob 2004.06.17,1,1,37,69,30,-39,A
GolfBob 2004.06.17,1,1,37,71,30,-41,B
HEARTLESSWIZARD 2004.06.17,1,0,45,160,18,-142,A
HEARTLESSWIZARD 2004.06.17,1,0,45,159,13,-146,B
platyjoe 2004.07.03,1,1,11,445,18,-427,A
platyjoe 2004.07.03,1,1,11,393,18,-375,B
sammyCmtww 2004.07.03,1,0,6,278,0,-278,A
sammyCmtww 2004.07.03,1,0,6,281,0,-281,B
WesternRed 1999.11.30,1,1,8,66,50,-16,A
WesternRed 1999.11.30,1,1,8,94,62,-32,B
Kimber 1999.11.30,1,0,11,247,36,-211,A
Kimber 1999.11.30,1,0,11,242,46,-196,B
sibil 2004.04.26,1,1,15,148,40,-108,A
sibil 2004.04.26,1,1,15,143,40,-103,B
twno 2004.04.26,1,0,17,226,18,-208,A
twno 2004.04.26,1,0,17,233,24,-209,B
Halfman 2006.01.03,2,2,43,70,37,-33,A
Halfman 2006.01.03,2,2,43,75,40,-35,B
olinebeefs 2006.01.03,2,0,48,149,33,-116,A
olinebeefs 2006.01.03,2,0,48,165,29,-136,B
Anoten 2006.02.04,1,0,21,437,24,-413,A
Anoten 2006.02.04,1,0,21,339,29,-310,B
aalaptop 2006.02.04,1,1,16,328,12,-316,A
aalaptop 2006.02.04,1,1,16,239,12,-227,B
enzito 2006.01.11,1,0,5,357,0,-357,A
enzito 2006.01.11,1,0,5,373,0,-373,B
KingdomRascal 2006.01.11,1,1,3,70,33,-37,A
KingdomRascal 2006.01.11,1,1,3,71,33,-38,B
pddchess 2006.01.10,2,0.5,20,194,25,-169,A
pddchess 2006.01.10,2,0.5,20,182,25,-157,B
SChlebowski 2006.01.10,1,1,15,211,27,-184,A
SChlebowski 2006.01.10,1,1,15,199,33,-166,B
smod 2006.01.23,1,1,13,82,46,-36,A
smod 2006.01.23,1,1,13,94,38,-56,B
PIONPAGO 2006.01.31,1,1,28,136,50,-86,A
PIONPAGO 2006.01.31,1,1,28,100,57,-43,B
PIONPAGO 2006.01.31,1,1,28,100,46,-54,C
Halfman 2006.01.31,1,0,28,195,25,-170,A
Halfman 2006.01.31,1,0,28,171,25,-146,B
Halfman 2006.01.31,1,0,28,156,21,-135,C
Halfman 2006.01.12,1,1,11,45,46,1,A
Halfman 2006.01.12,1,1,11,39,36,-3,B
aGameofChess 2006.01.12,1,0,14,148,21,-127,A
aGameofChess 2006.01.12,1,0,14,144,21,-123,B
JorgeAdRomero 2006.01.04,1,0,20,164,35,-129,A
JorgeAdRomero 2006.01.04,1,0,20,175,35,-140,B
Ljovusa 2004.05.12,1,1,18,240,28,-212,A
Ljovusa 2004.05.12,1,1,18,224,28,-196,B
twno 2004.04.06,1,0,17,412,18,-394,A
twno 2004.04.06,1,0,17,478,24,-454,B
dockson 2004.04.06,1,1,16,431,19,-412,A
dockson 2004.04.06,1,1,16,467,19,-448,B
PIONPAGO 2006.01.13,2,2,29,236,24,-212,A
PIONPAGO 2006.01.13,2,2,29,159,28,-131,B
KarstenBlom 2006.01.13,1,0,11,150,18,-132,A
KarstenBlom 2006.01.13,1,0,11,143,36,-107,B
Pfistou 2005.12.24,1,1,8,206,38,-168,A
Pfistou 2005.12.24,1,1,8,270,38,-232,B
Spartagus 2005.12.24,1,0,11,559,9,-550,A
Spartagus 2005.12.24,1,0,11,559,9,-550,B
twno 2004.04.21,1,0,19,195,32,-163,A
twno 2004.04.21,1,0,19,209,26,-183,B
Ureshii 2004.04.21,1,1,18,144,11,-133,A
Ureshii 2004.04.21,1,1,18,147,17,-130,B
dillondeck 2006.01.13,1,0,19,250,10,-240,A
dillondeck 2006.01.13,1,0,19,235,10,-225,B
PIONPAGO 2006.01.14,2,0.5,34,194,47,-147,A
PIONPAGO 2006.01.14,2,0.5,34,173,44,-129,B
BigIrish 2006.01.14,1,0.5,9,325,33,-292,A
BigIrish 2006.01.14,1,0.5,9,315,44,-271,B
willcarter 2006.01.14,1,1,24,143,33,-110,A
willcarter 2006.01.14,1,1,24,134,38,-96,B
seeall 2006.01.10,1,0.5,6,204,33,-171,A
seeall 2006.01.10,1,0.5,6,197,33,-164,B
ELMC 2006.01.04,1,0,23,116,17,-99,A
ELMC 2006.01.04,1,0,23,120,17,-103,B
Halfman 2006.01.04,1,1,22,48,46,-2,A
Halfman 2006.01.04,1,1,22,54,46,-8,B
ninox 2006.01.07,1,1,20,99,20,-79,A
ninox 2006.01.07,1,1,20,84,25,-59,B
