Name,Rating,Games,Result,Moves,CPL,MM,Sort Score,Analysis
emorej 2007.12.14,885,1,0,16,179,44,-135,A
emorej 2007.12.14,885,1,0,16,171,38,-133,B
salius 2007.12.14,1037,1,1,15,61,40,-21,A
salius 2007.12.14,1037,1,1,15,63,40,-23,B
Malca 2007.06.28,1053,2,2,30,101,33,-68,A
Malca 2007.06.28,1053,2,2,30,94,33,-61,B
laksen 2007.06.28,866,7,0,91,241,23,-218,A
laksen 2007.06.28,866,7,0,91,233,21,-212,B
alamaak 2007.07.05,1093,1,1,10,220,40,-180,A
alamaak 2007.07.05,1093,1,1,10,172,30,-142,B
laksen 2007.07.05,884,1,0,11,340,18,-322,A
laksen 2007.07.05,884,1,0,11,330,18,-312,B
Aydo 2007.12.09,1079,2,2,48,116,31,-85,A
Aydo 2007.12.09,1079,2,2,48,115,31,-84,B
jinbu 2007.12.09,841,2,1,35,107,43,-64,A
jinbu 2007.12.09,841,2,1,35,104,43,-61,B
POREDJE 2007.12.09,1063,1,0,7,291,14,-277,A
POREDJE 2007.12.09,1063,1,0,7,290,14,-276,B
zhouzhou 2007.11.26,976,1,0,25,103,36,-67,A
zhouzhou 2007.11.26,976,1,0,25,105,48,-57,B
michaelchen 2007.11.26,942,1,1,28,264,29,-235,A
michaelchen 2007.11.26,942,1,1,28,252,43,-209,B
louiswei 2007.12.31,907,1,0,29,126,31,-95,A
louiswei 2007.12.31,907,1,0,29,129,34,-95,B
louiswei 2007.12.31,907,1,0,29,126,34,-92,C
sevenohnine 2007.12.31,1066,1,1,28,46,57,11,A
sevenohnine 2007.12.31,1066,1,1,28,45,57,12,B
sevenohnine 2007.12.31,1066,1,1,28,45,54,9,C
DINOCO 2007.12.09,870,1,0,18,193,39,-154,A
DINOCO 2007.12.09,870,1,0,18,180,33,-147,B
meathelmet 2007.06.28,1082,1,1,7,85,14,-71,A
meathelmet 2007.06.28,1082,1,1,7,123,14,-109,B
zhouzhou 2007.11.15,915,1,0,33,127,27,-100,A
zhouzhou 2007.11.15,915,1,0,33,97,30,-67,B
Artmachine 2007.11.15,1019,1,1,34,131,41,-90,A
Artmachine 2007.11.15,1019,1,1,34,136,32,-104,B
thebrickwall 2007.12.30,982,2,1,32,220,47,-173,A
thebrickwall 2007.12.30,982,2,1,32,217,53,-164,B
thebrickwall 2007.12.30,982,2,1,32,219,53,-166,C
podlas 2007.12.30,913,2,1,30,220,47,-173,A
podlas 2007.12.30,913,2,1,30,181,43,-138,B
podlas 2007.12.30,913,2,1,30,178,40,-138,C
phactpatterns 2007.12.23,919,1,1,4,0,75,75,A
phactpatterns 2007.12.23,919,1,1,4,8,75,67,B
rbrtoe 2007.12.23,940,1,0,7,309,0,-309,A
rbrtoe 2007.12.23,940,1,0,7,329,14,-315,B
Biggnick 2007.12.28,1136,1,0,32,271,34,-237,A
Biggnick 2007.12.28,1136,1,0,32,225,34,-191,B
mipsparc 2007.12.28,847,1,1,29,213,38,-175,A
mipsparc 2007.12.28,847,1,1,29,172,34,-138,B
vetteboy 2007.12.20,996,1,0,31,236,35,-201,A
vetteboy 2007.12.20,996,1,0,31,239,32,-207,B
thebrickwall 2007.12.20,1012,2,1,58,246,34,-212,A
thebrickwall 2007.12.20,1012,2,1,58,258,36,-222,B
louiswei 2007.12.23,824,2,1.5,66,115,20,-95,A
louiswei 2007.12.23,824,2,1.5,66,112,23,-89,B
kevinoc 2007.12.23,886,2,1.5,54,111,33,-78,A
kevinoc 2007.12.23,886,2,1.5,54,105,33,-72,B
KTSCane 2007.12.23,1079,1,0,13,435,15,-420,A
KTSCane 2007.12.23,1079,1,0,13,409,15,-394,B
whitelighter 2007.07.04,956,2,1,43,138,35,-103,A
whitelighter 2007.07.04,956,2,1,43,130,30,-100,B
Bmoresoldier 2007.07.04,1029,1,0,27,205,30,-175,A
Bmoresoldier 2007.07.04,1029,1,0,27,202,33,-169,B
thebrickwall 2007.12.23,1011,1,0,25,161,40,-121,A
thebrickwall 2007.12.23,1011,1,0,25,164,40,-124,B
adamjodonnell 2007.12.21,997,1,1,9,100,22,-78,A
adamjodonnell 2007.12.21,997,1,1,9,129,11,-118,B
Cheezychess 2007.12.21,915,3,0,44,234,27,-207,A
Cheezychess 2007.12.21,915,3,0,44,208,30,-178,B
kevinoc 2007.12.22,935,1,0,6,84,33,-51,A
kevinoc 2007.12.22,935,1,0,6,71,33,-38,B
adamjodonnell 2007.12.22,1062,1,1,8,314,12,-302,A
adamjodonnell 2007.12.22,1062,1,1,8,352,0,-352,B
POREDJE 2007.12.11,1036,1,1,12,126,25,-101,A
POREDJE 2007.12.11,1036,1,1,12,137,33,-104,B
zhouzhou 2007.12.11,939,1,0,12,185,25,-160,A
zhouzhou 2007.12.11,939,1,0,12,186,25,-161,B
jmaeder 2007.11.17,1003,2,2,16,190,37,-153,A
jmaeder 2007.11.17,1003,2,2,16,183,31,-152,B
ScottieD 2007.11.17,971,2,0,16,271,19,-252,A
ScottieD 2007.11.17,971,2,0,16,290,25,-265,B
Syrik 2007.10.30,1126,1,1,9,47,56,9,A
Syrik 2007.10.30,1126,1,1,9,40,56,16,B
Seroth 2007.10.30,674,1,0,11,339,36,-303,A
Seroth 2007.10.30,674,1,0,11,334,36,-298,B
joethecoolestman 2007.10.20,766,1,0,7,266,14,-252,A
joethecoolestman 2007.10.20,766,1,0,7,298,14,-284,B
TheBuzzard 2007.10.20,1220,1,1,5,105,40,-65,A
TheBuzzard 2007.10.20,1220,1,1,5,131,40,-91,B
jmaeder 2007.10.16,955,3,1,26,256,35,-221,A
jmaeder 2007.10.16,955,3,1,26,267,35,-232,B
soucyj 2007.10.16,1013,2,1,19,211,37,-174,A
soucyj 2007.10.16,1013,2,1,19,239,37,-202,B
lamemyles 2007.12.21,1068,1,1,22,124,55,-69,A
lamemyles 2007.12.21,1068,1,1,22,103,50,-53,B
Doragon 2007.12.21,877,1,0,22,116,41,-75,A
Doragon 2007.12.21,877,1,0,22,104,41,-63,B
nedy 2007.07.03,977,1,0,8,402,25,-377,A
nedy 2007.07.03,977,1,0,8,366,38,-328,B
whitelighter 2007.07.03,933,1,1,4,233,25,-208,A
whitelighter 2007.07.03,933,1,1,4,226,25,-201,B
thebrickwall 2007.12.16,1022,1,1,17,148,41,-107,A
thebrickwall 2007.12.16,1022,1,1,17,165,29,-136,B
Cheezychess 2007.12.16,909,1,0,18,210,28,-182,A
Cheezychess 2007.12.16,909,1,0,18,221,22,-199,B
laksen 2007.06.30,852,5,1.5,70,323,27,-296,A
laksen 2007.06.30,852,5,1.5,70,310,23,-287,B
MajorNerd 2007.06.30,1021,2,0,18,132,22,-110,A
MajorNerd 2007.06.30,1021,2,0,18,140,28,-112,B
meathelmet 2007.06.30,1100,2,2,37,260,30,-230,A
meathelmet 2007.06.30,1100,2,2,37,278,30,-248,B
sdormeus 2007.12.21,1085,1,1,14,171,29,-142,A
sdormeus 2007.12.21,1085,1,1,14,112,21,-91,B
louiswei 2007.11.25,795,2,0.5,94,119,30,-89,A
louiswei 2007.11.25,795,2,0.5,94,115,27,-88,B
Kyobutungi 2007.11.25,1076,1,0.5,75,79,25,-54,A
Kyobutungi 2007.11.25,1076,1,0.5,75,81,24,-57,B
luoyun 2007.12.11,931,1,1,15,119,33,-86,A
luoyun 2007.12.11,931,1,1,15,92,27,-65,B
ArcticDevil 2007.12.11,981,1,0,17,236,18,-218,A
ArcticDevil 2007.12.11,981,1,0,17,227,18,-209,B
ddurden 2007.12.05,1167,1,1,12,173,25,-148,A
ddurden 2007.12.05,1167,1,1,12,173,17,-156,B
louiswei 2007.12.05,829,2,1,53,142,40,-102,A
louiswei 2007.12.05,829,2,1,53,140,42,-98,B
ilikecar 2007.11.07,1038,1,1,42,84,29,-55,A
ilikecar 2007.11.07,1038,1,1,42,91,31,-60,B
ilikecomputer 2007.11.07,953,1,0,44,190,36,-154,A
ilikecomputer 2007.11.07,953,1,0,44,176,41,-135,B
Grige 2007.06.16,1125,1,0,6,293,17,-276,A
Grige 2007.06.16,1125,1,0,6,259,17,-242,B
nunziocedi 2007.06.16,785,1,1,5,25,60,35,A
nunziocedi 2007.06.16,785,1,1,5,32,80,48,B
BurtForFun 2007.10.01,1122,1,1,13,158,23,-135,A
BurtForFun 2007.10.01,1122,1,1,13,151,31,-120,B
hysong 2007.10.01,865,1,0,16,288,12,-276,A
hysong 2007.10.01,865,1,0,16,293,12,-281,B
MagicMon 2007.07.04,1069,1,1,23,216,13,-203,A
MagicMon 2007.07.04,1069,1,1,23,189,22,-167,B
laksen 2007.07.04,873,1,0,26,187,31,-156,A
laksen 2007.07.04,873,1,0,26,184,31,-153,B
louiswei 2007.12.24,839,1,0,18,177,56,-121,A
louiswei 2007.12.24,839,1,0,18,177,56,-121,B
bullrock 2007.12.24,1139,1,1,17,86,47,-39,A
bullrock 2007.12.24,1139,1,1,17,87,53,-34,B
michaelchen 2007.12.16,952,1,0,35,144,40,-104,A
michaelchen 2007.12.16,952,1,0,35,133,40,-93,B
Avatarz 2007.12.16,1014,1,1,29,60,34,-26,A
Avatarz 2007.12.16,1014,1,1,29,60,31,-29,B
blingking 2007.12.21,1069,1,1,21,182,33,-149,A
blingking 2007.12.21,1069,1,1,21,197,38,-159,B
Kayode 2007.12.13,988,1,0,11,410,18,-392,A
Kayode 2007.12.13,988,1,0,11,430,18,-412,B
podlas 2007.12.13,991,1,1,9,278,33,-245,A
podlas 2007.12.13,991,1,1,9,302,22,-280,B
NiceEvent 2007.11.24,819,1,0,35,157,37,-120,A
NiceEvent 2007.11.24,819,1,0,35,120,37,-83,B
DHamm 2007.11.24,878,1,1,37,105,51,-54,A
DHamm 2007.11.24,878,1,1,37,103,43,-60,B
RandallMR 2007.11.25,1140,1,1,43,89,30,-59,A
RandallMR 2007.11.25,1140,1,1,43,94,30,-64,B
DINOCO 2007.11.25,857,2,0,49,166,25,-141,A
DINOCO 2007.11.25,857,2,0,49,165,22,-143,B
louiswei 2007.12.22,832,2,0,47,179,28,-151,A
louiswei 2007.12.22,832,2,0,47,168,28,-140,B
blingking 2007.12.22,1075,2,2,46,108,39,-69,A
blingking 2007.12.22,1075,2,2,46,106,37,-69,B
paperchasdvincent 2007.12.18,969,1,1,6,91,17,-74,A
paperchasdvincent 2007.12.18,969,1,1,6,76,33,-43,B
thebrickwall 2007.12.18,1021,1,0,6,273,0,-273,A
thebrickwall 2007.12.18,1021,1,0,6,283,0,-283,B
ippat 2007.11.28,984,2,0.5,63,156,25,-131,A
ippat 2007.11.28,984,2,0.5,63,168,22,-146,B
fseeling 2007.11.28,1005,2,1.5,66,205,29,-176,A
fseeling 2007.11.28,1005,2,1.5,66,217,30,-187,B
jamesobrien 2007.06.27,935,1,0,6,417,0,-417,A
jamesobrien 2007.06.27,935,1,0,6,504,0,-504,B
GatorWarrior 2007.06.27,1036,1,1,5,271,20,-251,A
GatorWarrior 2007.06.27,1036,1,1,5,338,40,-298,B
Malca 2007.07.02,1058,1,1,25,86,68,-18,A
Malca 2007.07.02,1058,1,1,25,98,56,-42,B
Malca 2007.07.02,1058,1,1,25,92,52,-40,C
luming 2007.07.02,920,1,0,22,138,32,-106,A
luming 2007.07.02,920,1,0,22,140,32,-108,B
luming 2007.07.02,920,1,0,22,126,36,-90,C
Cheezychess 2007.12.20,883,1,1,18,229,28,-201,A
Cheezychess 2007.12.20,883,1,1,18,230,28,-202,B
rooktakesqueen 2007.06.30,1098,1,1,5,179,40,-139,A
rooktakesqueen 2007.06.30,1098,1,1,5,117,40,-77,B
thebrickwall 2007.12.08,955,1,1,16,83,31,-52,A
thebrickwall 2007.12.08,955,1,1,16,83,44,-39,B
adamjodonnell 2007.12.08,954,1,0,18,252,22,-230,A
adamjodonnell 2007.12.08,954,1,0,18,250,22,-228,B
whitelighter 2007.06.28,974,1,0,19,213,16,-197,A
whitelighter 2007.06.28,974,1,0,19,218,5,-213,B
Woosky 2007.06.28,983,1,1,19,185,26,-159,A
Woosky 2007.06.28,983,1,1,19,191,26,-165,B
kassab 2007.07.04,1026,1,1,22,166,23,-143,A
kassab 2007.07.04,1026,1,1,22,150,23,-127,B
DHamm 2007.12.08,946,2,1,36,168,36,-132,A
DHamm 2007.12.08,946,2,1,36,163,33,-130,B
tyfoonturk 2007.12.08,1041,1,1,17,124,29,-95,A
tyfoonturk 2007.12.08,1041,1,1,17,137,24,-113,B
luoyun 2007.12.05,989,1,0,38,105,32,-73,A
luoyun 2007.12.05,989,1,0,38,119,32,-87,B
jinbu 2007.11.30,865,1,0,27,159,30,-129,A
jinbu 2007.11.30,865,1,0,27,156,26,-130,B
Pestachio 2007.11.30,1095,1,1,24,49,46,-3,A
Pestachio 2007.11.30,1095,1,1,24,57,46,-11,B
bullrock 2007.12.23,1131,1,0,22,113,23,-90,A
bullrock 2007.12.23,1131,1,0,22,101,32,-69,B
Cheezychess 2007.12.23,865,1,1,19,49,37,-12,A
Cheezychess 2007.12.23,865,1,1,19,43,42,-1,B
louiswei 2007.12.07,835,1,0,10,378,10,-368,A
louiswei 2007.12.07,835,1,0,10,380,0,-380,B
vetteboy 2007.12.07,990,1,1,8,145,25,-120,A
vetteboy 2007.12.07,990,1,1,8,134,38,-96,B
thebrickwall 2007.12.09,962,1,0.5,26,181,35,-146,A
thebrickwall 2007.12.09,962,1,0.5,26,173,31,-142,B
Caledonian 2007.12.09,795,1,0.5,25,152,28,-124,A
Caledonian 2007.12.09,795,1,0.5,25,143,32,-111,B
JLLR 2007.06.28,1118,1,1,15,104,53,-51,A
JLLR 2007.06.28,1118,1,1,15,98,53,-45,B
louiswei 2007.11.15,786,1,1,21,155,24,-131,A
louiswei 2007.11.15,786,1,1,21,143,14,-129,B
BeNumberOne 2007.11.15,1021,1,0,20,94,30,-64,A
BeNumberOne 2007.11.15,1021,1,0,20,106,25,-81,B
SChlebowski 2007.11.02,1194,1,1,13,83,46,-37,A
SChlebowski 2007.11.02,1194,1,1,13,77,46,-31,B
louiswei 2007.11.02,780,1,0,12,190,42,-148,A
louiswei 2007.11.02,780,1,0,12,193,33,-160,B
tyfoonturk 2007.11.04,1030,1,1,4,35,50,15,A
tyfoonturk 2007.11.04,1030,1,1,4,60,50,-10,B
jinbu 2007.11.04,877,1,0,7,283,0,-283,A
jinbu 2007.11.04,877,1,0,7,293,14,-279,B
Aydo 2007.06.20,1052,1,1,4,186,25,-161,A
Aydo 2007.06.20,1052,1,1,4,204,25,-179,B
YINGYING 2007.06.20,942,1,0,4,414,25,-389,A
YINGYING 2007.06.20,942,1,0,4,419,25,-394,B
louiswei 2007.12.19,834,1,0,30,125,40,-85,A
louiswei 2007.12.19,834,1,0,30,129,43,-86,B
thebrickwall 2007.12.19,1004,1,1,30,167,20,-147,A
thebrickwall 2007.12.19,1004,1,1,30,179,17,-162,B
Cheezychess 2007.11.23,838,1,0,6,331,17,-314,A
Cheezychess 2007.11.23,838,1,0,6,342,17,-325,B
dberryco 2007.11.23,1030,1,1,5,172,40,-132,A
dberryco 2007.11.23,1030,1,1,5,199,40,-159,B
CLAS 2007.06.28,1075,1,1,11,162,27,-135,A
CLAS 2007.06.28,1075,1,1,11,175,27,-148,B
Malca 2007.06.27,1043,2,2,8,37,25,-12,A
Malca 2007.06.27,1043,2,2,8,36,25,-11,B
laksen 2007.06.27,914,2,0,12,293,25,-268,A
laksen 2007.06.27,914,2,0,12,201,25,-176,B
azaluski 2007.11.01,1123,1,1,23,140,26,-114,A
azaluski 2007.11.01,1123,1,1,23,156,26,-130,B
ilikecomputer 2007.11.01,765,1,0,23,171,35,-136,A
ilikecomputer 2007.11.01,765,1,0,23,179,30,-149,B
joethecoolestman 2007.10.23,754,1,0,10,298,20,-278,A
joethecoolestman 2007.10.23,754,1,0,10,292,20,-272,B
shadowroy 2007.10.23,1110,1,1,9,119,56,-63,A
shadowroy 2007.10.23,1110,1,1,9,114,44,-70,B
ilikecomputer 2007.10.17,798,1,0,28,159,29,-130,A
ilikecomputer 2007.10.17,798,1,0,28,130,39,-91,B
stephenbyers 2007.10.17,1110,1,1,26,78,46,-32,A
stephenbyers 2007.10.17,1110,1,1,26,74,46,-28,B
Pillowpants 2007.06.04,821,1,0,5,307,0,-307,A
Pillowpants 2007.06.04,821,1,0,5,297,0,-297,B
houseofcakes 2007.06.04,1102,1,1,4,52,50,-2,A
houseofcakes 2007.06.04,1102,1,1,4,52,50,-2,B
Philiphh 2007.06.03,951,2,0,41,177,24,-153,A
Philiphh 2007.06.03,951,2,0,41,155,24,-131,B
shadyKnight 2007.06.03,1001,2,2,38,105,37,-68,A
shadyKnight 2007.06.03,1001,2,2,38,79,34,-45,B
rarte 2007.12.18,1101,1,0,12,328,17,-311,A
rarte 2007.12.18,1101,1,0,12,306,17,-289,B
Ratatoesk 2007.12.18,858,1,1,11,302,9,-293,A
Ratatoesk 2007.12.18,858,1,1,11,261,9,-252,B
timmybucks 2007.06.30,1118,1,0.5,11,196,18,-178,A
timmybucks 2007.06.30,1118,1,0.5,11,197,18,-179,B
splicerx 2007.06.28,1147,1,1,15,397,13,-384,A
splicerx 2007.06.28,1147,1,1,15,310,20,-290,B
DINOCO 2007.11.15,818,1,0,29,140,24,-116,A
DINOCO 2007.11.15,818,1,0,29,108,31,-77,B
WhiteSide 2007.11.15,839,1,1,28,80,29,-51,A
WhiteSide 2007.11.15,839,1,1,28,75,29,-46,B
louiswei 2007.12.13,840,1,0,11,448,9,-439,A
louiswei 2007.12.13,840,1,0,11,435,9,-426,B
plcsparky 2007.12.13,1087,1,1,12,393,25,-368,A
plcsparky 2007.12.13,1087,1,1,12,373,33,-340,B
CrassNaste 2007.06.30,1005,1,1,9,287,0,-287,A
CrassNaste 2007.06.30,1005,1,1,9,332,0,-332,B
CrassNaste 2007.06.29,993,1,0,23,206,30,-176,A
CrassNaste 2007.06.29,993,1,0,23,206,30,-176,B
Bbbumpy 2007.06.29,908,1,1,20,116,50,-66,A
Bbbumpy 2007.06.29,908,1,1,20,114,45,-69,B
WayneRuyLopez 2007.11.25,1119,1,1,8,204,38,-166,A
WayneRuyLopez 2007.11.25,1119,1,1,8,232,38,-194,B
jinbu 2007.11.13,840,2,1,19,270,11,-259,A
jinbu 2007.11.13,840,2,1,19,253,5,-248,B
OldWazzaBoy 2007.11.13,980,1,1,10,126,60,-66,A
OldWazzaBoy 2007.11.13,980,1,1,10,104,40,-64,B
louiswei 2007.11.19,802,1,0,14,226,29,-197,A
louiswei 2007.11.19,802,1,0,14,221,36,-185,B
Jia 2007.11.19,1060,1,1,14,210,36,-174,A
Jia 2007.11.19,1060,1,1,14,203,36,-167,B
talleyman 2007.12.07,1124,1,1,34,78,47,-31,A
talleyman 2007.12.07,1124,1,1,34,72,47,-25,B
jinbu 2007.12.07,848,1,0,34,121,35,-86,A
jinbu 2007.12.07,848,1,0,34,102,38,-64,B
BeNumberOne 2007.12.03,1041,1,1,13,52,62,10,A
BeNumberOne 2007.12.03,1041,1,1,13,55,62,7,B
DINOCO 2007.12.03,829,2,1,25,217,32,-185,A
DINOCO 2007.12.03,829,2,1,25,207,32,-175,B
spenda 2007.11.08,814,2,0,28,206,21,-185,A
spenda 2007.11.08,814,2,0,28,197,21,-176,B
Timandre 2007.11.08,1167,1,1,3,0,67,67,A
Timandre 2007.11.08,1167,1,1,3,26,67,41,B
Sansui 2007.11.01,1106,1,0,39,126,33,-93,A
Sansui 2007.11.01,1106,1,0,39,141,33,-108,B
lamemyles 2007.11.01,853,1,1,36,81,42,-39,A
lamemyles 2007.11.01,853,1,1,36,74,42,-32,B
louiswei 2007.12.08,837,1,0,25,215,24,-191,A
louiswei 2007.12.08,837,1,0,25,210,24,-186,B
fabras 2007.12.08,1114,1,1,23,140,30,-110,A
fabras 2007.12.08,1114,1,1,23,142,30,-112,B
jokkman 2007.12.03,1051,1,0,18,309,22,-287,A
jokkman 2007.12.03,1051,1,0,18,235,22,-213,B
vijm 2007.06.28,1124,1,1,8,220,25,-195,A
vijm 2007.06.28,1124,1,1,8,160,25,-135,B
thebrickwall 2007.12.10,952,1,1,38,224,21,-203,A
thebrickwall 2007.12.10,952,1,1,38,212,21,-191,B
docholloday 2007.12.10,1020,1,0,36,262,28,-234,A
docholloday 2007.12.10,1020,1,0,36,251,28,-223,B
DINOCO 2007.10.22,794,2,0,59,143,20,-123,A
DINOCO 2007.10.22,794,2,0,59,145,24,-121,B
brunuoh 2007.10.22,1203,1,1,8,102,50,-52,A
brunuoh 2007.10.22,1203,1,1,8,76,38,-38,B
andoferni 2007.10.20,985,1,0,10,406,10,-396,A
andoferni 2007.10.20,985,1,0,10,386,10,-376,B
MrBoris 2007.10.20,983,1,1,9,307,0,-307,A
MrBoris 2007.10.20,983,1,1,9,280,0,-280,B
metalayer 2007.06.16,964,1,0,12,258,25,-233,A
metalayer 2007.06.16,964,1,0,12,258,17,-241,B
suppechasper 2007.06.16,1011,2,1,16,265,25,-240,A
suppechasper 2007.06.16,1011,2,1,16,257,31,-226,B
ShaneSher 2007.10.13,1009,1,1,4,23,75,52,A
ShaneSher 2007.10.13,1009,1,1,4,25,75,50,B
louiswei 2007.10.13,828,1,0,5,422,40,-382,A
louiswei 2007.10.13,828,1,0,5,420,40,-380,B
Silveraj 2007.10.03,958,1,1,7,281,14,-267,A
Silveraj 2007.10.03,958,1,1,7,194,14,-180,B
SoloBaric 2007.10.03,998,1,0,9,430,11,-419,A
SoloBaric 2007.10.03,998,1,0,9,432,11,-421,B
Cheezychess 2007.12.08,1006,1,0,19,193,37,-156,A
Cheezychess 2007.12.08,1006,1,0,19,159,32,-127,B
jmaeder 2007.12.04,981,1,0,5,475,0,-475,A
jmaeder 2007.12.04,981,1,0,5,433,20,-413,B
ScottieD 2007.12.04,926,1,1,4,186,50,-136,A
ScottieD 2007.12.04,926,1,1,4,191,75,-116,B
zhouzhou 2007.11.28,959,1,1,24,163,42,-121,A
zhouzhou 2007.11.28,959,1,1,24,157,33,-124,B
DINOCO 2007.11.28,839,1,0,30,241,30,-211,A
DINOCO 2007.11.28,839,1,0,30,252,30,-222,B
jtseng 2007.12.02,1013,1,1,4,43,25,-18,A
jtseng 2007.12.02,1013,1,1,4,20,50,30,B
Ativa 2007.12.02,970,1,0,5,448,20,-428,A
Ativa 2007.12.02,970,1,0,5,243,0,-243,B
jamesobrien 2007.06.26,897,1,1,14,46,57,11,A
jamesobrien 2007.06.26,897,1,1,14,46,57,11,B
nedy 2007.06.26,1039,1,0,15,165,27,-138,A
nedy 2007.06.26,1039,1,0,15,130,33,-97,B
hanntannif 2007.10.27,1102,1,1,13,86,31,-55,A
hanntannif 2007.10.27,1102,1,1,13,82,31,-51,B
DINOCO 2007.10.27,799,1,0,13,139,31,-108,A
DINOCO 2007.10.27,799,1,0,13,138,31,-107,B
jmaeder 2007.11.27,996,1,0.5,36,198,36,-162,A
jmaeder 2007.11.27,996,1,0.5,36,201,33,-168,B
vetteboy 2007.11.27,988,1,0.5,38,128,37,-91,A
vetteboy 2007.11.27,988,1,0.5,38,131,42,-89,B
mamede 2007.11.25,1190,1,1,13,91,46,-45,A
mamede 2007.11.25,1190,1,1,13,75,54,-21,B
SunRaphi 2007.06.27,1052,1,1,17,253,29,-224,A
SunRaphi 2007.06.27,1052,1,1,17,251,29,-222,B
simonjs 2007.06.27,915,1,0,17,380,12,-368,A
simonjs 2007.06.27,915,1,0,17,357,18,-339,B
jmaeder 2007.10.30,900,1,1,12,96,42,-54,A
jmaeder 2007.10.30,900,1,1,12,130,33,-97,B
FreddyAbeloos 2007.10.30,985,1,0,13,376,8,-368,A
FreddyAbeloos 2007.10.30,985,1,0,13,360,15,-345,B
ilikecomputer 2007.10.29,778,1,0,20,227,10,-217,A
ilikecomputer 2007.10.29,778,1,0,20,207,5,-202,B
Halfman 2007.10.29,1187,1,1,19,123,16,-107,A
Halfman 2007.10.29,1187,1,1,19,118,26,-92,B
TusharAmba 2007.10.28,1118,2,2,39,113,41,-72,A
TusharAmba 2007.10.28,1118,2,2,39,114,38,-76,B
navneet 2007.10.28,876,2,0,37,169,16,-153,A
navneet 2007.10.28,876,2,0,37,167,16,-151,B
zhouzhou 2007.11.30,963,1,1,5,141,20,-121,A
zhouzhou 2007.11.30,963,1,1,5,128,20,-108,B
Artmachine 2007.11.30,1025,1,0,8,267,12,-255,A
Artmachine 2007.11.30,1025,1,0,8,260,12,-248,B
ukjay 2007.11.13,1128,1,0,5,114,40,-74,A
ukjay 2007.11.13,1128,1,0,5,122,40,-82,B
juansebastian 2007.11.07,1178,2,1,24,167,42,-125,A
juansebastian 2007.11.07,1178,2,1,24,161,42,-119,B
DINOCO 2007.11.07,807,2,1,27,289,18,-271,A
DINOCO 2007.11.07,807,2,1,27,282,15,-267,B
whitelighter 2007.06.02,977,1,0,27,242,33,-209,A
whitelighter 2007.06.02,977,1,0,27,245,22,-223,B
XsteveoX 2007.06.02,960,1,1,29,313,24,-289,A
XsteveoX 2007.06.02,960,1,1,29,312,21,-291,B
Tycew 2007.11.21,906,1,0,18,125,33,-92,A
Tycew 2007.11.21,906,1,0,18,118,22,-96,B
BeNumberOne 2007.11.21,1006,1,1,17,72,6,-66,A
BeNumberOne 2007.11.21,1006,1,1,17,60,12,-48,B
DINOCO 2007.11.18,816,1,0.5,44,136,25,-111,A
DINOCO 2007.11.18,816,1,0.5,44,127,23,-104,B
BurtForFun 2007.11.18,1162,1,0.5,44,101,20,-81,A
BurtForFun 2007.11.18,1162,1,0.5,44,96,20,-76,B
luoyun 2007.11.14,964,1,1,23,299,26,-273,A
luoyun 2007.11.14,964,1,1,23,328,22,-306,B
jmaeder 2007.11.14,1015,1,0,14,240,50,-190,A
jmaeder 2007.11.14,1015,1,0,14,272,21,-251,B
vetteboy 2007.11.09,939,1,1,8,340,0,-340,A
vetteboy 2007.11.09,939,1,1,8,374,0,-374,B
zhouzhou 2007.11.09,927,1,0,8,345,12,-333,A
zhouzhou 2007.11.09,927,1,0,8,338,25,-313,B
bosamor 2007.10.16,1019,1,1,10,156,30,-126,A
bosamor 2007.10.16,1019,1,1,10,166,30,-136,B
deboragleice 2007.11.12,846,1,0.5,13,313,8,-305,A
deboragleice 2007.11.12,846,1,0.5,13,295,8,-287,B
thebrickwall 2007.11.12,993,1,0.5,11,139,9,-130,A
thebrickwall 2007.11.12,993,1,0.5,11,134,9,-125,B
DINOCO 2007.10.30,789,2,0,16,247,25,-222,A
DINOCO 2007.10.30,789,2,0,16,242,25,-217,B
Tycew 2007.10.30,879,1,1,6,87,33,-54,A
Tycew 2007.10.30,879,1,1,6,58,50,-8,B
ignacionf 2007.11.10,1046,1,1,15,119,40,-79,A
ignacionf 2007.11.10,1046,1,1,15,114,40,-74,B
zhouzhou 2007.11.10,907,1,0,16,168,25,-143,A
zhouzhou 2007.11.10,907,1,0,16,181,25,-156,B
BeNumberOne 2007.10.30,1001,1,1,9,130,56,-74,A
BeNumberOne 2007.10.30,1001,1,1,9,127,56,-71,B
jinbu 2007.10.28,860,1,0.5,7,518,29,-489,A
jinbu 2007.10.28,860,1,0.5,7,266,29,-237,B
Aydo 2007.10.28,1092,1,0.5,4,117,25,-92,A
Aydo 2007.10.28,1092,1,0.5,4,101,50,-51,B
zhouzhou 2007.11.16,904,1,1,20,219,10,-209,A
zhouzhou 2007.11.16,904,1,1,20,205,15,-190,B
DINOCO 2007.11.16,800,1,0,25,250,40,-210,A
DINOCO 2007.11.16,800,1,0,25,253,32,-221,B
TheJudgeSarov 2007.11.04,1070,1,1,7,115,29,-86,A
TheJudgeSarov 2007.11.04,1070,1,1,7,124,29,-95,B
Krishnadas 2007.11.04,904,1,0,7,214,14,-200,A
Krishnadas 2007.11.04,904,1,0,7,223,14,-209,B
louiswei 2007.11.01,782,1,0,16,206,6,-200,A
louiswei 2007.11.01,782,1,0,16,169,12,-157,B
xlmr 2007.11.01,1171,1,1,14,87,29,-58,A
xlmr 2007.11.01,1171,1,1,14,51,29,-22,B
drewly 2007.10.22,1187,1,1,16,162,38,-124,A
drewly 2007.10.22,1187,1,1,16,107,38,-69,B
joethecoolestman 2007.10.22,762,1,0,20,185,35,-150,A
joethecoolestman 2007.10.22,762,1,0,20,204,35,-169,B
electronf 2007.06.08,952,1,1,10,190,40,-150,A
electronf 2007.06.08,952,1,1,10,188,40,-148,B
CausalClosure 2007.06.08,1033,1,0,11,322,18,-304,A
CausalClosure 2007.06.08,1033,1,0,11,323,18,-305,B
ilikecar 2007.10.11,994,1,1,11,90,54,-36,A
ilikecar 2007.10.11,994,1,1,11,86,54,-32,B
joshaidan 2007.10.11,986,1,0,11,206,54,-152,A
joshaidan 2007.10.11,986,1,0,11,210,54,-156,B
BurtForFun 2007.10.03,1139,1,1,20,232,30,-202,A
BurtForFun 2007.10.03,1139,1,1,20,261,15,-246,B
louiswei 2007.10.03,819,1,0,20,316,25,-291,A
louiswei 2007.10.03,819,1,0,20,307,30,-277,B
awhittaker 2007.06.24,731,1,0,14,376,7,-369,A
awhittaker 2007.06.24,731,1,0,14,400,14,-386,B
crisforrest 2007.06.24,1114,1,1,7,253,0,-253,A
crisforrest 2007.06.24,1114,1,1,7,282,0,-282,B
CausalClosure 2007.06.13,972,2,1,54,153,41,-112,A
CausalClosure 2007.06.13,972,2,1,54,131,37,-94,B
Malca 2007.06.13,1016,1,0,27,223,37,-186,A
Malca 2007.06.13,1016,1,0,27,232,37,-195,B
whitelighter 2007.06.03,957,1,1,30,89,33,-56,A
whitelighter 2007.06.03,957,1,1,30,82,33,-49,B
lordcyrix 2007.06.03,1007,1,0,30,116,30,-86,A
lordcyrix 2007.06.03,1007,1,0,30,119,47,-72,B
Artmachine 2007.10.12,1047,1,0,19,323,26,-297,A
Artmachine 2007.10.12,1047,1,0,19,298,26,-272,B
Ativa 2007.10.12,945,1,1,15,180,13,-167,A
Ativa 2007.10.12,945,1,1,15,220,13,-207,B
waynerooneyfan 2007.11.08,1185,1,1,22,147,46,-101,A
waynerooneyfan 2007.11.08,1185,1,1,22,156,50,-106,B
waynerooneyfan 2007.11.08,1185,1,1,22,160,46,-114,C
louiswei 2007.10.30,802,1,0,12,490,8,-482,A
louiswei 2007.10.30,802,1,0,12,477,17,-460,B
vetteboy 2007.10.30,944,1,1,12,415,25,-390,A
vetteboy 2007.10.30,944,1,1,12,406,25,-381,B
mwebber 2007.10.25,998,1,0,18,113,44,-69,A
mwebber 2007.10.25,998,1,0,18,113,50,-63,B
buddhajuke 2007.10.25,878,1,1,17,78,47,-31,A
buddhajuke 2007.10.25,878,1,1,17,81,47,-34,B
louiswei 2007.10.29,806,1,0,24,303,12,-291,A
louiswei 2007.10.29,806,1,0,24,322,17,-305,B
peihan 2007.10.29,1084,1,1,20,173,15,-158,A
peihan 2007.10.29,1084,1,1,20,188,20,-168,B
Syrik 2007.10.22,1106,1,1,11,34,54,20,A
Syrik 2007.10.22,1106,1,1,11,30,64,34,B
Seroth 2007.10.22,736,1,0,14,280,21,-259,A
Seroth 2007.10.22,736,1,0,14,274,21,-253,B
Refry 2007.06.21,1038,1,1,4,121,50,-71,A
Refry 2007.06.21,1038,1,1,4,103,25,-78,B
saturnine 2007.06.21,938,1,0,6,356,50,-306,A
saturnine 2007.06.21,938,1,0,6,223,17,-206,B
thebiznassman 2007.06.21,900,1,0,5,241,0,-241,A
thebiznassman 2007.06.21,900,1,0,5,215,0,-215,B
RABBITrabbit 2007.06.21,1062,1,1,6,609,0,-609,A
RABBITrabbit 2007.06.21,1062,1,1,6,602,0,-602,B
Syrik 2007.10.23,1108,2,2,17,203,29,-174,A
Syrik 2007.10.23,1108,2,2,17,192,24,-168,B
Seroth 2007.10.23,719,2,0,21,335,24,-311,A
Seroth 2007.10.23,719,2,0,21,362,29,-333,B
Artmachine 2007.10.20,1009,1,0.5,28,103,36,-67,A
Artmachine 2007.10.20,1009,1,0.5,28,114,36,-78,B
jmaeder 2007.10.20,957,1,0.5,28,141,18,-123,A
jmaeder 2007.10.20,957,1,0.5,28,175,21,-154,B
DINOCO 2007.10.17,825,1,0,9,398,22,-376,A
DINOCO 2007.10.17,825,1,0,9,402,33,-369,B
BeNumberOne 2007.10.17,984,1,1,6,170,33,-137,A
BeNumberOne 2007.10.17,984,1,1,6,123,50,-73,B
electronf 2007.06.11,998,1,1,4,211,25,-186,A
electronf 2007.06.11,998,1,1,4,216,25,-191,B
laksen 2007.06.11,893,1,0,4,0,100,100,A
laksen 2007.06.11,893,1,0,4,0,100,100,B
jmaeder 2007.10.15,966,1,0,13,355,8,-347,A
jmaeder 2007.10.15,966,1,0,13,278,15,-263,B
jlorby 2007.10.15,997,1,1,10,45,60,15,A
jlorby 2007.10.15,997,1,1,10,42,60,18,B
MrBogs 2007.09.23,1002,1,1,5,154,20,-134,A
MrBogs 2007.09.23,1002,1,1,5,136,40,-96,B
louiswei 2007.09.23,837,1,0,4,246,0,-246,A
louiswei 2007.09.23,837,1,0,4,298,0,-298,B
Fencingiscool 2007.09.19,1033,1,0,12,308,8,-300,A
Fencingiscool 2007.09.19,1033,1,0,12,286,17,-269,B
hysong 2007.09.19,870,1,1,11,234,36,-198,A
hysong 2007.09.19,870,1,1,11,212,36,-176,B
soucyj 2007.09.01,971,1,0,24,246,25,-221,A
soucyj 2007.09.01,971,1,0,24,227,12,-215,B
Artmachine 2007.09.01,1001,1,1,21,146,33,-113,A
Artmachine 2007.09.01,1001,1,1,21,134,33,-101,B
TonyLechner 2007.08.16,799,1,0,11,219,0,-219,A
TonyLechner 2007.08.16,799,1,0,11,219,0,-219,B
robofriven 2007.08.16,1164,1,1,10,51,40,-11,A
robofriven 2007.08.16,1164,1,1,10,51,40,-11,B
laksen 2007.07.30,864,3,1,48,289,12,-277,A
laksen 2007.07.30,864,3,1,48,283,17,-266,B
BurtForFun 2007.07.30,1029,1,0,14,367,14,-353,A
BurtForFun 2007.07.30,1029,1,0,14,372,14,-358,B
simonjs 2007.06.20,1010,2,0.5,56,136,36,-100,A
simonjs 2007.06.20,1010,2,0.5,56,122,37,-85,B
Refry 2007.06.20,932,1,0.5,40,146,40,-106,A
Refry 2007.06.20,932,1,0.5,40,159,42,-117,B
richarddixon 2007.06.20,917,1,1,19,117,42,-75,A
richarddixon 2007.06.20,917,1,1,19,119,37,-82,B
Syrik 2007.10.24,1112,1,1,17,294,18,-276,A
Syrik 2007.10.24,1112,1,1,17,305,12,-293,B
Seroth 2007.10.24,693,1,0,19,378,32,-346,A
Seroth 2007.10.24,693,1,0,19,391,32,-359,B
jmaeder 2007.10.23,943,1,0,12,214,25,-189,A
jmaeder 2007.10.23,943,1,0,12,231,25,-206,B
soucyj 2007.10.23,1004,1,1,9,97,44,-53,A
soucyj 2007.10.23,1004,1,1,9,78,44,-34,B
jmaeder 2007.10.29,910,1,0,22,179,36,-143,A
jmaeder 2007.10.29,910,1,0,22,176,46,-130,B
rdubs 2007.10.29,1067,1,1,20,108,30,-78,A
rdubs 2007.10.29,1067,1,1,20,93,35,-58,B
kyleelhs 2007.10.27,944,1,1,16,110,38,-72,A
kyleelhs 2007.10.27,944,1,1,16,81,44,-37,B
zhouzhou 2007.10.27,953,1,0,23,434,22,-412,A
zhouzhou 2007.10.27,953,1,0,23,440,22,-418,B
joethecoolestman 2007.10.25,747,1,0,5,359,0,-359,A
joethecoolestman 2007.10.25,747,1,0,5,328,20,-308,B
superpete 2007.10.25,1229,1,1,4,118,25,-93,A
superpete 2007.10.25,1229,1,1,4,95,25,-70,B
JFolla 2007.06.12,1086,1,1,22,116,54,-62,A
JFolla 2007.06.12,1086,1,1,22,110,54,-56,B
JFolla 2007.06.12,1086,1,1,22,116,54,-62,C
prettydarnbad 2007.06.12,782,1,0,21,156,19,-137,A
prettydarnbad 2007.06.12,782,1,0,21,148,19,-129,B
prettydarnbad 2007.06.12,782,1,0,21,152,33,-119,C
Seroth 2007.10.25,682,1,0,5,329,40,-289,A
Seroth 2007.10.25,682,1,0,5,334,20,-314,B
Syrik 2007.10.25,1139,1,1,4,90,25,-65,A
Syrik 2007.10.25,1139,1,1,4,72,25,-47,B
karimniemela 2007.10.13,833,1,1,12,96,33,-63,A
karimniemela 2007.10.13,833,1,1,12,78,42,-36,B
beasley 2007.10.13,1157,1,0,12,210,33,-177,A
beasley 2007.10.13,1157,1,0,12,208,25,-183,B
talleyman 2007.10.24,1184,1,1,7,378,0,-378,A
talleyman 2007.10.24,1184,1,1,7,379,0,-379,B
DINOCO 2007.10.24,807,1,0,6,216,17,-199,A
DINOCO 2007.10.24,807,1,0,6,209,17,-192,B
DINOCO 2007.10.18,808,1,0,9,239,11,-228,A
DINOCO 2007.10.18,808,1,0,9,243,11,-232,B
peihan 2007.10.18,1080,1,1,8,78,38,-40,A
peihan 2007.10.18,1080,1,1,8,105,38,-67,B
Ativa 2007.06.18,784,1,1,22,47,64,17,A
Ativa 2007.06.18,784,1,1,22,44,54,10,B
Ativa 2007.06.18,784,1,1,22,45,46,1,C
Dakel 2007.06.18,1012,1,0,22,87,41,-46,A
Dakel 2007.06.18,1012,1,0,22,77,41,-36,B
Dakel 2007.06.18,1012,1,0,22,84,32,-52,C
jmaeder 2007.10.21,957,2,1,45,147,33,-114,A
jmaeder 2007.10.21,957,2,1,45,142,24,-118,B
thess 2007.10.21,986,2,1,50,122,40,-82,A
thess 2007.10.21,986,2,1,50,140,36,-104,B
louiswei 2007.10.22,804,1,0,7,342,0,-342,A
louiswei 2007.10.22,804,1,0,7,368,0,-368,B
peihan 2007.10.22,1078,2,2,51,86,37,-49,A
peihan 2007.10.22,1078,2,2,51,95,33,-62,B
CausalClosure 2007.06.16,979,2,1,13,237,23,-214,A
CausalClosure 2007.06.16,979,2,1,13,254,31,-223,B
Babnet 2007.06.13,975,1,1,32,142,41,-101,A
Babnet 2007.06.13,975,1,1,32,150,31,-119,B
whitelighter 2007.06.18,998,1,1,14,151,43,-108,A
whitelighter 2007.06.18,998,1,1,14,148,36,-112,B
Woosky 2007.06.18,1000,1,0,14,195,14,-181,A
Woosky 2007.06.18,1000,1,0,14,215,14,-201,B
buddhajuke 2007.10.20,828,1,1,8,428,0,-428,A
buddhajuke 2007.10.20,828,1,1,8,535,0,-535,B
beasley 2007.10.20,1132,1,0,11,665,0,-665,A
beasley 2007.10.20,1132,1,0,11,669,0,-669,B
jinbu 2007.10.20,822,1,1,11,242,18,-224,A
jinbu 2007.10.20,822,1,1,11,202,18,-184,B
BeNumberOne 2007.10.20,1012,1,0,10,118,60,-58,A
BeNumberOne 2007.10.20,1012,1,0,10,94,60,-34,B
kreshoo 2007.06.12,936,1,1,26,136,19,-117,A
kreshoo 2007.06.12,936,1,1,26,140,19,-121,B
YINGYING 2007.06.12,979,1,0,26,187,23,-164,A
YINGYING 2007.06.12,979,1,0,26,189,23,-166,B
louiswei 2007.10.17,812,1,0,8,238,0,-238,A
louiswei 2007.10.17,812,1,0,8,194,12,-182,B
Artmachine 2007.10.17,1003,1,1,7,133,0,-133,A
Artmachine 2007.10.17,1003,1,1,7,83,0,-83,B
Ativa 2007.06.17,790,1,0,7,101,29,-72,A
Ativa 2007.06.17,790,1,0,7,136,29,-107,B
jugglepro 2007.06.17,1088,1,1,6,70,50,-20,A
jugglepro 2007.06.17,1088,1,1,6,66,83,17,B
Fimbrethil 2007.06.06,957,1,0,18,413,11,-402,A
Fimbrethil 2007.06.06,957,1,0,18,412,11,-401,B
lordcyrix 2007.06.06,970,1,1,14,239,36,-203,A
lordcyrix 2007.06.06,970,1,1,14,258,29,-229,B
jaxonmills 2007.06.02,1040,1,1,16,238,31,-207,A
jaxonmills 2007.06.02,1040,1,1,16,240,31,-209,B
Philiphh 2007.06.02,869,2,0.5,30,227,20,-207,A
Philiphh 2007.06.02,869,2,0.5,30,218,20,-198,B
Malca 2007.10.04,1152,1,0,37,257,30,-227,A
Malca 2007.10.04,1152,1,0,37,241,32,-209,B
Malca 2007.10.04,1152,1,0,37,249,32,-217,C
herrahuu 2007.10.04,817,1,1,24,244,63,-181,A
herrahuu 2007.10.04,817,1,1,24,192,58,-134,B
herrahuu 2007.10.04,817,1,1,24,130,50,-80,C
laksen 2007.08.05,863,2,0,33,368,21,-347,A
laksen 2007.08.05,863,2,0,33,373,21,-352,B
vetteboy 2007.08.05,872,1,1,18,272,33,-239,A
vetteboy 2007.08.05,872,1,1,18,266,39,-227,B
suppechasper 2007.06.18,1005,1,1,5,231,20,-211,A
suppechasper 2007.06.18,1005,1,1,5,221,20,-201,B
YINGYING 2007.06.18,969,1,0,5,320,0,-320,A
YINGYING 2007.06.18,969,1,0,5,315,0,-315,B
kreshoo 2007.06.11,917,1,0,18,422,17,-405,A
kreshoo 2007.06.11,917,1,0,18,452,17,-435,B
redheat 2007.06.11,1048,1,1,15,350,33,-317,A
redheat 2007.06.11,1048,1,1,15,343,33,-310,B
SCHWAM 2007.10.16,1205,1,1,21,260,19,-241,A
SCHWAM 2007.10.16,1205,1,1,21,260,24,-236,B
jinbu 2007.10.16,786,1,0,21,279,33,-246,A
jinbu 2007.10.16,786,1,0,21,278,38,-240,B
whitelighter 2007.05.30,1020,1,0,18,130,39,-91,A
whitelighter 2007.05.30,1020,1,0,18,152,39,-113,B
mikihiir 2007.05.30,969,1,1,19,191,32,-159,A
mikihiir 2007.05.30,969,1,1,19,202,21,-181,B
ilikecomputer 2007.10.12,825,1,0,11,244,18,-226,A
ilikecomputer 2007.10.12,825,1,0,11,222,27,-195,B
ddurden 2007.10.12,1122,1,1,10,109,20,-89,A
ddurden 2007.10.12,1122,1,1,10,98,20,-78,B
buddhajuke 2007.10.05,895,1,0,10,231,40,-191,A
buddhajuke 2007.10.05,895,1,0,10,240,40,-200,B
tobys 2007.10.05,1104,1,1,9,48,44,-4,A
tobys 2007.10.05,1104,1,1,9,58,44,-14,B
Imiro 2007.06.17,925,1,1,24,103,58,-45,A
Imiro 2007.06.17,925,1,1,24,109,50,-59,B
Imiro 2007.06.17,925,1,1,24,102,50,-52,C
whitelighter 2007.06.17,977,1,0,24,168,37,-131,A
whitelighter 2007.06.17,977,1,0,24,158,25,-133,B
whitelighter 2007.06.17,977,1,0,24,163,21,-142,C
whitelighter 2007.06.14,994,2,0,67,107,37,-70,A
whitelighter 2007.06.14,994,2,0,67,104,36,-68,B
lordcyrix 2007.06.14,998,1,1,17,97,35,-62,A
lordcyrix 2007.06.14,998,1,1,17,78,35,-43,B
Depi 2007.10.14,971,2,2,20,126,30,-96,A
Depi 2007.10.14,971,2,2,20,125,25,-100,B
soucyj 2007.10.14,988,1,0,15,173,47,-126,A
soucyj 2007.10.14,988,1,0,15,174,40,-134,B
vetteboy 2007.10.12,949,1,1,42,451,17,-434,A
vetteboy 2007.10.12,949,1,1,42,480,14,-466,B
DINOCO 2007.10.12,864,1,0,29,274,17,-257,A
DINOCO 2007.10.12,864,1,0,29,288,21,-267,B
vitela 2007.09.28,907,1,1,13,201,31,-170,A
vitela 2007.09.28,907,1,1,13,195,31,-164,B
beasley 2007.09.28,1054,1,0,13,336,23,-313,A
beasley 2007.09.28,1054,1,0,13,348,23,-325,B
Boldrig 2007.06.09,984,1,1,12,134,33,-101,A
Boldrig 2007.06.09,984,1,1,12,137,33,-104,B
andoferni 2007.06.09,970,1,0,19,345,21,-324,A
andoferni 2007.06.09,970,1,0,19,288,21,-267,B
beasley 2007.10.15,1153,1,1,15,123,27,-96,A
beasley 2007.10.15,1153,1,1,15,112,40,-72,B
Exsation 2007.10.15,829,1,0,15,188,40,-148,A
Exsation 2007.10.15,829,1,0,15,194,33,-161,B
Tajibo 2007.10.04,1114,1,1,36,226,36,-190,A
Tajibo 2007.10.04,1114,1,1,36,217,39,-178,B
direworl 2007.10.04,846,1,0,36,241,33,-208,A
direworl 2007.10.04,846,1,0,36,260,33,-227,B
beasley 2007.10.08,1125,1,1,23,176,26,-150,A
beasley 2007.10.08,1125,1,1,23,166,22,-144,B
jinbu 2007.10.08,835,1,0,23,215,26,-189,A
jinbu 2007.10.08,835,1,0,23,205,26,-179,B
shahar 2007.09.08,1102,1,1,34,88,23,-65,A
shahar 2007.09.08,1102,1,1,34,104,29,-75,B
Caledonian 2007.09.08,848,1,0,34,113,47,-66,A
Caledonian 2007.09.08,848,1,0,34,108,44,-64,B
beasley 2007.09.06,967,1,1,13,328,31,-297,A
beasley 2007.09.06,967,1,1,13,273,15,-258,B
louiswei 2007.09.06,874,1,0,11,245,18,-227,A
louiswei 2007.09.06,874,1,0,11,220,18,-202,B
electronf 2007.06.14,991,1,1,50,101,42,-59,A
electronf 2007.06.14,991,1,1,50,105,40,-65,B
DuncanRDG 2007.10.04,970,1,0,54,175,37,-138,A
DuncanRDG 2007.10.04,970,1,0,54,171,43,-128,B
Kestreall 2007.10.04,1023,1,1,51,105,41,-64,A
Kestreall 2007.10.04,1023,1,1,51,111,43,-68,B
louiswei 2007.09.08,856,2,0,32,224,16,-208,A
louiswei 2007.09.08,856,2,0,32,224,22,-202,B
justhoff 2007.09.08,1000,1,1,23,128,39,-89,A
justhoff 2007.09.08,1000,1,1,23,124,35,-89,B
Malca 2007.06.16,1015,1,1,8,67,25,-42,A
Malca 2007.06.16,1015,1,1,8,111,25,-86,B
BurtForFun 2007.08.14,1049,2,2,18,198,22,-176,A
BurtForFun 2007.08.14,1049,2,2,18,200,17,-183,B
TonyLechner 2007.08.14,913,3,0,26,345,35,-310,A
TonyLechner 2007.08.14,913,3,0,26,311,35,-276,B
urodec 2007.04.30,985,1,1,11,172,9,-163,A
urodec 2007.04.30,985,1,1,11,163,9,-154,B
direworl 2007.04.30,889,1,0,10,100,20,-80,A
direworl 2007.04.30,889,1,0,10,88,30,-58,B
direworl 2007.04.28,896,1,0,11,131,18,-113,A
direworl 2007.04.28,896,1,0,11,134,18,-116,B
Artmachine 2007.04.28,1075,1,1,4,0,100,100,A
Artmachine 2007.04.28,1075,1,1,4,0,100,100,B
joethecoolestman 2007.10.14,814,1,0,5,366,0,-366,A
joethecoolestman 2007.10.14,814,1,0,5,340,0,-340,B
HZI 2007.10.01,976,1,1,7,121,29,-92,A
HZI 2007.10.01,976,1,1,7,104,43,-61,B
whitestarrnyc 2007.10.01,996,1,0,7,216,14,-202,A
whitestarrnyc 2007.10.01,996,1,0,7,255,14,-241,B
FrankyBaby 2007.06.02,1078,1,0.5,15,331,7,-324,A
FrankyBaby 2007.06.02,1078,1,0.5,15,330,0,-330,B
zhouzhou 2007.09.28,1017,1,0,12,417,8,-409,A
zhouzhou 2007.09.28,1017,1,0,12,442,17,-425,B
jmaeder 2007.09.28,976,1,1,9,169,33,-136,A
jmaeder 2007.09.28,976,1,1,9,182,33,-149,B
mjwadams 2007.05.28,1158,1,0,21,264,29,-235,A
mjwadams 2007.05.28,1158,1,0,21,264,33,-231,B
ComradeRoshchin 2007.05.28,780,2,2,26,160,27,-133,A
ComradeRoshchin 2007.05.28,780,2,2,26,153,27,-126,B
jinbu 2007.10.05,899,1,0,10,251,10,-241,A
jinbu 2007.10.05,899,1,0,10,253,0,-253,B
Tycew 2007.10.05,764,1,1,9,85,44,-41,A
Tycew 2007.10.05,764,1,1,9,90,44,-46,B
Seroth 2007.09.25,767,1,0,7,436,0,-436,A
Seroth 2007.09.25,767,1,0,7,413,0,-413,B
Syrik 2007.09.25,1115,1,1,5,155,20,-135,A
Syrik 2007.09.25,1115,1,1,5,173,40,-133,B
LzVandy 2007.06.01,985,1,1,8,153,50,-103,A
LzVandy 2007.06.01,985,1,1,8,139,50,-89,B
nunziocedi 2007.06.01,784,1,0,9,394,33,-361,A
nunziocedi 2007.06.01,784,1,0,9,406,33,-373,B
jokkman 2007.10.14,1172,1,1,6,80,50,-30,A
jokkman 2007.10.14,1172,1,1,6,75,50,-25,B
louiswei 2007.10.14,823,1,0,6,254,33,-221,A
louiswei 2007.10.14,823,1,0,6,256,33,-223,B
simonjs 2007.07.13,879,2,1.5,21,288,33,-255,A
simonjs 2007.07.13,879,2,1.5,21,297,29,-268,B
laksen 2007.07.13,894,2,0.5,20,349,15,-334,A
laksen 2007.07.13,894,2,0.5,20,347,15,-332,B
monergism 2007.05.28,1091,1,0,15,342,20,-322,A
monergism 2007.05.28,1091,1,0,15,270,27,-243,B
Kwela 2007.10.09,740,1,1,37,165,16,-149,A
Kwela 2007.10.09,740,1,1,37,169,24,-145,B
PhoenixRedOne 2007.10.09,1199,1,0,37,113,32,-81,A
PhoenixRedOne 2007.10.09,1199,1,0,37,110,32,-78,B
hysong 2007.09.29,918,1,0,14,284,14,-270,A
hysong 2007.09.29,918,1,0,14,261,21,-240,B
beasley 2007.09.29,1071,1,1,13,157,54,-103,A
beasley 2007.09.29,1071,1,1,13,174,38,-136,B
Tycew 2007.09.25,778,1,0,19,238,32,-206,A
Tycew 2007.09.25,778,1,0,19,239,10,-229,B
jinbu 2007.09.25,1096,1,1,20,316,25,-291,A
jinbu 2007.09.25,1096,1,1,20,296,25,-271,B
louiswei 2007.10.12,833,1,0,14,288,21,-267,A
louiswei 2007.10.12,833,1,0,14,299,29,-270,B
jamesthesecond 2007.10.12,1160,1,1,11,175,18,-157,A
jamesthesecond 2007.10.12,1160,1,1,11,153,27,-126,B
yangyang 2007.09.23,960,1,0,27,244,22,-222,A
yangyang 2007.09.23,960,1,0,27,247,22,-225,B
zhouzhou 2007.09.23,971,1,1,25,169,24,-145,A
zhouzhou 2007.09.23,971,1,1,25,176,24,-152,B
thess 2007.10.04,869,1,1,31,249,42,-207,A
thess 2007.10.04,869,1,1,31,194,42,-152,B
jokersplay 2007.10.04,971,1,0,37,289,35,-254,A
jokersplay 2007.10.04,971,1,0,37,316,32,-284,B
louiswei 2007.09.02,899,2,0,28,255,18,-237,A
louiswei 2007.09.02,899,2,0,28,268,18,-250,B
fishel 2007.09.02,1000,1,1,16,117,19,-98,A
fishel 2007.09.02,1000,1,1,16,114,19,-95,B
kreshoo 2007.09.28,1104,1,0,7,231,14,-217,A
kreshoo 2007.09.28,1104,1,0,7,288,14,-274,B
BjornGrimskull 2007.09.28,887,1,1,2,283,50,-233,A
BjornGrimskull 2007.09.28,887,1,1,2,206,0,-206,B
Ephphatha 2007.08.14,1022,1,1,6,198,33,-165,A
Ephphatha 2007.08.14,1022,1,1,6,208,33,-175,B
greenqueenbrasil 2007.04.24,825,1,0,14,286,7,-279,A
greenqueenbrasil 2007.04.24,825,1,0,14,289,7,-282,B
thepirate 2007.04.24,1173,1,1,11,147,36,-111,A
thepirate 2007.04.24,1173,1,1,11,148,18,-130,B
Ephphatha 2007.08.28,977,3,2,40,197,30,-167,A
Ephphatha 2007.08.28,977,3,2,40,174,28,-146,B
LopezLaTorre 2007.08.28,982,3,1,42,273,26,-247,A
LopezLaTorre 2007.08.28,982,3,1,42,263,26,-237,B
louiswei 2007.09.09,840,1,0,23,246,13,-233,A
louiswei 2007.09.09,840,1,0,23,265,13,-252,B
LopezLaTorre 2007.09.09,942,1,1,27,369,19,-350,A
LopezLaTorre 2007.09.09,942,1,1,27,372,18,-354,B
nightway 2007.09.25,1046,1,1,28,82,50,-32,A
nightway 2007.09.25,1046,1,1,28,89,46,-43,B
nightway 2007.09.25,1046,1,1,28,90,36,-54,C
NiceEvent 2007.09.25,947,1,0,28,124,50,-74,A
NiceEvent 2007.09.25,947,1,0,28,128,50,-78,B
NiceEvent 2007.09.25,947,1,0,28,131,46,-85,C
Youngturks 2007.08.08,835,1,0,16,181,50,-131,A
Youngturks 2007.08.08,835,1,0,16,186,50,-136,B
arrarat 2007.08.08,1152,1,1,9,82,44,-38,A
arrarat 2007.08.08,1152,1,1,9,103,56,-47,B
MSmarques 2007.07.30,1048,1,1,11,128,27,-101,A
MSmarques 2007.07.30,1048,1,1,11,128,27,-101,B
soucyj 2007.09.19,968,1,1,24,209,33,-176,A
soucyj 2007.09.19,968,1,1,24,205,33,-172,B
jmaeder 2007.09.19,1003,1,0,30,419,40,-379,A
jmaeder 2007.09.19,1003,1,0,30,381,33,-348,B
louiswei 2007.09.15,844,1,0.5,10,468,10,-458,A
louiswei 2007.09.15,844,1,0.5,10,472,10,-462,B
peihan 2007.09.15,1108,1,0.5,10,457,10,-447,A
peihan 2007.09.15,1108,1,0.5,10,452,20,-432,B
Codees 2007.09.22,939,1,0,8,357,25,-332,A
Codees 2007.09.22,939,1,0,8,264,25,-239,B
KyleYoung 2007.09.22,1048,1,1,7,131,43,-88,A
KyleYoung 2007.09.22,1048,1,1,7,133,43,-90,B
Tycew 2007.09.21,702,1,1,9,58,44,-14,A
Tycew 2007.09.21,702,1,1,9,63,44,-19,B
jmaeder 2007.09.21,964,1,0,9,203,33,-170,A
jmaeder 2007.09.21,964,1,0,9,206,33,-173,B
direworl 2007.08.26,865,1,0,5,322,40,-282,A
direworl 2007.08.26,865,1,0,5,311,40,-271,B
ChessWizzard 2007.08.26,958,1,1,4,184,0,-184,A
ChessWizzard 2007.08.26,958,1,1,4,174,0,-174,B
greatwhitepine 2007.09.09,960,2,2,52,78,48,-30,A
greatwhitepine 2007.09.09,960,2,2,52,81,44,-37,B
soucyj 2007.09.09,980,1,0,33,199,39,-160,A
soucyj 2007.09.09,980,1,0,33,210,36,-174,B
sirishb 2007.09.08,957,1,1,4,157,25,-132,A
sirishb 2007.09.08,957,1,1,4,132,50,-82,B
hysong 2007.09.18,909,1,0,12,260,0,-260,A
hysong 2007.09.18,909,1,0,12,267,8,-259,B
themathwhiz 2007.09.18,1083,1,1,7,82,43,-39,A
themathwhiz 2007.09.18,1083,1,1,7,83,43,-40,B
WesleySimmons 2007.09.09,1045,1,1,32,219,28,-191,A
WesleySimmons 2007.09.09,1045,1,1,32,241,28,-213,B
sirishb 2007.09.09,951,1,0,27,242,37,-205,A
sirishb 2007.09.09,951,1,0,27,221,41,-180,B
laksen 2007.07.28,850,1,1,19,391,16,-375,A
laksen 2007.07.28,850,1,1,19,419,16,-403,B
vetteboy 2007.07.28,912,1,0,21,539,14,-525,A
vetteboy 2007.07.28,912,1,0,21,520,10,-510,B
jmaeder 2007.08.29,1104,1,1,3,177,67,-110,A
jmaeder 2007.08.29,1104,1,1,3,136,67,-69,B
TonyLechner 2007.08.29,878,1,0,8,448,12,-436,A
TonyLechner 2007.08.29,878,1,0,8,422,12,-410,B
mrschultz 2007.05.06,878,1,0,9,113,44,-69,A
mrschultz 2007.05.06,878,1,0,9,128,44,-84,B
greenqueenbrasil 2007.05.06,930,1,1,7,0,86,86,A
greenqueenbrasil 2007.05.06,930,1,1,7,0,100,100,B
aadeeb 2007.07.19,775,1,0,8,239,38,-201,A
aadeeb 2007.07.19,775,1,0,8,233,25,-208,B
pastime 2007.07.19,1210,1,1,7,198,14,-184,A
pastime 2007.07.19,1210,1,1,7,166,14,-152,B
justhoff 2007.09.09,1010,1,0,23,127,35,-92,A
justhoff 2007.09.09,1010,1,0,23,90,30,-60,B
cjmaeder 2007.08.24,768,1,0,24,353,17,-336,A
cjmaeder 2007.08.24,768,1,0,24,354,12,-342,B
BurtForFun 2007.08.24,1024,1,1,19,248,21,-227,A
BurtForFun 2007.08.24,1024,1,1,19,240,21,-219,B
panchivilla 2007.07.27,873,1,1,14,42,57,15,A
panchivilla 2007.07.27,873,1,1,14,38,71,33,B
RIQUELME 2007.07.27,1080,1,0,17,125,41,-84,A
RIQUELME 2007.07.27,1080,1,0,17,135,29,-106,B
SuperMicroNanoMan 2007.08.18,903,1,0.5,8,249,25,-224,A
SuperMicroNanoMan 2007.08.18,903,1,0.5,8,189,25,-164,B
CaptainWeirdo 2007.08.18,915,1,0.5,7,104,29,-75,A
CaptainWeirdo 2007.08.18,915,1,0.5,7,100,29,-71,B
SneekyJones 2007.09.02,1066,1,1,2,0,50,50,A
SneekyJones 2007.09.02,1066,1,1,2,0,50,50,B
TonyLechner 2007.08.21,761,1,1,21,141,43,-98,A
TonyLechner 2007.08.21,761,1,1,21,150,43,-107,B
soucyj 2007.08.21,1124,1,0,22,230,32,-198,A
soucyj 2007.08.21,1124,1,0,22,227,23,-204,B
herculus 2007.08.20,1157,1,1,17,208,35,-173,A
herculus 2007.08.20,1157,1,1,17,220,35,-185,B
TonyLechner 2007.08.20,775,1,0,20,348,30,-318,A
TonyLechner 2007.08.20,775,1,0,20,366,30,-336,B
SuperMicroNanoMan 2007.08.20,970,1,0,7,437,14,-423,A
SuperMicroNanoMan 2007.08.20,970,1,0,7,413,29,-384,B
CaptainWeirdo 2007.08.20,834,1,1,5,187,40,-147,A
CaptainWeirdo 2007.08.20,834,1,1,5,172,60,-112,B
whitelighter 2007.05.26,925,1,1,8,133,12,-121,A
whitelighter 2007.05.26,925,1,1,8,149,12,-137,B
nunziocedi 2007.05.26,806,1,0,8,242,25,-217,A
nunziocedi 2007.05.26,806,1,0,8,248,25,-223,B
juanjogallardo 2007.08.26,913,1,1,12,72,42,-30,A
juanjogallardo 2007.08.26,913,1,1,12,82,42,-40,B
LopezLaTorre 2007.08.26,1017,1,0,14,263,14,-249,A
LopezLaTorre 2007.08.26,1017,1,0,14,300,14,-286,B
BurtForFun 2007.08.19,1037,1,1,17,140,29,-111,A
BurtForFun 2007.08.19,1037,1,1,17,162,24,-138,B
cjmaeder 2007.08.19,807,1,0,18,202,11,-191,A
cjmaeder 2007.08.19,807,1,0,18,218,17,-201,B
guilut 2007.08.09,1085,2,2,30,154,27,-127,A
guilut 2007.08.09,1085,2,2,30,147,27,-120,B
LitovecBlind 2007.08.09,901,1,0,15,184,33,-151,A
LitovecBlind 2007.08.09,901,1,0,15,193,33,-160,B
laksen 2007.07.16,854,3,2,40,218,30,-188,A
laksen 2007.07.16,854,3,2,40,202,27,-175,B
Pandu 2007.07.16,1086,1,1,14,67,43,-24,A
Pandu 2007.07.16,1086,1,1,14,48,43,-5,B
SuperMicroNanoMan 2007.08.22,938,1,0.5,18,439,28,-411,A
SuperMicroNanoMan 2007.08.22,938,1,0.5,18,287,28,-259,B
CaptainWeirdo 2007.08.22,935,1,0.5,10,259,40,-219,A
CaptainWeirdo 2007.08.22,935,1,0.5,10,260,30,-230,B
AntidOto 2007.08.19,766,1,0,12,171,58,-113,A
AntidOto 2007.08.19,766,1,0,12,160,33,-127,B
RIQUELME 2007.08.19,1169,1,1,24,379,46,-333,A
RIQUELME 2007.08.19,1169,1,1,24,341,42,-299,B
TWINSXZ 2007.08.09,903,1,0,17,191,29,-162,A
TWINSXZ 2007.08.09,903,1,0,17,192,29,-163,B
Saldeeznuts 2007.07.22,980,1,0,6,412,17,-395,A
Saldeeznuts 2007.07.22,980,1,0,6,374,17,-357,B
nedy 2007.07.22,1016,1,1,2,74,100,26,A
nedy 2007.07.22,1016,1,1,2,0,100,100,B
Halfman 2007.07.30,1061,1,0,11,187,46,-141,A
Halfman 2007.07.30,1061,1,0,11,174,46,-128,B
RIQUELME 2007.07.30,934,1,1,10,71,60,-11,A
RIQUELME 2007.07.30,934,1,1,10,76,40,-36,B
GatorWarrior 2007.05.19,1029,1,0.5,68,91,35,-56,A
GatorWarrior 2007.05.19,1029,1,0.5,68,91,37,-54,B
fewral 2007.05.19,963,1,0.5,69,80,41,-39,A
fewral 2007.05.19,963,1,0.5,69,79,41,-38,B
BurtForFun 2007.07.16,1004,1,0,17,310,24,-286,A
BurtForFun 2007.07.16,1004,1,0,17,285,29,-256,B
cecilieh 2007.07.30,1080,1,1,19,168,32,-136,A
cecilieh 2007.07.30,1080,1,1,19,167,32,-135,B
phillymaintman 2007.08.18,1139,1,1,13,166,23,-143,A
phillymaintman 2007.08.18,1139,1,1,13,156,31,-125,B
TonyLechner 2007.08.18,786,1,0,13,142,15,-127,A
TonyLechner 2007.08.18,786,1,0,13,119,31,-88,B
lousychess 2007.08.05,1091,1,1,5,279,20,-259,A
lousychess 2007.08.05,1091,1,1,5,279,20,-259,B
MrBoris 2007.05.25,946,1,1,13,133,46,-87,A
MrBoris 2007.05.25,946,1,1,13,130,54,-76,B
HomogenousMass 2007.05.25,986,1,0,12,206,8,-198,A
HomogenousMass 2007.05.25,986,1,0,12,202,8,-194,B
Kirktcb 2007.05.01,842,1,0.5,15,252,20,-232,A
Kirktcb 2007.05.01,842,1,0.5,15,254,13,-241,B
Oldskewlphool 2007.05.01,1156,1,0.5,13,152,31,-121,A
Oldskewlphool 2007.05.01,1156,1,0.5,13,141,23,-118,B
SuperMicroNanoMan 2007.08.09,907,1,0.5,8,318,25,-293,A
SuperMicroNanoMan 2007.08.09,907,1,0.5,8,314,25,-289,B
CaptainWeirdo 2007.08.09,1038,1,0.5,6,89,17,-72,A
CaptainWeirdo 2007.08.09,1038,1,0.5,6,92,17,-75,B
vetteboy 2007.08.15,912,1,1,22,201,27,-174,A
vetteboy 2007.08.15,912,1,1,22,223,27,-196,B
Ephphatha 2007.08.15,1030,1,0,25,337,20,-317,A
Ephphatha 2007.08.15,1030,1,0,25,341,28,-313,B
hotwheela 2007.04.25,1182,1,1,13,50,31,-19,A
hotwheela 2007.04.25,1182,1,1,13,42,38,-4,B
greenqueenbrasil 2007.04.25,817,4,0,63,201,19,-182,A
greenqueenbrasil 2007.04.25,817,4,0,63,197,19,-178,B
aliceg 2007.08.03,915,1,0,11,171,9,-162,A
aliceg 2007.08.03,915,1,0,11,149,9,-140,B
CausalClosure 2007.08.03,999,1,1,9,53,22,-31,A
CausalClosure 2007.08.03,999,1,1,9,65,33,-32,B
infernonk 2007.05.24,990,1,1,21,254,29,-225,A
infernonk 2007.05.24,990,1,1,21,251,19,-232,B
ComradeRoshchin 2007.05.24,820,1,0,19,206,32,-174,A
ComradeRoshchin 2007.05.24,820,1,0,19,210,32,-178,B
Asdrulbo 2007.05.23,860,2,1,21,304,33,-271,A
Asdrulbo 2007.05.23,860,2,1,21,326,19,-307,B
nunziocedi 2007.05.23,812,2,1,20,243,35,-208,A
nunziocedi 2007.05.23,812,2,1,20,229,25,-204,B
HEARTLESSWIZARD 2007.07.28,956,2,0,27,259,26,-233,A
HEARTLESSWIZARD 2007.07.28,956,2,0,27,226,19,-207,B
HEARTLESSWIZARD 2007.07.28,956,2,0,27,236,15,-221,C
BurtForFun 2007.07.28,989,2,2,25,82,56,-26,A
BurtForFun 2007.07.28,989,2,2,25,85,64,-21,B
BurtForFun 2007.07.28,989,2,2,25,96,56,-40,C
Malca 2007.05.22,1038,1,1,20,104,35,-69,A
Malca 2007.05.22,1038,1,1,20,94,35,-59,B
nunziocedi 2007.05.22,854,1,0,21,173,33,-140,A
nunziocedi 2007.05.22,854,1,0,21,166,33,-133,B
WilliamJ 2007.07.29,865,1,1,17,138,29,-109,A
WilliamJ 2007.07.29,865,1,1,17,154,29,-125,B
nedy 2007.07.29,1012,1,0,17,191,29,-162,A
nedy 2007.07.29,1012,1,0,17,196,24,-172,B
nedy 2007.07.19,983,1,1,13,228,15,-213,A
nedy 2007.07.19,983,1,1,13,279,31,-248,B
jamesobrien 2007.07.19,1002,1,0,15,425,13,-412,A
jamesobrien 2007.07.19,1002,1,0,15,430,33,-397,B
Linckar 2007.05.14,1002,1,1,14,326,29,-297,A
Linckar 2007.05.14,1002,1,1,14,296,29,-267,B
suppechasper 2007.05.14,972,1,0,11,264,27,-237,A
suppechasper 2007.05.14,972,1,0,11,229,27,-202,B
bandwagon 2007.04.25,1182,1,1,4,127,50,-77,A
bandwagon 2007.04.25,1182,1,1,4,120,50,-70,B
scarsetto 2007.07.14,1062,1,1,10,190,20,-170,A
scarsetto 2007.07.14,1062,1,1,10,214,20,-194,B
andoferni 2007.07.14,933,2,1,36,177,44,-133,A
andoferni 2007.07.14,933,2,1,36,181,36,-145,B
BourbaKiND 2007.04.30,960,1,1,12,340,8,-332,A
BourbaKiND 2007.04.30,960,1,1,12,320,0,-320,B
paulfallet 2007.04.30,967,1,0,9,126,33,-93,A
paulfallet 2007.04.30,967,1,0,9,87,44,-43,B
GatorWarrior 2007.07.23,1115,1,1,4,106,0,-106,A
GatorWarrior 2007.07.23,1115,1,1,4,102,0,-102,B
cjmaeder 2007.07.23,848,1,0,6,490,0,-490,A
cjmaeder 2007.07.23,848,1,0,6,486,0,-486,B
GatorWarrior 2007.05.06,996,1,1,33,197,27,-170,A
GatorWarrior 2007.05.06,996,1,1,33,205,15,-190,B
vetteboy 2007.05.06,932,1,0,32,176,41,-135,A
vetteboy 2007.05.06,932,1,0,32,158,34,-124,B
JohntheChristian 2007.04.19,990,1,0,17,174,18,-156,A
JohntheChristian 2007.04.19,990,1,0,17,165,18,-147,B
paulfallet 2007.04.19,984,1,1,14,104,36,-68,A
paulfallet 2007.04.19,984,1,1,14,94,29,-65,B
Linckar 2007.05.09,1036,1,0,32,120,47,-73,A
Linckar 2007.05.09,1036,1,0,32,122,38,-84,B
Linckar 2007.05.09,1036,1,0,32,97,31,-66,C
greenqueenbrasil 2007.05.09,937,1,1,30,44,67,23,A
greenqueenbrasil 2007.05.09,937,1,1,30,43,63,20,B
greenqueenbrasil 2007.05.09,937,1,1,30,32,67,35,C
Jia 2007.05.20,999,1,1,33,160,39,-121,A
Jia 2007.05.20,999,1,1,33,168,39,-129,B
ChuckieChex 2007.05.20,982,1,0,36,214,39,-175,A
ChuckieChex 2007.05.20,982,1,0,36,204,42,-162,B
greenqueenbrasil 2007.05.05,903,1,1,7,9,86,77,A
greenqueenbrasil 2007.05.05,903,1,1,7,19,71,52,B
BourbaKiND 2007.05.05,1022,1,0,6,186,33,-153,A
BourbaKiND 2007.05.05,1022,1,0,6,168,17,-151,B
lordcyrix 2007.05.17,967,1,0,10,102,40,-62,A
lordcyrix 2007.05.17,967,1,0,10,94,40,-54,B
KevinusMaximus 2007.05.17,958,1,1,16,359,6,-353,A
KevinusMaximus 2007.05.17,958,1,1,16,352,19,-333,B
paulfallet 2007.04.25,967,1,0,10,334,10,-324,A
paulfallet 2007.04.25,967,1,0,10,330,10,-320,B
shawny 2007.04.25,959,1,1,8,145,25,-120,A
shawny 2007.04.25,959,1,1,8,147,25,-122,B
YINGYING 2007.07.06,938,1,0,9,250,11,-239,A
YINGYING 2007.07.06,938,1,0,9,261,11,-250,B
BurtForFun 2007.07.06,1055,1,1,6,56,33,-23,A
BurtForFun 2007.07.06,1055,1,1,6,50,33,-17,B
NickVee 2007.04.21,868,1,1,25,271,28,-243,A
NickVee 2007.04.21,868,1,1,25,266,28,-238,B
telis 2007.04.21,1079,1,0,23,247,48,-199,A
telis 2007.04.21,1079,1,0,23,243,44,-199,B
andoferni 2007.05.16,845,1,0,16,143,38,-105,A
andoferni 2007.05.16,845,1,0,16,153,38,-115,B
shouou 2007.05.16,1045,1,1,16,84,38,-46,A
shouou 2007.05.16,1045,1,1,16,92,38,-54,B
SixteenCorners 2007.04.29,1115,1,0,13,152,54,-98,A
SixteenCorners 2007.04.29,1115,1,0,13,194,38,-156,B
divcat 2007.04.29,875,1,1,12,48,50,2,A
divcat 2007.04.29,875,1,1,12,23,75,52,B
KevinusMaximus 2007.05.03,1051,1,1,18,236,33,-203,A
KevinusMaximus 2007.05.03,1051,1,1,18,240,39,-201,B
Kirktcb 2007.05.03,853,1,0,17,207,18,-189,A
Kirktcb 2007.05.03,853,1,0,17,232,12,-220,B
direworl 2007.05.04,881,1,0,15,270,40,-230,A
direworl 2007.05.04,881,1,0,15,260,40,-220,B
ZenDarb 2007.05.04,1113,1,1,12,128,58,-70,A
ZenDarb 2007.05.04,1113,1,1,12,93,58,-35,B
KawaiiOSakura 2007.07.16,1009,1,0,7,360,0,-360,A
KawaiiOSakura 2007.07.16,1009,1,0,7,385,0,-385,B
louiswei 2007.07.16,929,1,1,5,150,20,-130,A
louiswei 2007.07.16,929,1,1,5,168,20,-148,B
wyldeemgz 2007.04.23,990,1,1,12,224,17,-207,A
wyldeemgz 2007.04.23,990,1,1,12,215,25,-190,B
direworl 2007.04.23,900,2,0.5,57,211,30,-181,A
direworl 2007.04.23,900,2,0.5,57,195,26,-169,B
BOXERFOREVR 2007.04.19,1199,1,1,8,40,50,10,A
BOXERFOREVR 2007.04.19,1199,1,1,8,33,50,17,B
xWildBillx 2007.04.19,790,2,0.5,32,142,28,-114,A
xWildBillx 2007.04.19,790,2,0.5,32,154,25,-129,B
Anja 2007.04.28,978,2,1,37,235,30,-205,A
Anja 2007.04.28,978,2,1,37,243,27,-216,B
Keiju 2007.04.28,946,2,1,35,174,34,-140,A
Keiju 2007.04.28,946,2,1,35,181,31,-150,B
Carmeliaz 2007.07.15,904,1,1,5,115,40,-75,A
Carmeliaz 2007.07.15,904,1,1,5,111,40,-71,B
andoferni 2007.07.15,931,1,0,6,384,0,-384,A
andoferni 2007.07.15,931,1,0,6,340,17,-323,B
xWildBillx 2007.04.04,788,3,0,32,259,28,-231,A
xWildBillx 2007.04.04,788,3,0,32,250,25,-225,B
SirEndipity 2007.04.04,1096,2,2,20,153,30,-123,A
SirEndipity 2007.04.04,1096,2,2,20,175,30,-145,B
divcat 2007.04.03,1069,1,0,15,186,20,-166,A
divcat 2007.04.03,1069,1,0,15,182,27,-155,B
xWildBillx 2007.04.03,773,1,1,11,122,18,-104,A
xWildBillx 2007.04.03,773,1,1,11,118,27,-91,B
Biggnick 2007.04.30,1031,1,1,23,426,13,-413,A
Biggnick 2007.04.30,1031,1,1,23,454,13,-441,B
meenamoh 2007.04.30,942,1,0,20,320,30,-290,A
meenamoh 2007.04.30,942,1,0,20,274,25,-249,B
greenqueenbrasil 2007.04.23,816,4,0,50,224,24,-200,A
greenqueenbrasil 2007.04.23,816,4,0,50,226,22,-204,B
alexserrano 2007.04.23,1181,2,2,9,106,44,-62,A
alexserrano 2007.04.23,1181,2,2,9,88,44,-44,B
greenqueenbrasil 2007.04.21,850,1,0,19,262,37,-225,A
greenqueenbrasil 2007.04.21,850,1,0,19,255,37,-218,B
tetrapharmakon 2007.04.21,893,1,1,16,122,50,-72,A
tetrapharmakon 2007.04.21,893,1,1,16,122,56,-66,B
paloloco 2007.04.29,1084,1,1,13,153,46,-107,A
paloloco 2007.04.29,1084,1,1,13,149,54,-95,B
greenqueenbrasil 2007.04.29,808,1,0,13,242,38,-204,A
greenqueenbrasil 2007.04.29,808,1,0,13,240,38,-202,B
SixteenCorners 2007.04.25,1108,1,1,17,130,18,-112,A
SixteenCorners 2007.04.25,1108,1,1,17,126,29,-97,B
paulfallet 2007.05.01,954,1,0,16,520,0,-520,A
paulfallet 2007.05.01,954,1,0,16,596,0,-596,B
bigrustynail 2007.05.01,1015,1,1,3,102,0,-102,A
bigrustynail 2007.05.01,1015,1,1,3,56,0,-56,B
Jia 2007.04.26,975,1,0,8,340,25,-315,A
Jia 2007.04.26,975,1,0,8,338,12,-326,B
ShawnStanley 2007.04.26,1001,1,1,6,134,50,-84,A
ShawnStanley 2007.04.26,1001,1,1,6,108,50,-58,B
GatorWarrior 2007.04.25,1079,1,1,11,47,36,-11,A
GatorWarrior 2007.04.25,1079,1,1,11,45,27,-18,B
xWildBillx 2007.04.25,800,1,0,14,210,21,-189,A
xWildBillx 2007.04.25,800,1,0,14,217,14,-203,B
Biggnick 2007.04.25,1031,1,1,24,202,25,-177,A
Biggnick 2007.04.25,1031,1,1,24,234,17,-217,B
greenqueenbrasil 2007.04.20,881,1,0,12,212,17,-195,A
greenqueenbrasil 2007.04.20,881,1,0,12,224,17,-207,B
Malca 2007.04.20,1086,1,1,11,66,27,-39,A
Malca 2007.04.20,1086,1,1,11,89,27,-62,B
Woosky 2007.07.18,1003,1,0,20,346,20,-326,A
Woosky 2007.07.18,1003,1,0,20,358,20,-338,B
jamesobrien 2007.07.18,930,1,1,14,271,50,-221,A
jamesobrien 2007.07.18,930,1,1,14,247,43,-204,B
louiswei 2007.07.11,991,1,0,5,247,20,-227,A
louiswei 2007.07.11,991,1,0,5,242,20,-222,B
whitelighter 2007.07.11,1004,1,1,4,17,75,58,A
whitelighter 2007.07.11,1004,1,1,4,22,75,53,B
Saldeeznuts 2007.04.15,982,1,0,11,180,27,-153,A
Saldeeznuts 2007.04.15,982,1,0,11,160,27,-133,B
Eladar 2007.04.15,1008,1,1,9,47,44,-3,A
Eladar 2007.04.15,1008,1,1,9,50,44,-6,B
lprcahn 2007.03.23,1057,2,2,26,257,19,-238,A
lprcahn 2007.03.23,1057,2,2,26,229,23,-206,B
xWildBillx 2007.03.23,896,2,0,31,339,19,-320,A
xWildBillx 2007.03.23,896,2,0,31,339,23,-316,B
HogODeath 2007.04.23,1047,1,1,5,170,0,-170,A
HogODeath 2007.04.23,1047,1,1,5,176,0,-176,B
Zevix 2007.04.23,955,1,0.5,49,163,41,-122,A
Zevix 2007.04.23,955,1,0.5,49,173,37,-136,B
cameronbra 2007.07.14,1006,1,0,34,190,29,-161,A
cameronbra 2007.07.14,1006,1,0,34,187,21,-166,B
nedy 2007.07.14,989,1,1,28,98,29,-69,A
nedy 2007.07.14,989,1,1,28,104,25,-79,B
WillemS 2007.04.10,1029,1,1,4,45,50,5,A
WillemS 2007.04.10,1029,1,1,4,40,50,10,B
titusm 2007.04.10,826,1,0,4,268,25,-243,A
titusm 2007.04.10,826,1,0,4,270,25,-245,B
zafercaymaz 2007.04.10,897,1,1,5,91,20,-71,A
zafercaymaz 2007.04.10,897,1,1,5,79,0,-79,B
meenamoh 2007.04.10,985,1,0,5,313,20,-293,A
meenamoh 2007.04.10,985,1,0,5,287,20,-267,B
Kirktcb 2007.04.10,882,1,0,25,178,32,-146,A
Kirktcb 2007.04.10,882,1,0,25,180,32,-148,B
tereliza 2007.04.10,1115,1,1,19,40,47,7,A
tereliza 2007.04.10,1115,1,1,19,48,47,-1,B
overloadcro 2007.03.27,853,2,1,55,233,31,-202,A
overloadcro 2007.03.27,853,2,1,55,211,29,-182,B
LUKAchess 2007.03.27,1182,1,0,17,305,29,-276,A
LUKAchess 2007.03.27,1182,1,0,17,252,29,-223,B
ThomasPace 2007.03.31,1068,1,1,12,131,17,-114,A
ThomasPace 2007.03.31,1068,1,1,12,94,17,-77,B
Kirktcb 2007.03.31,914,1,0,12,184,33,-151,A
Kirktcb 2007.03.31,914,1,0,12,157,42,-115,B
GatorWarrior 2007.04.23,1092,1,1,33,173,12,-161,A
GatorWarrior 2007.04.23,1092,1,1,33,167,12,-155,B
whitelighter 2007.07.08,967,1,0,12,439,25,-414,A
whitelighter 2007.07.08,967,1,0,12,422,25,-397,B
francod 2007.07.08,976,1,1,12,343,17,-326,A
francod 2007.07.08,976,1,1,12,330,17,-313,B
ComradeRoshchin 2007.03.16,850,3,1,27,183,19,-164,A
ComradeRoshchin 2007.03.16,850,3,1,27,182,26,-156,B
HomogenousMass 2007.03.16,967,3,2,22,154,32,-122,A
HomogenousMass 2007.03.16,967,3,2,22,149,36,-113,B
aleksthegreat 2007.02.12,895,2,0,34,205,26,-179,A
aleksthegreat 2007.02.12,895,2,0,34,209,24,-185,B
chesscoolman 2007.02.12,1025,2,2,29,136,34,-102,A
chesscoolman 2007.02.12,1025,2,2,29,126,34,-92,B
LithFlash 2007.04.25,1080,1,1,10,96,40,-56,A
LithFlash 2007.04.25,1080,1,1,10,122,30,-92,B
direworl 2007.04.25,892,1,0,11,257,9,-248,A
direworl 2007.04.25,892,1,0,11,273,9,-264,B
Gregarious 2007.07.18,1095,1,1,13,288,8,-280,A
Gregarious 2007.07.18,1095,1,1,13,281,8,-273,B
laksen 2007.07.18,873,1,0,14,388,14,-374,A
laksen 2007.07.18,873,1,0,14,402,14,-388,B
Aydo 2007.07.15,1108,1,1,12,186,42,-144,A
Aydo 2007.07.15,1108,1,1,12,201,50,-151,B
laksen 2007.07.15,863,1,0,12,366,25,-341,A
laksen 2007.07.15,863,1,0,12,366,25,-341,B
Ketzalos 2007.04.17,1079,1,0,9,342,11,-331,A
Ketzalos 2007.04.17,1079,1,0,9,329,11,-318,B
Marcellov 2007.04.17,846,1,1,7,139,29,-110,A
Marcellov 2007.04.17,846,1,1,7,124,29,-95,B
herrahuu 2007.03.28,853,1,0,22,158,50,-108,A
herrahuu 2007.03.28,853,1,0,22,149,46,-103,B
SirEndipity 2007.03.28,1112,1,1,25,179,32,-147,A
SirEndipity 2007.03.28,1112,1,1,25,228,36,-192,B
ellieuk 2007.03.02,1003,1,1,19,193,53,-140,A
ellieuk 2007.03.02,1003,1,1,19,158,47,-111,B
neog 2007.03.02,971,1,0,20,227,40,-187,A
neog 2007.03.02,971,1,0,20,208,35,-173,B
mpaon 2007.02.01,825,2,1,49,187,33,-154,A
mpaon 2007.02.01,825,2,1,49,181,33,-148,B
GoSyracuse 2007.02.01,1134,1,1,19,75,47,-28,A
GoSyracuse 2007.02.01,1134,1,1,19,70,58,-12,B
alamaak 2007.07.16,1107,1,0,12,473,8,-465,A
alamaak 2007.07.16,1107,1,0,12,435,8,-427,B
Woosky 2007.07.14,1003,1,0,32,237,34,-203,A
Woosky 2007.07.14,1003,1,0,32,198,41,-157,B
GatorWarrior 2007.07.14,1091,1,1,14,391,29,-362,A
GatorWarrior 2007.07.14,1091,1,1,14,383,21,-362,B
mcmurray 2007.07.14,829,1,0,11,130,27,-103,A
mcmurray 2007.07.14,829,1,0,11,253,27,-226,B
ALFREDII 2007.04.15,989,1,1,13,243,15,-228,A
ALFREDII 2007.04.15,989,1,1,13,228,8,-220,B
direworl 2007.04.15,939,1,0,13,283,8,-275,A
direworl 2007.04.15,939,1,0,13,329,8,-321,B
direworl 2007.04.01,1070,1,1,24,313,33,-280,A
direworl 2007.04.01,1070,1,1,24,311,25,-286,B
Kirktcb 2007.04.01,875,1,0,21,319,29,-290,A
Kirktcb 2007.04.01,875,1,0,21,273,29,-244,B
wyldeemgz 2007.04.22,950,1,1,3,91,0,-91,A
wyldeemgz 2007.04.22,950,1,1,3,82,0,-82,B
greenbeandipper 2007.04.22,981,1,0,5,269,20,-249,A
greenbeandipper 2007.04.22,981,1,0,5,375,20,-355,B
paulfallet 2007.03.24,973,1,0,14,140,21,-119,A
paulfallet 2007.03.24,973,1,0,14,144,21,-123,B
zzzsah 2007.03.24,1011,1,1,14,119,21,-98,A
zzzsah 2007.03.24,1011,1,1,14,118,21,-97,B
mpaon 2007.01.31,850,1,0,10,288,30,-258,A
mpaon 2007.01.31,850,1,0,10,260,20,-240,B
mbafreng 2007.01.31,1141,1,1,6,75,50,-25,A
mbafreng 2007.01.31,1141,1,1,6,49,50,1,B
Kongfuchess 2007.07.13,1058,2,1,29,315,34,-281,A
Kongfuchess 2007.07.13,1058,2,1,29,308,34,-274,B
andoferni 2007.07.13,919,2,1,25,247,32,-215,A
andoferni 2007.07.13,919,2,1,25,235,32,-203,B
YINGYING 2007.07.10,919,1,0,9,304,11,-293,A
YINGYING 2007.07.10,919,1,0,9,274,11,-263,B
NicolaTesla 2007.07.10,1006,1,1,5,14,80,66,A
NicolaTesla 2007.07.10,1006,1,1,5,18,80,62,B
FlyingFig 2007.07.07,1030,1,0,13,272,31,-241,A
FlyingFig 2007.07.07,1030,1,0,13,286,31,-255,B
andoferni 2007.07.07,916,1,1,12,348,0,-348,A
andoferni 2007.07.07,916,1,1,12,367,0,-367,B
Woosky 2007.07.09,987,1,1,10,140,20,-120,A
Woosky 2007.07.09,987,1,1,10,102,20,-82,B
Muffro 2007.07.09,954,1,0,10,175,30,-145,A
Muffro 2007.07.09,954,1,0,10,172,30,-142,B
ShawnStanley 2007.04.20,1038,1,1,11,188,36,-152,A
ShawnStanley 2007.04.20,1038,1,1,11,190,36,-154,B
Kirktcb 2007.04.20,869,1,0,11,272,27,-245,A
Kirktcb 2007.04.20,869,1,0,11,268,27,-241,B
greenqueenbrasil 2007.04.19,929,1,0,5,303,0,-303,A
greenqueenbrasil 2007.04.19,929,1,0,5,325,0,-325,B
goodbuzz 2007.04.19,1064,1,1,5,48,60,12,A
goodbuzz 2007.04.19,1064,1,1,5,52,60,8,B
icman 2007.04.19,1079,1,0.5,16,298,12,-286,A
icman 2007.04.19,1079,1,0.5,16,269,19,-250,B
jjmieres 2007.04.16,1047,1,0,20,154,30,-124,A
jjmieres 2007.04.16,1047,1,0,20,153,30,-123,B
RoKStAR 2007.04.16,902,1,1,21,132,33,-99,A
RoKStAR 2007.04.16,902,1,1,21,145,33,-112,B
Eskupitazo 2007.07.06,860,1,1,9,271,22,-249,A
Eskupitazo 2007.07.06,860,1,1,9,223,11,-212,B
andoferni 2007.07.06,933,1,0,9,422,0,-422,A
andoferni 2007.07.06,933,1,0,9,393,11,-382,B
direworl 2007.04.19,933,2,0,20,218,15,-203,A
direworl 2007.04.19,933,2,0,20,215,25,-190,B
SixteenCorners 2007.04.19,965,2,2,20,111,20,-91,A
SixteenCorners 2007.04.19,965,2,2,20,110,30,-80,B
KnutY 2007.04.04,1205,1,1,4,98,50,-48,A
KnutY 2007.04.04,1205,1,1,4,97,50,-47,B
Blindjavamanissa 2007.04.02,873,1,1,4,166,0,-166,A
Blindjavamanissa 2007.04.02,873,1,1,4,143,0,-143,B
meenamoh 2007.04.02,1012,1,0,5,318,0,-318,A
meenamoh 2007.04.02,1012,1,0,5,385,0,-385,B
HomogenousMass 2007.03.10,1002,1,0,13,138,15,-123,A
HomogenousMass 2007.03.10,1002,1,0,13,154,15,-139,B
MySic 2007.03.10,987,1,1,12,57,42,-15,A
MySic 2007.03.10,987,1,1,12,55,50,-5,B
Jia 2007.01.02,1006,1,0,11,275,18,-257,A
Jia 2007.01.02,1006,1,0,11,242,18,-224,B
jshumaker 2007.01.02,853,1,1,10,68,50,-18,A
jshumaker 2007.01.02,853,1,1,10,63,50,-13,B
Biggnick 2007.04.09,1038,1,1,16,201,6,-195,A
Biggnick 2007.04.09,1038,1,1,16,194,12,-182,B
Dakel 2007.04.09,907,1,0,17,273,12,-261,A
Dakel 2007.04.09,907,1,0,17,278,18,-260,B
bigrustynail 2007.04.08,919,1,1,14,144,29,-115,A
bigrustynail 2007.04.08,919,1,1,14,175,21,-154,B
paulfallet 2007.04.08,974,1,0,15,247,20,-227,A
paulfallet 2007.04.08,974,1,0,15,283,7,-276,B
Jia 2007.04.21,989,1,1,22,148,46,-102,A
Jia 2007.04.21,989,1,1,22,160,46,-114,B
wyldeemgz 2007.04.21,966,1,0,22,188,14,-174,A
wyldeemgz 2007.04.21,966,1,0,22,188,27,-161,B
xWildBillx 2007.03.29,790,1,0,27,401,15,-386,A
xWildBillx 2007.03.29,790,1,0,27,395,7,-388,B
Kirktcb 2007.03.29,899,1,1,20,330,20,-310,A
Kirktcb 2007.03.29,899,1,1,20,307,20,-287,B
kaarunya 2007.04.15,843,1,0,18,226,6,-220,A
kaarunya 2007.04.15,843,1,0,18,215,6,-209,B
LopezLaTorre 2007.04.15,1078,1,1,17,154,18,-136,A
LopezLaTorre 2007.04.15,1078,1,1,17,146,18,-128,B
Darvster 2007.04.09,962,1,0,13,227,46,-181,A
Darvster 2007.04.09,962,1,0,13,176,46,-130,B
Jia 2007.04.09,1000,1,1,11,171,9,-162,A
Jia 2007.04.09,1000,1,1,11,162,0,-162,B
SirEndipity 2007.03.24,1151,1,1,11,231,27,-204,A
SirEndipity 2007.03.24,1151,1,1,11,162,27,-135,B
xWildBillx 2007.03.24,849,3,0,43,400,16,-384,A
xWildBillx 2007.03.24,849,3,0,43,391,14,-377,B
DeathFromAbove 2007.03.09,872,1,1,10,207,30,-177,A
DeathFromAbove 2007.03.09,872,1,1,10,202,30,-172,B
HomogenousMass 2007.03.09,1036,1,0,10,214,30,-184,A
HomogenousMass 2007.03.09,1036,1,0,10,193,30,-163,B
Kirktcb 2007.04.08,899,1,0,14,294,14,-280,A
Kirktcb 2007.04.08,899,1,0,14,291,21,-270,B
LithFlash 2007.04.08,1099,1,1,12,101,58,-43,A
LithFlash 2007.04.08,1099,1,1,12,109,58,-51,B
Sailmo 2007.03.24,962,1,1,9,78,44,-34,A
Sailmo 2007.03.24,962,1,1,9,74,56,-18,B
kaarunya 2007.04.13,851,1,0,12,372,17,-355,A
kaarunya 2007.04.13,851,1,0,12,399,17,-382,B
CLAS 2007.04.13,1051,1,1,10,191,10,-181,A
CLAS 2007.04.13,1051,1,1,10,209,10,-199,B
unfrozen 2007.04.06,964,1,0,16,238,25,-213,A
unfrozen 2007.04.06,964,1,0,16,224,25,-199,B
HEARTLESSWIZARD 2007.04.06,1013,1,1,17,336,12,-324,A
HEARTLESSWIZARD 2007.04.06,1013,1,1,17,319,12,-307,B
tetrapharmakon 2007.04.08,972,1,0,10,307,20,-287,A
tetrapharmakon 2007.04.08,972,1,0,10,276,20,-256,B
RiverRock 2007.04.08,950,1,1,8,74,62,-12,A
RiverRock 2007.04.08,950,1,1,8,85,62,-23,B
xWildBillx 2007.03.28,799,1,0,7,337,14,-323,A
xWildBillx 2007.03.28,799,1,0,7,334,14,-320,B
zzzsah 2007.03.28,1078,1,1,5,62,40,-22,A
zzzsah 2007.03.28,1078,1,1,5,66,40,-26,B
xWildBillx 2007.03.25,797,2,1,40,270,22,-248,A
xWildBillx 2007.03.25,797,2,1,40,270,25,-245,B
SirEndipity 2007.03.25,1153,1,1,19,207,32,-175,A
SirEndipity 2007.03.25,1153,1,1,19,199,26,-173,B
Bolders 2007.03.27,1102,1,1,36,151,42,-109,A
Bolders 2007.03.27,1102,1,1,36,103,42,-61,B
Chrisasdf 2007.03.12,976,1,0,24,175,29,-146,A
Chrisasdf 2007.03.12,976,1,0,24,134,25,-109,B
hotwheela 2007.03.12,969,1,1,27,259,30,-229,A
hotwheela 2007.03.12,969,1,1,27,272,22,-250,B
RiverRock 2007.04.07,997,1,1,8,462,25,-437,A
RiverRock 2007.04.07,997,1,1,8,422,25,-397,B
wyldeemgz 2007.04.07,949,1,0,6,377,33,-344,A
wyldeemgz 2007.04.07,949,1,0,6,310,33,-277,B
timothyschmid 2007.03.08,869,1,0,9,187,22,-165,A
timothyschmid 2007.03.08,869,1,0,9,195,22,-173,B
aGameofChess 2007.03.08,1122,1,1,9,122,44,-78,A
aGameofChess 2007.03.08,1122,1,1,9,122,44,-78,B
MasterOfMagic 2007.01.25,1026,1,0,24,272,8,-264,A
MasterOfMagic 2007.01.25,1026,1,0,24,259,12,-247,B
CopilotJoe 2007.01.25,970,1,1,29,392,17,-375,A
CopilotJoe 2007.01.25,970,1,1,29,376,17,-359,B
stardawg 2007.03.31,884,1,0,17,284,6,-278,A
stardawg 2007.03.31,884,1,0,17,307,0,-307,B
Jia 2007.03.31,1006,1,1,14,213,7,-206,A
Jia 2007.03.31,1006,1,1,14,260,7,-253,B
xWildBillx 2007.03.27,806,2,0,31,213,23,-190,A
xWildBillx 2007.03.27,806,2,0,31,222,26,-196,B
slumberjack 2007.03.27,1098,1,1,15,86,20,-66,A
slumberjack 2007.03.27,1098,1,1,15,92,13,-79,B
Eladar 2007.03.24,1061,1,0,14,130,36,-94,A
Eladar 2007.03.24,1061,1,0,14,114,50,-64,B
Dicemice 2007.03.24,876,1,1,11,59,46,-13,A
Dicemice 2007.03.24,876,1,1,11,46,36,-10,B
paulfallet 2007.03.09,975,1,0,25,196,28,-168,A
paulfallet 2007.03.09,975,1,0,25,208,24,-184,B
GolfBob 2007.03.09,968,1,1,24,157,29,-128,A
GolfBob 2007.03.09,968,1,1,24,173,21,-152,B
perfectloop 2007.03.27,1186,1,1,12,93,33,-60,A
perfectloop 2007.03.27,1186,1,1,12,111,33,-78,B
stardawg 2007.03.25,1035,1,0,21,329,24,-305,A
stardawg 2007.03.25,1035,1,0,21,340,19,-321,B
NYTahiti 2007.03.24,1151,1,1,13,157,38,-119,A
NYTahiti 2007.03.24,1151,1,1,13,176,38,-138,B
zacq 2007.03.09,883,1,0,24,373,38,-335,A
zacq 2007.03.09,883,1,0,24,397,25,-372,B
Malca 2007.03.09,1047,1,1,26,330,27,-303,A
Malca 2007.03.09,1047,1,1,26,349,19,-330,B
HomogenousMass 2007.03.07,1021,2,1.5,23,250,30,-220,A
HomogenousMass 2007.03.07,1021,2,1.5,23,247,26,-221,B
DeathFromAbove 2007.03.07,904,2,0.5,29,309,17,-292,A
DeathFromAbove 2007.03.07,904,2,0.5,29,333,10,-323,B
mjcknight 2007.01.26,918,1,1,14,327,14,-313,A
mjcknight 2007.01.26,918,1,1,14,320,7,-313,B
nuthegoob 2007.01.26,1068,1,0,13,230,23,-207,A
nuthegoob 2007.01.26,1068,1,0,13,229,23,-206,B
mjcknight 2007.02.11,878,1,1,7,86,57,-29,A
mjcknight 2007.02.11,878,1,1,7,82,57,-25,B
ITVin 2007.02.11,1040,1,0,9,373,11,-362,A
ITVin 2007.02.11,1040,1,0,9,376,11,-365,B
Andreadoria 2007.01.14,913,1,1,11,192,18,-174,A
Andreadoria 2007.01.14,913,1,1,11,187,18,-169,B
paulfallet 2007.01.14,1042,1,0,8,65,62,-3,A
paulfallet 2007.01.14,1042,1,0,8,73,62,-11,B
sneakypawn 2007.03.12,850,1,0,28,334,18,-316,A
sneakypawn 2007.03.12,850,1,0,28,266,21,-245,B
tereliza 2007.03.12,1102,1,1,23,158,44,-114,A
tereliza 2007.03.12,1102,1,1,23,158,39,-119,B
eclipze 2007.02.01,1186,1,0,25,245,24,-221,A
eclipze 2007.02.01,1186,1,0,25,227,32,-195,B
theshowboat 2007.03.19,977,1,0,21,165,19,-146,A
theshowboat 2007.03.19,977,1,0,21,155,19,-136,B
unfrozen 2007.03.19,1021,1,1,21,174,29,-145,A
unfrozen 2007.03.19,1021,1,1,21,151,29,-122,B
SimSima 2007.02.22,888,1,0,21,214,33,-181,A
SimSima 2007.02.22,888,1,0,21,210,29,-181,B
checkmatejack 2007.02.22,1087,1,1,19,113,47,-66,A
checkmatejack 2007.02.22,1087,1,1,19,102,53,-49,B
Rexton 2007.02.23,901,1,0,8,432,25,-407,A
Rexton 2007.02.23,901,1,0,8,306,25,-281,B
BlondBabe 2007.02.23,1093,1,1,6,126,33,-93,A
BlondBabe 2007.02.23,1093,1,1,6,117,33,-84,B
Andreadoria 2007.01.22,1075,1,0,16,152,31,-121,A
Andreadoria 2007.01.22,1075,1,0,16,187,31,-156,B
infernonk 2007.01.22,860,1,1,14,63,43,-20,A
infernonk 2007.01.22,860,1,1,14,74,43,-31,B
mjcknight 2007.01.06,952,1,0,17,226,29,-197,A
mjcknight 2007.01.06,952,1,0,17,212,29,-183,B
nuthegoob 2007.01.06,1034,1,1,16,153,31,-122,A
nuthegoob 2007.01.06,1034,1,1,16,134,31,-103,B
Pixxilingstron 2007.03.09,1005,1,0,41,95,41,-54,A
Pixxilingstron 2007.03.09,1005,1,0,41,92,34,-58,B
Pixxilingstron 2007.03.09,1005,1,0,41,95,34,-61,C
hotwheela 2007.03.09,976,1,1,39,39,41,2,A
hotwheela 2007.03.09,976,1,1,39,32,38,6,B
hotwheela 2007.03.09,976,1,1,39,34,33,-1,C
myibcait 2007.01.10,936,1,1,6,342,17,-325,A
myibcait 2007.01.10,936,1,1,6,318,33,-285,B
Andreadoria 2007.01.10,1014,1,0,6,523,17,-506,A
Andreadoria 2007.01.10,1014,1,0,6,530,17,-513,B
Ratamacue 2007.02.14,873,1,0,25,142,20,-122,A
Ratamacue 2007.02.14,873,1,0,25,136,20,-116,B
TrumpetJedi 2007.02.14,1021,1,1,23,152,35,-117,A
TrumpetJedi 2007.02.14,1021,1,1,23,143,35,-108,B
Spiraldown 2007.01.27,898,1,0,16,386,19,-367,A
Spiraldown 2007.01.27,898,1,0,16,425,19,-406,B
slartibartflat 2007.01.27,1030,1,1,13,256,46,-210,A
slartibartflat 2007.01.27,1030,1,1,13,250,38,-212,B
dustbuni 2007.02.13,1009,1,1,26,158,46,-112,A
dustbuni 2007.02.13,1009,1,1,26,164,38,-126,B
knightse 2007.02.13,982,1,0,23,196,22,-174,A
knightse 2007.02.13,982,1,0,23,208,22,-186,B
mpaon 2007.01.21,896,2,0,27,184,15,-169,A
mpaon 2007.01.21,896,2,0,27,173,22,-151,B
steventhenoob 2007.01.21,1072,2,2,26,161,23,-138,A
steventhenoob 2007.01.21,1072,2,2,26,154,23,-131,B
MasterGilly 2007.01.28,967,1,0,11,152,27,-125,A
MasterGilly 2007.01.28,967,1,0,11,156,27,-129,B
ArtVandeleigh 2007.01.28,993,1,1,15,328,20,-308,A
ArtVandeleigh 2007.01.28,993,1,1,15,295,20,-275,B
Zevix 2007.02.13,964,1,0.5,12,193,42,-151,A
Zevix 2007.02.13,964,1,0.5,12,196,33,-163,B
DEDEE 2007.02.13,913,1,0.5,12,239,33,-206,A
DEDEE 2007.02.13,913,1,0.5,12,245,33,-212,B
slavonija 2007.01.10,687,1,0,6,355,17,-338,A
slavonija 2007.01.10,687,1,0,6,321,17,-304,B
Etka 2007.01.10,1129,1,1,5,146,20,-126,A
Etka 2007.01.10,1129,1,1,5,148,0,-148,B
Jia 2007.01.28,1011,1,0,29,264,28,-236,A
Jia 2007.01.28,1011,1,0,29,220,24,-196,B
himmelsgrau 2007.01.28,833,1,1,27,162,41,-121,A
himmelsgrau 2007.01.28,833,1,1,27,146,48,-98,B
timothyschmid 2007.01.23,879,1,1,13,45,46,1,A
timothyschmid 2007.01.23,879,1,1,13,16,54,38,B
steventhenoob 2007.01.23,1098,1,0,15,149,40,-109,A
steventhenoob 2007.01.23,1098,1,0,15,100,33,-67,B
JohnstonDJ 2007.01.23,923,1,0,12,239,8,-231,A
JohnstonDJ 2007.01.23,923,1,0,12,204,8,-196,B
willingdon 2007.01.23,1063,1,1,11,94,36,-58,A
willingdon 2007.01.23,1063,1,1,11,65,36,-29,B
slartibartflat 2007.01.21,1057,1,0.5,40,209,38,-171,A
slartibartflat 2007.01.21,1057,1,0.5,40,225,35,-190,B
timothyschmid 2007.01.21,903,1,0.5,36,162,42,-120,A
timothyschmid 2007.01.21,903,1,0.5,36,142,44,-98,B
mjcknight 2007.01.24,941,1,0,24,267,12,-255,A
mjcknight 2007.01.24,941,1,0,24,279,12,-267,B
MrAdcock 2007.01.24,1054,1,1,23,185,26,-159,A
MrAdcock 2007.01.24,1054,1,1,23,220,26,-194,B
clickoo 2007.01.17,792,1,1,7,37,57,20,A
clickoo 2007.01.17,792,1,1,7,48,71,23,B
awen 2007.01.17,987,1,0,6,74,50,-24,A
awen 2007.01.17,987,1,0,6,120,33,-87,B
slavonija 2007.01.03,856,1,0,7,226,0,-226,A
slavonija 2007.01.03,856,1,0,7,237,0,-237,B
netbrain 2007.01.03,1072,1,1,6,99,17,-82,A
netbrain 2007.01.03,1072,1,1,6,113,17,-96,B
mipsparc 2008.07.28,1007,1,1,10,78,80,2,A
mipsparc 2008.07.28,1007,1,1,10,65,60,-5,B
lacceroswaldo 2008.07.28,913,1,0,12,213,8,-205,A
lacceroswaldo 2008.07.28,913,1,0,12,240,8,-232,B
bdbailey 2008.07.24,921,1,0,19,302,16,-286,A
bdbailey 2008.07.24,921,1,0,19,291,21,-270,B
TheSexyKid 2008.07.24,1048,1,1,14,380,14,-366,A
TheSexyKid 2008.07.24,1048,1,1,14,296,14,-282,B
Kyobutungi 2008.07.05,1072,1,1,27,116,26,-90,A
Kyobutungi 2008.07.05,1072,1,1,27,116,33,-83,B
tfrio 2008.07.05,836,2,1,40,152,38,-114,A
tfrio 2008.07.05,836,2,1,40,158,38,-120,B
attilanino 2008.07.31,959,1,1,12,74,58,-16,A
attilanino 2008.07.31,959,1,1,12,75,58,-17,B
drstu 2008.07.31,920,1,0,15,251,33,-218,A
drstu 2008.07.31,920,1,0,15,211,33,-178,B
nryan 2008.07.21,977,2,1,30,143,33,-110,A
nryan 2008.07.21,977,2,1,30,124,33,-91,B
NaraShikamaru 2008.07.21,927,1,0,10,293,20,-273,A
NaraShikamaru 2008.07.21,927,1,0,10,270,20,-250,B
lacceroswaldo 2008.06.23,986,11,6,232,169,37,-132,A
lacceroswaldo 2008.06.23,986,11,6,232,166,36,-130,B
mipsparc 2008.06.23,1009,11,5,240,184,33,-151,A
mipsparc 2008.06.23,1009,11,5,240,176,35,-141,B
scygrav 2008.06.15,939,1,1,18,93,33,-60,A
scygrav 2008.06.15,939,1,1,18,94,22,-72,B
sspcleber 2008.06.15,953,1,0,21,116,38,-78,A
sspcleber 2008.06.15,953,1,0,21,119,29,-90,B
DDJ 2008.07.26,978,1,1,6,366,0,-366,A
DDJ 2008.07.26,978,1,1,6,403,0,-403,B
drkris 2008.07.26,991,3,0,37,183,19,-164,A
drkris 2008.07.26,991,3,0,37,182,19,-163,B
Gabimo 2008.07.15,931,1,1,13,152,46,-106,A
Gabimo 2008.07.15,931,1,1,13,141,46,-95,B
mbbane 2008.07.15,949,1,0,11,88,36,-52,A
mbbane 2008.07.15,949,1,0,11,77,36,-41,B
LaurentDelaon 2008.07.09,1087,1,1,9,142,22,-120,A
LaurentDelaon 2008.07.09,1087,1,1,9,130,22,-108,B
Scumm 2008.07.09,894,1,0,9,167,44,-123,A
Scumm 2008.07.09,894,1,0,9,160,33,-127,B
pumpbuster 2008.07.31,1128,1,0.5,40,89,30,-59,A
pumpbuster 2008.07.31,1128,1,0.5,40,87,28,-59,B
isntheaqt 2008.07.31,869,1,0.5,45,209,27,-182,A
isntheaqt 2008.07.31,869,1,0.5,45,212,20,-192,B
NaraShikamaru 2008.07.13,953,2,1.5,28,186,32,-154,A
NaraShikamaru 2008.07.13,953,2,1.5,28,191,25,-166,B
kigger 2008.07.13,938,1,0,7,341,43,-298,A
kigger 2008.07.13,938,1,0,7,336,43,-293,B
mbranimir 2008.07.05,966,1,1,17,91,41,-50,A
mbranimir 2008.07.05,966,1,1,17,107,29,-78,B
sspcleber 2008.07.05,905,1,0,19,190,21,-169,A
sspcleber 2008.07.05,905,1,0,19,198,21,-177,B
VOnegin 2008.06.05,933,1,1,5,118,20,-98,A
VOnegin 2008.06.05,933,1,1,5,79,20,-59,B
KarimNicho 2008.06.05,905,1,0,7,163,14,-149,A
KarimNicho 2008.06.05,905,1,0,7,275,14,-261,B
MalcaReborn 2008.07.25,867,2,0.5,67,134,31,-103,A
MalcaReborn 2008.07.25,867,2,0.5,67,109,34,-75,B
DEDEE 2008.07.25,1111,1,0.5,62,168,29,-139,A
DEDEE 2008.07.25,1111,1,0.5,62,159,29,-130,B
JabZ 2008.07.14,871,1,0,5,439,40,-399,A
JabZ 2008.07.14,871,1,0,5,421,40,-381,B
sspcleber 2008.07.14,952,1,1,4,73,50,-23,A
sspcleber 2008.07.14,952,1,1,4,67,75,8,B
tabbykt 2008.07.05,912,1,0.5,8,578,25,-553,A
tabbykt 2008.07.05,912,1,0.5,8,346,25,-321,B
DEDEE 2008.07.05,1083,1,0.5,4,115,75,-40,A
DEDEE 2008.07.05,1083,1,0.5,4,48,25,-23,B
sspcleber 2008.06.28,916,1,0,28,268,25,-243,A
sspcleber 2008.06.28,916,1,0,28,270,36,-234,B
Simplicus 2008.06.28,1078,1,1,24,127,33,-94,A
Simplicus 2008.06.28,1078,1,1,24,149,33,-116,B
achieve 2008.05.28,1071,1,0,5,360,0,-360,A
achieve 2008.05.28,1071,1,0,5,150,0,-150,B
simmito 2008.05.28,925,1,1,8,341,12,-329,A
simmito 2008.05.28,925,1,1,8,320,12,-308,B
arsalanbaig 2008.07.25,1079,1,1,7,0,100,100,A
arsalanbaig 2008.07.25,1079,1,1,7,0,100,100,B
sspcleber 2008.07.21,988,1,1,19,99,37,-62,A
sspcleber 2008.07.21,988,1,1,19,91,32,-59,B
qpn 2008.07.03,1070,1,0,22,259,27,-232,A
qpn 2008.07.03,1070,1,0,22,252,14,-238,B
JonEG 2008.07.03,844,1,1,21,175,33,-142,A
JonEG 2008.07.03,844,1,1,21,190,33,-157,B
mjwadams 2008.07.26,1001,1,1,4,74,25,-49,A
mjwadams 2008.07.26,1001,1,1,4,52,50,-2,B
laksen 2008.07.26,948,1,0,4,133,25,-108,A
laksen 2008.07.26,948,1,0,4,164,25,-139,B
vetteboy 2008.07.23,901,2,1,22,238,27,-211,A
vetteboy 2008.07.23,901,2,1,22,253,32,-221,B
NaraShikamaru 2008.07.23,898,1,0,20,423,25,-398,A
NaraShikamaru 2008.07.23,898,1,0,20,408,25,-383,B
LaurentDelaon 2008.06.27,1039,1,0,19,222,21,-201,A
LaurentDelaon 2008.06.27,1039,1,0,19,235,21,-214,B
tabbykt 2008.06.27,911,1,1,20,224,35,-189,A
tabbykt 2008.06.27,911,1,1,20,279,35,-244,B
RICHARDEUR 2008.05.30,1063,1,1,15,363,33,-330,A
RICHARDEUR 2008.05.30,1063,1,1,15,327,20,-307,B
bandicot 2008.05.30,928,1,0,19,423,26,-397,A
bandicot 2008.05.30,928,1,0,19,411,26,-385,B
zenmate 2008.07.27,1056,1,0,5,50,20,-30,A
zenmate 2008.07.27,1056,1,0,5,54,40,-14,B
madjoe 2008.07.27,911,1,1,4,70,25,-45,A
madjoe 2008.07.27,911,1,1,4,78,25,-53,B
krishnak 2008.07.22,980,2,1,41,129,39,-90,A
krishnak 2008.07.22,980,2,1,41,146,32,-114,B
pmineiro 2008.07.22,847,1,0,10,279,20,-259,A
pmineiro 2008.07.22,847,1,0,10,264,20,-244,B
LaurentDelaon 2008.06.09,1044,1,1,41,276,32,-244,A
LaurentDelaon 2008.06.09,1044,1,1,41,269,27,-242,B
bandicot 2008.06.09,909,1,0,36,170,31,-139,A
bandicot 2008.06.09,909,1,0,36,177,28,-149,B
bandicot 2008.05.29,904,2,0,20,236,20,-216,A
bandicot 2008.05.29,904,2,0,20,241,20,-221,B
mAsTERpEE 2008.05.29,939,1,1,12,111,33,-78,A
mAsTERpEE 2008.05.29,939,1,1,12,128,33,-95,B
lowball 2008.04.22,853,1,1,6,42,50,8,A
lowball 2008.04.22,853,1,1,6,24,67,43,B
LaurentDelaon 2008.04.22,1099,1,0,6,208,33,-175,A
LaurentDelaon 2008.04.22,1099,1,0,6,202,33,-169,B
DEDEE 2008.04.19,992,2,2,7,63,71,8,A
DEDEE 2008.04.19,992,2,2,7,92,71,-21,B
ChessWurgen 2008.04.19,968,2,0,14,407,43,-364,A
ChessWurgen 2008.04.19,968,2,0,14,427,43,-384,B
themoor 2008.04.22,1103,1,1,6,152,33,-119,A
themoor 2008.04.22,1103,1,1,6,134,33,-101,B
DaveMiddled 2008.04.22,846,1,0,6,246,33,-213,A
DaveMiddled 2008.04.22,846,1,0,6,231,33,-198,B
Belane 2008.04.15,1043,1,1,16,54,50,-4,A
Belane 2008.04.15,1043,1,1,16,45,56,11,B
Philipck 2008.04.15,954,1,0,17,171,41,-130,A
Philipck 2008.04.15,954,1,0,17,163,41,-122,B
SKUMARKOPPALA 2008.04.09,959,1,0,9,319,22,-297,A
SKUMARKOPPALA 2008.04.09,959,1,0,9,304,11,-293,B
karcal 2008.04.09,1019,1,1,5,84,40,-44,A
karcal 2008.04.09,1019,1,1,5,90,40,-50,B
MalcaReborn 2008.07.26,1001,2,2,29,65,62,-3,A
MalcaReborn 2008.07.26,1001,2,2,29,59,59,0,B
MalcaReborn 2008.07.26,1001,2,2,29,61,55,-6,C
tfrio 2008.07.14,915,1,0,6,492,17,-475,A
tfrio 2008.07.14,915,1,0,6,408,17,-391,B
skydvr 2008.07.14,1077,1,1,5,212,40,-172,A
skydvr 2008.07.14,1077,1,1,5,137,40,-97,B
pendaggie 2008.06.29,816,1,1,7,246,43,-203,A
pendaggie 2008.06.29,816,1,1,7,243,29,-214,B
pumpbuster 2008.06.29,1148,1,0,6,317,33,-284,A
pumpbuster 2008.06.29,1148,1,0,6,322,17,-305,B
LaurentDelaon 2008.06.12,1043,2,1,13,363,31,-332,A
LaurentDelaon 2008.06.12,1043,2,1,13,322,31,-291,B
CHESSDONK 2008.06.12,954,2,1,13,309,31,-278,A
CHESSDONK 2008.06.12,954,2,1,13,281,31,-250,B
LaurentDelaon 2008.05.27,1028,2,2,48,244,25,-219,A
LaurentDelaon 2008.05.27,1028,2,2,48,243,23,-220,B
bandicot 2008.05.27,928,2,0,53,304,30,-274,A
bandicot 2008.05.27,928,2,0,53,306,30,-276,B
dtrasatti 2008.05.25,878,1,0,22,192,36,-156,A
dtrasatti 2008.05.25,878,1,0,22,170,36,-134,B
ogbornd 2008.05.25,1115,1,1,19,118,32,-86,A
ogbornd 2008.05.25,1115,1,1,19,125,42,-83,B
HerveRenault 2008.04.29,986,1,1,21,106,52,-54,A
HerveRenault 2008.04.29,986,1,1,21,100,57,-43,B
HerveRenault 2008.04.29,986,1,1,21,100,57,-43,C
DaveMiddled 2008.04.29,846,1,0,21,186,29,-157,A
DaveMiddled 2008.04.29,846,1,0,21,188,29,-159,B
DaveMiddled 2008.04.29,846,1,0,21,185,24,-161,C
jasonmyerss 2008.07.31,885,1,0,27,365,33,-332,A
jasonmyerss 2008.07.31,885,1,0,27,340,26,-314,B
theonejanitor 2008.07.31,1007,1,1,19,212,53,-159,A
theonejanitor 2008.07.31,1007,1,1,19,224,47,-177,B
sspcleber 2008.07.17,989,1,0,11,231,36,-195,A
sspcleber 2008.07.17,989,1,0,11,227,36,-191,B
JabZ 2008.07.17,797,1,1,10,221,30,-191,A
JabZ 2008.07.17,797,1,1,10,242,20,-222,B
tabbykt 2008.07.29,941,1,1,5,39,60,21,A
tabbykt 2008.07.29,941,1,1,5,49,60,11,B
Liisa 2008.07.29,984,1,0,5,255,20,-235,A
Liisa 2008.07.29,984,1,0,5,265,20,-245,B
tabbykt 2008.07.07,924,1,0,10,263,30,-233,A
tabbykt 2008.07.07,924,1,0,10,271,30,-241,B
krishnak 2008.07.07,922,1,1,8,205,12,-193,A
krishnak 2008.07.07,922,1,1,8,202,12,-190,B
lacceroswaldo 2008.07.27,946,1,0,21,183,33,-150,A
lacceroswaldo 2008.07.27,946,1,0,21,208,33,-175,B
lacceroswaldo 2008.07.27,946,1,0,21,219,29,-190,C
tfrio 2008.07.27,902,1,1,20,138,50,-88,A
tfrio 2008.07.27,902,1,1,20,165,50,-115,B
tfrio 2008.07.27,902,1,1,20,155,45,-110,C
mipsparc 2008.06.18,1007,2,0.5,42,193,33,-160,A
mipsparc 2008.06.18,1007,2,0.5,42,154,36,-118,B
lacceroswaldo 2008.06.18,986,2,1.5,41,122,39,-83,A
lacceroswaldo 2008.06.18,986,2,1.5,41,106,46,-60,B
mipsparc 2008.06.15,1027,2,0,33,310,21,-289,A
mipsparc 2008.06.15,1027,2,0,33,249,27,-222,B
lacceroswaldo 2008.06.15,893,2,2,30,231,37,-194,A
lacceroswaldo 2008.06.15,893,2,2,30,223,30,-193,B
vannman 2008.07.18,1104,1,1,13,92,31,-61,A
vannman 2008.07.18,1104,1,1,13,102,31,-71,B
chrisdill 2008.07.18,844,1,0,12,214,33,-181,A
chrisdill 2008.07.18,844,1,0,12,222,33,-189,B
pumpbuster 2008.07.15,1144,1,1,7,52,43,-9,A
pumpbuster 2008.07.15,1144,1,1,7,33,57,24,B
isntheaqt 2008.07.15,854,1,0,7,282,29,-253,A
isntheaqt 2008.07.15,854,1,0,7,285,29,-256,B
AndyKG 2008.07.08,924,1,1,15,45,40,-5,A
AndyKG 2008.07.08,924,1,1,15,52,27,-25,B
sspcleber 2008.07.08,931,1,0,15,136,20,-116,A
sspcleber 2008.07.08,931,1,0,15,130,27,-103,B
paulgrahi 2008.06.25,1035,1,1,14,63,21,-42,A
paulgrahi 2008.06.25,1035,1,1,14,67,29,-38,B
sspcleber 2008.06.25,945,1,0,15,162,33,-129,A
sspcleber 2008.06.25,945,1,0,15,166,40,-126,B
avorenus 2008.07.25,967,1,0,24,229,25,-204,A
avorenus 2008.07.25,967,1,0,24,238,25,-213,B
sspcleber 2008.07.25,1011,1,1,20,122,30,-92,A
sspcleber 2008.07.25,1011,1,1,20,119,30,-89,B
laksen 2008.07.13,961,1,0.5,26,252,35,-217,A
laksen 2008.07.13,961,1,0.5,26,254,27,-227,B
TheMightyOne 2008.07.10,916,2,2,11,45,64,19,A
TheMightyOne 2008.07.10,916,2,2,11,47,73,26,B
tabbykt 2008.07.10,881,2,0,15,271,20,-251,A
tabbykt 2008.07.10,881,2,0,15,296,13,-283,B
bellumnonpax 2008.07.23,1049,1,1,8,84,38,-46,A
bellumnonpax 2008.07.23,1049,1,1,8,106,38,-68,B
Dancinchess 2008.06.20,939,1,0,10,530,0,-530,A
Dancinchess 2008.06.20,939,1,0,10,483,0,-483,B
Atlante 2008.06.20,946,1,1,9,427,0,-427,A
Atlante 2008.06.20,946,1,1,9,380,11,-369,B
KaiserPawn 2008.06.18,866,1,1,5,95,20,-75,A
KaiserPawn 2008.06.18,866,1,1,5,87,20,-67,B
flpcosta 2008.06.18,1133,1,0,5,286,20,-266,A
flpcosta 2008.06.18,1133,1,0,5,270,20,-250,B
bandicot 2008.06.03,883,1,1,9,68,22,-46,A
bandicot 2008.06.03,883,1,1,9,73,33,-40,B
YVN 2008.06.03,1039,1,0,9,100,11,-89,A
YVN 2008.06.03,1039,1,0,9,113,0,-113,B
PBLegion 2008.05.27,919,1,1,7,85,29,-56,A
PBLegion 2008.05.27,919,1,1,7,56,29,-27,B
Androidkenny 2008.05.27,1032,1,0,10,171,30,-141,A
Androidkenny 2008.05.27,1032,1,0,10,152,20,-132,B
tfrio 2008.05.12,869,4,1,48,217,31,-186,A
tfrio 2008.05.12,869,4,1,48,222,31,-191,B
MXseptimus 2008.05.12,1141,1,1,4,244,25,-219,A
MXseptimus 2008.05.12,1141,1,1,4,336,0,-336,B
BrunoPereira 2008.05.09,948,1,1,19,172,32,-140,A
BrunoPereira 2008.05.09,948,1,1,19,165,26,-139,B
cinex 2008.05.09,1048,1,0,20,226,30,-196,A
cinex 2008.05.09,1048,1,0,20,230,25,-205,B
TiredofLosing 2008.07.22,1013,1,1,29,36,52,16,A
TiredofLosing 2008.07.22,1013,1,1,29,33,48,15,B
TiredofLosing 2008.07.22,1013,1,1,29,30,48,18,C
lacceroswaldo 2008.06.16,964,4,2.5,53,233,32,-201,A
lacceroswaldo 2008.06.16,964,4,2.5,53,216,28,-188,B
mipsparc 2008.06.16,1019,4,1.5,53,251,32,-219,A
mipsparc 2008.06.16,1019,4,1.5,53,259,25,-234,B
Lucanus 2008.07.20,1033,1,1,23,158,44,-114,A
Lucanus 2008.07.20,1033,1,1,23,159,44,-115,B
psychotronic 2008.07.20,959,1,0,22,167,36,-131,A
psychotronic 2008.07.20,959,1,0,22,173,32,-141,B
lacceroswaldo 2008.07.04,986,1,0,10,332,0,-332,A
lacceroswaldo 2008.07.04,986,1,0,10,335,0,-335,B
mipsparc 2008.07.04,995,1,1,5,47,40,-7,A
mipsparc 2008.07.04,995,1,1,5,45,40,-5,B
tabbykt 2008.06.30,934,1,0,23,255,26,-229,A
tabbykt 2008.06.30,934,1,0,23,242,26,-216,B
gerassi 2008.06.30,996,1,1,24,286,21,-265,A
gerassi 2008.06.30,996,1,1,24,283,29,-254,B
poos 2008.05.28,927,1,0,17,298,47,-251,A
poos 2008.05.28,927,1,0,17,314,47,-267,B
sspcleber 2008.05.28,1066,1,1,25,568,32,-536,A
sspcleber 2008.05.28,1066,1,1,25,525,32,-493,B
paulfallet 2008.05.03,873,1,0,25,148,28,-120,A
paulfallet 2008.05.03,873,1,0,25,157,28,-129,B
SAVAGEPLAYA 2008.05.03,1109,1,1,27,198,30,-168,A
SAVAGEPLAYA 2008.05.03,1109,1,1,27,205,30,-175,B
isntheaqt 2008.07.17,855,1,1,7,188,29,-159,A
isntheaqt 2008.07.17,855,1,1,7,194,29,-165,B
pumpbuster 2008.07.17,1142,1,0,6,57,67,10,A
pumpbuster 2008.07.17,1142,1,0,6,37,67,30,B
Derbentli 2008.05.30,934,1,1,12,73,50,-23,A
Derbentli 2008.05.30,934,1,1,12,80,50,-30,B
KaiserPawn 2008.05.30,941,1,0,12,136,42,-94,A
KaiserPawn 2008.05.30,941,1,0,12,154,42,-112,B
Leonidovich 2008.07.23,969,1,1,15,103,20,-83,A
Leonidovich 2008.07.23,969,1,1,15,98,27,-71,B
MianMy 2008.07.23,1020,1,0,15,199,20,-179,A
MianMy 2008.07.23,1020,1,0,15,195,20,-175,B
mbranimir 2008.07.03,966,1,0.5,8,38,38,0,A
mbranimir 2008.07.03,966,1,0.5,8,57,38,-19,B
mupdegrove 2008.07.03,1022,1,0.5,10,266,20,-246,A
mupdegrove 2008.07.03,1022,1,0.5,10,247,20,-227,B
DEDEE 2008.05.19,1014,1,1,19,73,42,-31,A
DEDEE 2008.05.19,1014,1,1,19,69,58,-11,B
kreukels 2008.05.19,977,1,0,22,175,32,-143,A
kreukels 2008.05.19,977,1,0,22,175,32,-143,B
chessrazz 2008.07.05,1065,1,0,13,287,23,-264,A
chessrazz 2008.07.05,1065,1,0,13,299,15,-284,B
philsolness 2008.06.23,911,1,0,7,230,43,-187,A
philsolness 2008.06.23,911,1,0,7,253,43,-210,B
DEDEE 2008.06.23,1055,1,1,7,96,57,-39,A
DEDEE 2008.06.23,1055,1,1,7,110,57,-53,B
kreukels 2008.06.16,923,1,0,19,122,16,-106,A
kreukels 2008.06.16,923,1,0,19,118,16,-102,B
redtube 2008.06.16,1073,1,1,18,48,44,-4,A
redtube 2008.06.16,1073,1,1,18,50,28,-22,B
LaurentDelaon 2008.06.13,1058,1,1,3,85,0,-85,A
LaurentDelaon 2008.06.13,1058,1,1,3,56,33,-23,B
Kyujoo 2008.06.13,910,1,0,5,409,20,-389,A
Kyujoo 2008.06.13,910,1,0,5,332,20,-312,B
dukemono 2008.05.29,1075,1,1,7,93,14,-79,A
dukemono 2008.05.29,1075,1,1,7,85,14,-71,B
tfrio 2008.06.15,854,1,0,11,204,27,-177,A
tfrio 2008.06.15,854,1,0,11,193,27,-166,B
FranckFabozi 2008.06.15,1137,1,1,3,216,33,-183,A
FranckFabozi 2008.06.15,1137,1,1,3,68,33,-35,B
pendaggie 2008.06.07,839,1,0,18,256,33,-223,A
pendaggie 2008.06.07,839,1,0,18,258,33,-225,B
MELUCHA 2008.06.07,1131,1,1,19,308,32,-276,A
MELUCHA 2008.06.07,1131,1,1,19,294,32,-262,B
KarimNicho 2008.06.06,873,1,1,39,247,26,-221,A
KarimNicho 2008.06.06,873,1,1,39,250,20,-230,B
mjwadams 2008.06.06,1020,1,0,38,265,18,-247,A
mjwadams 2008.06.06,1020,1,0,38,283,24,-259,B
SkietSkijf 2008.06.14,1056,1,1,11,171,55,-116,A
SkietSkijf 2008.06.14,1056,1,1,11,120,54,-66,B
SviSe 2008.06.14,889,1,0,12,241,33,-208,A
SviSe 2008.06.14,889,1,0,12,240,25,-215,B
santai 2008.06.02,989,2,2,32,97,41,-56,A
santai 2008.06.02,989,2,2,32,90,38,-52,B
bandicot 2008.06.02,901,2,0,34,157,18,-139,A
bandicot 2008.06.02,901,2,0,34,159,21,-138,B
bongocat 2008.05.09,1130,1,0,10,262,30,-232,A
bongocat 2008.05.09,1130,1,0,10,259,30,-229,B
deckedm 2008.05.09,857,1,1,8,71,38,-33,A
deckedm 2008.05.09,857,1,1,8,78,38,-40,B
tomerzarfaty 2008.04.21,1054,1,0,36,224,36,-188,A
tomerzarfaty 2008.04.21,1054,1,0,36,227,39,-188,B
ifalou 2008.04.21,832,1,1,33,161,33,-128,A
ifalou 2008.04.21,832,1,1,33,164,33,-131,B
metallichristian 2008.06.06,848,1,1,6,112,33,-79,A
metallichristian 2008.06.06,848,1,1,6,102,33,-69,B
santai 2008.06.06,1081,1,0,6,216,50,-166,A
santai 2008.06.06,1081,1,0,6,202,50,-152,B
bcoffield 2008.06.18,908,1,1,6,124,50,-74,A
bcoffield 2008.06.18,908,1,1,6,140,50,-90,B
paulgrahi 2008.06.18,1043,1,0,6,347,33,-314,A
paulgrahi 2008.06.18,1043,1,0,6,354,33,-321,B
paperchasdvincent 2008.05.24,1046,1,1,9,192,0,-192,A
paperchasdvincent 2008.05.24,1046,1,1,9,186,0,-186,B
smaiurana 2008.05.24,916,1,0,9,316,0,-316,A
smaiurana 2008.05.24,916,1,0,9,326,0,-326,B
MXseptimus 2008.04.18,882,2,0,30,282,23,-259,A
MXseptimus 2008.04.18,882,2,0,30,285,27,-258,B
bangs 2008.04.18,1098,2,2,24,187,33,-154,A
bangs 2008.04.18,1098,2,2,24,129,42,-87,B
tomerzarfaty 2008.04.08,1056,1,1,21,122,43,-79,A
tomerzarfaty 2008.04.08,1056,1,1,21,107,48,-59,B
lynnyx 2008.04.08,940,1,0,28,158,36,-122,A
lynnyx 2008.04.08,940,1,0,28,153,32,-121,B
FranckFabozi 2008.06.11,1146,1,1,16,71,38,-33,A
FranckFabozi 2008.06.11,1146,1,1,16,89,38,-51,B
jaelaw 2008.06.11,807,1,0,22,252,27,-225,A
jaelaw 2008.06.11,807,1,0,22,265,32,-233,B
KaiserPawn 2008.06.04,890,1,0,40,134,38,-96,A
KaiserPawn 2008.06.04,890,1,0,40,172,30,-142,B
StanGetz 2008.06.04,1074,1,1,37,155,41,-114,A
StanGetz 2008.06.04,1074,1,1,37,155,43,-112,B
KarimNicho 2008.05.31,864,1,0,12,234,17,-217,A
KarimNicho 2008.05.31,864,1,0,12,220,25,-195,B
jywhe 2008.05.31,967,1,1,10,144,30,-114,A
jywhe 2008.05.31,967,1,1,10,127,30,-97,B
simmito 2008.05.21,939,1,0,8,313,12,-301,A
simmito 2008.05.21,939,1,0,8,318,25,-293,B
achieve 2008.05.21,1059,1,1,7,183,29,-154,A
achieve 2008.05.21,1059,1,1,7,189,29,-160,B
Birgie 2008.06.06,1011,1,0,33,215,27,-188,A
Birgie 2008.06.06,1011,1,0,33,206,30,-176,B
tabbykt 2008.06.06,987,1,1,33,233,27,-206,A
tabbykt 2008.06.06,987,1,1,33,240,18,-222,B
poos 2008.06.03,934,1,0,13,314,31,-283,A
poos 2008.06.03,934,1,0,13,284,23,-261,B
LaurentDelaon 2008.06.03,1030,1,1,11,220,27,-193,A
LaurentDelaon 2008.06.03,1030,1,1,11,193,27,-166,B
Philipck 2008.05.26,984,1,1,30,161,33,-128,A
Philipck 2008.05.26,984,1,1,30,146,33,-113,B
bandicot 2008.05.26,942,1,0,31,212,36,-176,A
bandicot 2008.05.26,942,1,0,31,191,42,-149,B
IanRedding 2008.05.13,1141,1,0,22,201,36,-165,A
IanRedding 2008.05.13,1141,1,0,22,193,32,-161,B
Derbentli 2008.05.13,847,1,1,21,153,33,-120,A
Derbentli 2008.05.13,847,1,1,21,148,33,-115,B
wangzhewudi 2008.05.07,1065,1,1,9,65,67,2,A
wangzhewudi 2008.05.07,1065,1,1,9,56,56,0,B
deckedm 2008.05.07,908,1,0,13,293,31,-262,A
deckedm 2008.05.07,908,1,0,13,280,38,-242,B
sneakypawn 2008.04.09,900,1,1,26,134,31,-103,A
sneakypawn 2008.04.09,900,1,1,26,149,27,-122,B
Baro 2008.04.09,1090,1,0,31,258,26,-232,A
Baro 2008.04.09,1090,1,0,31,258,23,-235,B
BrunoPereira 2008.05.12,1006,2,1,30,191,40,-151,A
BrunoPereira 2008.05.12,1006,2,1,30,155,47,-108,B
breachy 2008.05.12,932,1,0,23,152,39,-113,A
breachy 2008.05.12,932,1,0,23,182,39,-143,B
Zhoss 2008.05.07,1083,1,1,12,243,33,-210,A
Zhoss 2008.05.07,1083,1,1,12,246,33,-213,B
ChessWurgen 2008.05.07,902,1,0,13,358,31,-327,A
ChessWurgen 2008.05.07,902,1,0,13,372,23,-349,B
vishavnathan 2008.04.10,1001,1,0,22,217,23,-194,A
vishavnathan 2008.04.10,1001,1,0,22,188,27,-161,B
JSGill 2008.04.10,951,1,1,24,167,21,-146,A
JSGill 2008.04.10,951,1,1,24,163,21,-142,B
achieve 2008.04.01,1064,4,3,61,215,41,-174,A
achieve 2008.04.01,1064,4,3,61,214,33,-181,B
simmito 2008.04.01,895,4,1,65,252,28,-224,A
simmito 2008.04.01,895,4,1,65,286,23,-263,B
zhoujin 2008.05.12,930,1,1,3,54,33,-21,A
zhoujin 2008.05.12,930,1,1,3,17,67,50,B
thestephanea 2008.05.12,1127,2,2,14,112,36,-76,A
thestephanea 2008.05.12,1127,2,2,14,124,43,-81,B
BDJ 2008.04.19,1183,1,0,16,264,12,-252,A
BDJ 2008.04.19,1183,1,0,16,279,12,-267,B
Derbentli 2008.04.19,728,1,1,10,280,20,-260,A
Derbentli 2008.04.19,728,1,1,10,258,10,-248,B
josoma 2008.04.03,1097,1,1,7,119,57,-62,A
josoma 2008.04.03,1097,1,1,7,96,43,-53,B
DaveMiddled 2008.04.03,865,1,0,7,271,0,-271,A
DaveMiddled 2008.04.03,865,1,0,7,231,14,-217,B
ziggylucy 2008.05.12,1043,1,0,31,188,32,-156,A
ziggylucy 2008.05.12,1043,1,0,31,219,32,-187,B
Dwaiosez 2008.05.08,945,1,1,34,181,35,-146,A
Dwaiosez 2008.05.08,945,1,1,34,165,38,-127,B
BrunoPereira 2008.05.08,982,1,0,40,325,25,-300,A
BrunoPereira 2008.05.08,982,1,0,40,333,25,-308,B
DEDEE 2008.04.21,1038,2,0,46,245,33,-212,A
DEDEE 2008.04.21,1038,2,0,46,220,22,-198,B
lynnyx 2008.04.21,923,3,2.5,81,126,43,-83,A
lynnyx 2008.04.21,923,3,2.5,81,122,48,-74,B
lowball 2008.04.18,928,3,1,34,314,24,-290,A
lowball 2008.04.18,928,3,1,34,310,24,-286,B
DEDEE 2008.04.18,979,3,2,32,303,19,-284,A
DEDEE 2008.04.18,979,3,2,32,329,22,-307,B
themoor 2008.04.24,1065,1,1,7,100,43,-57,A
themoor 2008.04.24,1065,1,1,7,97,43,-54,B
DaveMiddled 2008.04.24,834,1,0,7,271,29,-242,A
DaveMiddled 2008.04.24,834,1,0,7,299,29,-270,B
Peroble 2008.04.19,1067,1,0.5,5,222,20,-202,A
Peroble 2008.04.19,1067,1,0.5,5,161,20,-141,B
dcook 2008.04.19,844,1,0.5,11,452,0,-452,A
dcook 2008.04.19,844,1,0.5,11,451,0,-451,B
simmito 2008.05.07,927,1,1,28,199,25,-174,A
simmito 2008.05.07,927,1,1,28,196,21,-175,B
achieve 2008.05.07,1034,1,0,28,257,36,-221,A
achieve 2008.05.07,1034,1,0,28,259,32,-227,B
IsoraGaby 2008.04.26,908,1,1,10,263,10,-253,A
IsoraGaby 2008.04.26,908,1,1,10,264,10,-254,B
alderius 2008.04.26,1051,1,0,5,83,40,-43,A
alderius 2008.04.26,1051,1,0,5,69,40,-29,B
Atlante 2008.04.27,934,1,0,17,154,29,-125,A
Atlante 2008.04.27,934,1,0,17,161,29,-132,B
MXseptimus 2008.04.27,1014,1,1,16,100,0,-100,A
MXseptimus 2008.04.27,1014,1,1,16,97,12,-85,B
lowball 2008.04.19,899,2,0,23,231,22,-209,A
lowball 2008.04.19,899,2,0,23,214,26,-188,B
psychodiez 2008.04.19,1034,1,1,8,42,75,33,A
psychodiez 2008.04.19,1034,1,1,8,60,50,-10,B
TastyTreatForKids 2008.04.25,888,1,1,25,128,48,-80,A
TastyTreatForKids 2008.04.25,888,1,1,25,137,44,-93,B
DEDEE 2008.04.25,1021,1,0,26,207,35,-172,A
DEDEE 2008.04.25,1021,1,0,26,218,35,-183,B
lowball 2008.04.20,863,1,0,8,227,25,-202,A
lowball 2008.04.20,863,1,0,8,220,12,-208,B
sevenohnine 2008.04.20,1073,1,1,7,101,29,-72,A
sevenohnine 2008.04.20,1073,1,1,7,84,29,-55,B
Tribune 2008.04.12,956,1,1,19,119,53,-66,A
Tribune 2008.04.12,956,1,1,19,128,37,-91,B
paato 2008.04.12,931,1,0,22,242,9,-233,A
paato 2008.04.12,931,1,0,22,249,14,-235,B
DaveMiddled 2008.04.16,844,1,0.5,16,248,44,-204,A
DaveMiddled 2008.04.16,844,1,0.5,16,203,38,-165,B
sharpempathy 2008.04.16,1067,1,0.5,19,249,21,-228,A
sharpempathy 2008.04.16,1067,1,0.5,19,271,10,-261,B
MXseptimus 2008.04.21,941,1,0.5,29,84,55,-29,A
MXseptimus 2008.04.21,941,1,0.5,29,87,52,-35,B
MXseptimus 2008.04.21,941,1,0.5,29,80,48,-32,C
azertyman 2008.04.08,1127,1,1,25,135,44,-91,A
azertyman 2008.04.08,1127,1,1,25,130,36,-94,B
jinbu 2008.04.08,858,1,0,25,156,36,-120,A
jinbu 2008.04.08,858,1,0,25,156,28,-128,B
osymo 2008.04.19,1037,1,1,14,258,14,-244,A
osymo 2008.04.19,1037,1,1,14,236,14,-222,B
seanwickham 2008.04.12,827,2,2,15,84,40,-44,A
seanwickham 2008.04.12,827,2,2,15,61,40,-21,B
arcticnegro 2008.04.12,1080,1,0,6,117,67,-50,A
arcticnegro 2008.04.12,1080,1,0,6,97,67,-30,B
aussiebattler 2008.04.12,912,1,1,7,172,43,-129,A
aussiebattler 2008.04.12,912,1,1,7,68,43,-25,B
chessup 2008.04.12,1025,1,0,13,269,15,-254,A
chessup 2008.04.12,1025,1,0,13,385,8,-377,B
johnsacko 2008.04.02,973,1,1,19,90,47,-43,A
johnsacko 2008.04.02,973,1,1,19,90,47,-43,B
Dszudszak 2008.04.02,983,1,0,20,185,35,-150,A
Dszudszak 2008.04.02,983,1,0,20,191,35,-156,B
THEREALVONBLUVENS 2008.04.14,936,1,1,6,184,33,-151,A
THEREALVONBLUVENS 2008.04.14,936,1,1,6,202,33,-169,B
Dreamlight 2008.04.14,1012,1,0,6,355,17,-338,A
Dreamlight 2008.04.14,1012,1,0,6,363,17,-346,B
DEDEE 2008.04.02,1039,1,1,9,231,11,-220,A
DEDEE 2008.04.02,1039,1,1,9,244,11,-233,B
lynnyx 2008.04.02,939,1,0,10,362,40,-322,A
lynnyx 2008.04.02,939,1,0,10,367,40,-327,B
vetteboy 2008.03.21,918,1,0,5,447,0,-447,A
vetteboy 2008.03.21,918,1,0,5,464,0,-464,B
josoma 2008.03.21,1048,1,1,3,51,67,16,A
josoma 2008.03.21,1048,1,1,3,56,67,11,B
ddurden 2008.04.13,1149,1,1,8,73,50,-23,A
ddurden 2008.04.13,1149,1,1,8,123,50,-73,B
DaveMiddled 2008.04.13,849,1,0,10,375,0,-375,A
DaveMiddled 2008.04.13,849,1,0,10,373,0,-373,B
vishavnathan 2008.04.04,1092,1,0,17,260,24,-236,A
vishavnathan 2008.04.04,1092,1,0,17,262,29,-233,B
tfrio 2008.04.04,871,1,1,17,401,29,-372,A
tfrio 2008.04.04,871,1,1,17,334,29,-305,B
chessup 2008.03.29,1082,1,1,8,140,0,-140,A
chessup 2008.03.29,1082,1,1,8,167,12,-155,B
vetteboy 2008.03.29,907,1,0,10,250,0,-250,A
vetteboy 2008.03.29,907,1,0,10,274,0,-274,B
JPUng 2008.04.05,986,2,1,21,232,33,-199,A
JPUng 2008.04.05,986,2,1,21,231,33,-198,B
princy 2008.04.05,975,1,0,12,259,17,-242,A
princy 2008.04.05,975,1,0,12,264,25,-239,B
johnsacko 2008.03.17,943,2,1,34,237,24,-213,A
johnsacko 2008.03.17,943,2,1,34,258,24,-234,B
jhnd 2008.03.17,879,1,0,14,319,14,-305,A
jhnd 2008.03.17,879,1,0,14,314,14,-300,B
ScottieD 2008.02.06,983,1,1,5,160,40,-120,A
ScottieD 2008.02.06,983,1,1,5,175,40,-135,B
Whipsnapper 2008.02.06,949,1,0,5,499,0,-499,A
Whipsnapper 2008.02.06,949,1,0,5,493,0,-493,B
vetteboy 2008.04.13,930,1,0,24,199,29,-170,A
vetteboy 2008.04.13,930,1,0,24,219,21,-198,B
paato 2008.04.13,910,2,2,55,159,36,-123,A
paato 2008.04.13,910,2,2,55,150,35,-115,B
Krikke 2008.04.13,1083,1,0,34,221,56,-165,A
Krikke 2008.04.13,1083,1,0,34,220,44,-176,B
savis 2008.04.12,1067,1,0,10,274,10,-264,A
savis 2008.04.12,1067,1,0,10,240,10,-230,B
achieve 2008.04.08,1048,2,0,32,356,25,-331,A
achieve 2008.04.08,1048,2,0,32,359,28,-331,B
simmito 2008.04.08,888,2,2,32,343,31,-312,A
simmito 2008.04.08,888,2,2,32,339,31,-308,B
Daimonion 2008.04.05,998,1,1,12,202,42,-160,A
Daimonion 2008.04.05,998,1,1,12,206,25,-181,B
TheTrooper 2008.04.12,888,1,0.5,51,106,35,-71,A
TheTrooper 2008.04.12,888,1,0.5,51,104,37,-67,B
bangs 2008.04.12,1103,1,0.5,48,95,46,-49,A
bangs 2008.04.12,1103,1,0.5,48,77,42,-35,B
JPUng 2008.04.06,1076,1,0,12,311,8,-303,A
JPUng 2008.04.06,1076,1,0,12,294,17,-277,B
amenophis 2008.04.06,882,1,1,11,190,18,-172,A
amenophis 2008.04.06,882,1,1,11,163,18,-145,B
ChrisAtkinson 2008.04.12,940,1,1,17,151,29,-122,A
ChrisAtkinson 2008.04.12,940,1,1,17,151,29,-122,B
badbadman 2008.04.12,1025,1,0,19,244,16,-228,A
badbadman 2008.04.12,1025,1,0,19,241,21,-220,B
Temppeliaukio 2008.03.30,941,4,1,51,137,26,-111,A
Temppeliaukio 2008.03.30,941,4,1,51,133,26,-107,B
lynnyx 2008.03.30,928,1,1,5,82,40,-42,A
lynnyx 2008.03.30,928,1,1,5,53,40,-13,B
Temppeliaukio 2008.03.26,957,1,0,16,143,50,-93,A
Temppeliaukio 2008.03.26,957,1,0,16,140,38,-102,B
gnavarro 2008.03.26,1005,1,1,17,379,6,-373,A
gnavarro 2008.03.26,1005,1,1,17,365,6,-359,B
aitmedallal 2008.03.15,1013,1,0,7,105,0,-105,A
aitmedallal 2008.03.15,1013,1,0,7,212,29,-183,B
heychee 2008.03.15,960,1,1,3,72,33,-39,A
heychee 2008.03.15,960,1,1,3,36,33,-3,B
Temppeliaukio 2008.03.14,1086,1,1,23,163,35,-128,A
Temppeliaukio 2008.03.14,1086,1,1,23,152,30,-122,B
DaveMiddled 2008.03.14,913,1,0,35,199,31,-168,A
DaveMiddled 2008.03.14,913,1,0,35,210,37,-173,B
simmito 2008.03.11,990,3,1,77,217,30,-187,A
simmito 2008.03.11,990,3,1,77,197,29,-168,B
achieve 2008.03.11,1008,3,2,74,194,31,-163,A
achieve 2008.03.11,1008,3,2,74,181,31,-150,B
seanwickham 2008.04.06,859,1,0,9,179,44,-135,A
seanwickham 2008.04.06,859,1,0,9,157,44,-113,B
achieve 2008.04.06,1050,1,1,9,256,22,-234,A
achieve 2008.04.06,1050,1,1,9,254,22,-232,B
Temppeliaukio 2008.03.28,972,2,0,37,177,22,-155,A
Temppeliaukio 2008.03.28,972,2,0,37,184,22,-162,B
lazysusan 2008.03.28,999,1,1,31,123,39,-84,A
lazysusan 2008.03.28,999,1,1,31,122,42,-80,B
princy 2008.03.12,947,1,1,3,226,67,-159,A
princy 2008.03.12,947,1,1,3,218,33,-185,B
DaveMiddled 2008.03.12,933,1,0,5,708,20,-688,A
DaveMiddled 2008.03.12,933,1,0,5,703,20,-683,B
princy 2008.03.16,931,1,1,11,62,46,-16,A
princy 2008.03.16,931,1,1,11,70,36,-34,B
kodra 2008.03.16,1010,1,0,13,247,23,-224,A
kodra 2008.03.16,1010,1,0,13,200,23,-177,B
seanwickham 2008.03.09,881,1,0,18,194,22,-172,A
seanwickham 2008.03.09,881,1,0,18,202,28,-174,B
markssixtyfour 2008.03.09,1099,1,1,15,48,47,-1,A
markssixtyfour 2008.03.09,1099,1,1,15,53,47,-6,B
vetteboy 2008.03.30,897,1,1,6,200,0,-200,A
vetteboy 2008.03.30,897,1,1,6,208,17,-191,B
jasperpalmer 2008.03.28,1001,1,1,4,146,25,-121,A
jasperpalmer 2008.03.28,1001,1,1,4,106,50,-56,B
achieve 2008.02.26,978,1,1,7,140,0,-140,A
achieve 2008.02.26,978,1,1,7,152,0,-152,B
simmito 2008.02.26,983,1,0,7,236,29,-207,A
simmito 2008.02.26,983,1,0,7,238,29,-209,B
RandyMc 2008.02.20,861,1,0,18,234,11,-223,A
RandyMc 2008.02.20,861,1,0,18,234,28,-206,B
JohnWinthrop 2008.02.20,976,2,1,20,223,50,-173,A
JohnWinthrop 2008.02.20,976,2,1,20,220,40,-180,B
DINOCO 2008.02.15,896,1,1,7,66,29,-37,A
DINOCO 2008.02.15,896,1,1,7,47,43,-4,B
Artmachine 2008.02.15,1019,1,0,7,266,14,-252,A
Artmachine 2008.02.15,1019,1,0,7,253,14,-239,B
Nielow 2008.03.31,1102,1,1,16,164,50,-114,A
Nielow 2008.03.31,1102,1,1,16,178,50,-128,B
tfrio 2008.03.31,895,2,0,39,242,28,-214,A
tfrio 2008.03.31,895,2,0,39,224,33,-191,B
Scumm 2008.03.21,929,1,0,10,196,30,-166,A
Scumm 2008.03.21,929,1,0,10,196,40,-156,B
Krikke 2008.03.21,1065,1,1,7,70,43,-27,A
Krikke 2008.03.21,1065,1,1,7,60,57,-3,B
gfransp 2008.03.14,835,1,0,16,250,13,-237,A
gfransp 2008.03.14,835,1,0,16,251,6,-245,B
henrikx 2008.03.14,1027,1,1,12,156,33,-123,A
henrikx 2008.03.14,1027,1,1,12,150,33,-117,B
xxxyyyxxx 2008.04.06,947,1,1,9,177,11,-166,A
xxxyyyxxx 2008.04.06,947,1,1,9,166,11,-155,B
HerveRenault 2008.04.06,1025,1,0,8,225,12,-213,A
HerveRenault 2008.04.06,1025,1,0,8,218,12,-206,B
Krikke 2008.03.25,1031,2,2,24,136,25,-111,A
Krikke 2008.03.25,1031,2,2,24,127,33,-94,B
DaveMiddled 2008.03.25,881,1,0,9,167,44,-123,A
DaveMiddled 2008.03.25,881,1,0,9,164,33,-131,B
fattylumpkin 2008.04.01,1083,1,1,21,225,38,-187,A
fattylumpkin 2008.04.01,1083,1,1,21,231,33,-198,B
tfrio 2008.04.01,880,1,0,21,258,24,-234,A
tfrio 2008.04.01,880,1,0,21,274,29,-245,B
Temppeliaukio 2008.03.10,1031,1,1,17,89,47,-42,A
Temppeliaukio 2008.03.10,1031,1,1,17,78,47,-31,B
Marcellov 2008.03.10,948,1,0,18,158,22,-136,A
Marcellov 2008.03.10,948,1,0,18,150,22,-128,B
saturnine 2008.03.13,864,2,0,19,240,16,-224,A
saturnine 2008.03.13,864,2,0,19,249,21,-228,B
thestephanea 2008.03.13,1096,1,1,13,166,8,-158,A
thestephanea 2008.03.13,1096,1,1,13,162,15,-147,B
DHamm 2008.03.04,996,1,0.5,11,80,54,-26,A
DHamm 2008.03.04,996,1,0.5,11,85,54,-31,B
WhiteSide 2008.03.04,977,1,0.5,11,170,18,-152,A
WhiteSide 2008.03.04,977,1,0.5,11,166,18,-148,B
ydankner 2008.02.21,1092,1,1,31,198,39,-159,A
ydankner 2008.02.21,1092,1,1,31,209,42,-167,B
johnsacko 2008.02.21,904,2,0,53,193,34,-159,A
johnsacko 2008.02.21,904,2,0,53,195,36,-159,B
Rules 2008.03.30,1066,1,1,10,35,50,15,A
Rules 2008.03.30,1066,1,1,10,31,50,19,B
chessup 2008.03.25,1077,1,0,24,239,33,-206,A
chessup 2008.03.25,1077,1,0,24,213,33,-180,B
bongocat 2008.03.25,886,1,1,24,224,42,-182,A
bongocat 2008.03.25,886,1,1,24,228,29,-199,B
johnsacko 2008.03.24,971,4,2,59,209,20,-189,A
johnsacko 2008.03.24,971,4,2,59,188,15,-173,B
uberkind 2008.03.24,977,3,3,53,146,28,-118,A
uberkind 2008.03.24,977,3,3,53,136,28,-108,B
MrPresto 2008.03.30,1021,1,0,28,120,50,-70,A
MrPresto 2008.03.30,1021,1,0,28,120,54,-66,B
MrPresto 2008.03.30,1021,1,0,28,111,46,-65,C
aussiebattler 2008.03.25,951,1,0,18,337,33,-304,A
aussiebattler 2008.03.25,951,1,0,18,351,33,-318,B
Dszudszak 2008.03.24,915,1,1,18,142,33,-109,A
Dszudszak 2008.03.24,915,1,1,18,154,33,-121,B
JScottDaBoss 2008.03.31,1077,1,1,24,102,46,-56,A
JScottDaBoss 2008.03.31,1077,1,1,24,99,38,-61,B
tfrio 2008.03.24,959,2,0,21,279,24,-255,A
tfrio 2008.03.24,959,2,0,21,242,24,-218,B
direita 2008.04.04,1044,1,1,19,108,37,-71,A
direita 2008.04.04,1044,1,1,19,118,26,-92,B
bongocat 2008.04.04,1030,1,0,22,239,36,-203,A
bongocat 2008.04.04,1030,1,0,22,215,36,-179,B
achieve 2008.03.25,1054,1,1,17,58,24,-34,A
achieve 2008.03.25,1054,1,1,17,61,41,-20,B
simmito 2008.03.25,910,1,0,19,222,32,-190,A
simmito 2008.03.25,910,1,0,19,239,26,-213,B
salius 2008.03.25,1020,1,0,20,287,20,-267,A
salius 2008.03.25,1020,1,0,20,270,20,-250,B
lynnyx 2008.03.25,966,1,1,18,223,22,-201,A
lynnyx 2008.03.25,966,1,1,18,213,22,-191,B
Temppeliaukio 2008.03.27,950,1,1,4,295,0,-295,A
Temppeliaukio 2008.03.27,950,1,1,4,232,0,-232,B
JScottDaBoss 2008.03.27,1036,1,0,6,627,17,-610,A
JScottDaBoss 2008.03.27,1036,1,0,6,450,0,-450,B
lynnyx 2008.03.24,1006,2,0,33,150,45,-105,A
lynnyx 2008.03.24,1006,2,0,33,124,39,-85,B
JohnWinthrop 2008.03.02,953,1,0,24,83,42,-41,A
JohnWinthrop 2008.03.02,953,1,0,24,85,42,-43,B
DHamm 2008.03.02,997,1,1,23,60,35,-25,A
DHamm 2008.03.02,997,1,1,23,61,30,-31,B
lynnyx 2008.03.20,903,1,0,27,208,18,-190,A
lynnyx 2008.03.20,903,1,0,27,207,11,-196,B
DEDEE 2008.03.20,1075,1,1,26,177,19,-158,A
DEDEE 2008.03.20,1075,1,1,26,172,23,-149,B
phenin 2008.03.15,919,1,0.5,44,199,23,-176,A
phenin 2008.03.15,919,1,0.5,44,195,27,-168,B
DaveMiddled 2008.03.15,895,1,0.5,44,190,32,-158,A
DaveMiddled 2008.03.15,895,1,0.5,44,170,36,-134,B
jinbu 2008.03.15,884,1,0,8,207,50,-157,A
jinbu 2008.03.15,884,1,0,8,135,25,-110,B
Bodegroes 2008.03.15,941,1,1,4,11,75,64,A
Bodegroes 2008.03.15,941,1,1,4,0,100,100,B
nerdzrool 2008.03.06,870,1,0,7,151,14,-137,A
nerdzrool 2008.03.06,870,1,0,7,137,14,-123,B
DHamm 2008.03.06,1012,1,1,4,94,50,-44,A
DHamm 2008.03.06,1012,1,1,4,65,25,-40,B
PlainsDrifter 2008.03.04,969,1,1,10,120,20,-100,A
PlainsDrifter 2008.03.04,969,1,1,10,139,20,-119,B
NobleBlade 2008.03.04,947,1,0,10,140,20,-120,A
NobleBlade 2008.03.04,947,1,0,10,133,30,-103,B
subramanyamn 2008.03.01,928,1,1,5,113,20,-93,A
subramanyamn 2008.03.01,928,1,1,5,112,20,-92,B
yackal 2008.03.01,1051,1,0,5,317,20,-297,A
yackal 2008.03.01,1051,1,0,5,331,0,-331,B
Artmachine 2008.03.21,1064,1,1,20,110,30,-80,A
Artmachine 2008.03.21,1064,1,1,20,117,30,-87,B
Lucidity 2008.03.21,869,1,0,20,171,25,-146,A
Lucidity 2008.03.21,869,1,0,20,162,35,-127,B
Dreamlight 2008.03.20,999,1,0,13,244,8,-236,A
Dreamlight 2008.03.20,999,1,0,13,244,0,-244,B
colonelcam 2008.03.20,986,1,1,12,220,25,-195,A
colonelcam 2008.03.20,986,1,1,12,212,33,-179,B
dewie 2008.03.19,925,1,0,6,212,50,-162,A
dewie 2008.03.19,925,1,0,6,230,50,-180,B
hebrewbrain 2008.03.19,833,1,1,7,441,14,-427,A
hebrewbrain 2008.03.19,833,1,1,7,452,14,-438,B
DEDEE 2008.03.21,1074,2,2,50,152,34,-118,A
DEDEE 2008.03.21,1074,2,2,50,154,36,-118,B
jhnd 2008.03.21,769,2,0,51,211,31,-180,A
jhnd 2008.03.21,769,2,0,51,196,29,-167,B
stabinandmoley 2008.03.18,1006,1,1,15,104,33,-71,A
stabinandmoley 2008.03.18,1006,1,1,15,75,40,-35,B
Dszudszak 2008.03.18,970,1,0,19,188,5,-183,A
Dszudszak 2008.03.18,970,1,0,19,167,10,-157,B
bigdawgdude 2008.03.06,1043,1,1,7,141,29,-112,A
bigdawgdude 2008.03.06,1043,1,1,7,178,29,-149,B
princy 2008.03.06,952,1,0,7,267,29,-238,A
princy 2008.03.06,952,1,0,7,312,29,-283,B
DHamm 2008.03.13,1088,1,1,4,0,100,100,A
DHamm 2008.03.13,1088,1,1,4,0,100,100,B
colonelcam 2008.03.05,1039,1,0,5,246,0,-246,A
colonelcam 2008.03.05,1039,1,0,5,271,0,-271,B
theridge 2008.03.05,932,1,1,4,64,50,-14,A
theridge 2008.03.05,932,1,1,4,30,75,45,B
cameronbra 2008.03.17,1052,1,1,19,188,26,-162,A
cameronbra 2008.03.17,1052,1,1,19,200,21,-179,B
achieve 2008.02.16,994,1,1,22,161,27,-134,A
achieve 2008.02.16,994,1,1,22,161,27,-134,B
whitestarrnyc 2008.02.16,959,1,0,22,207,23,-184,A
whitestarrnyc 2008.02.16,959,1,0,22,200,36,-164,B
JohnWinthrop 2008.03.14,1026,1,1,16,203,19,-184,A
JohnWinthrop 2008.03.14,1026,1,1,16,223,19,-204,B
zhouzhou 2008.03.14,944,1,0,15,278,13,-265,A
zhouzhou 2008.03.14,944,1,0,15,277,13,-264,B
gfransp 2008.03.10,928,1,0,13,260,15,-245,A
gfransp 2008.03.10,928,1,0,13,261,31,-230,B
stabinandmoley 2008.03.10,965,1,1,12,174,42,-132,A
stabinandmoley 2008.03.10,965,1,1,12,181,42,-139,B
simmito 2008.03.18,968,2,0,32,243,31,-212,A
simmito 2008.03.18,968,2,0,32,203,31,-172,B
achieve 2008.03.18,1018,2,2,27,85,37,-48,A
achieve 2008.03.18,1018,2,2,27,80,37,-43,B
yackal 2008.03.03,1106,2,1,23,229,17,-212,A
yackal 2008.03.03,1106,2,1,23,222,17,-205,B
moibeatle 2008.03.03,864,2,1,21,251,10,-241,A
moibeatle 2008.03.03,864,2,1,21,210,10,-200,B
vetteboy 2008.03.17,938,1,0,19,223,32,-191,A
vetteboy 2008.03.17,938,1,0,19,225,26,-199,B
mikelee 2008.03.17,1057,1,1,21,270,38,-232,A
mikelee 2008.03.17,1057,1,1,21,265,29,-236,B
lynnyx 2008.03.18,830,1,1,6,114,50,-64,A
lynnyx 2008.03.18,830,1,1,6,108,67,-41,B
sdormeus 2008.03.18,1011,1,0,11,357,27,-330,A
sdormeus 2008.03.18,1011,1,0,11,366,27,-339,B
seanwickham 2008.03.13,819,1,1,18,76,33,-43,A
seanwickham 2008.03.13,819,1,1,18,73,39,-34,B
Temppeliaukio 2008.03.13,1114,1,0,18,138,17,-121,A
Temppeliaukio 2008.03.13,1114,1,0,18,142,11,-131,B
nerdzrool 2008.03.10,847,1,0,14,266,14,-252,A
nerdzrool 2008.03.10,847,1,0,14,274,14,-260,B
waxmatiwaxmati 2008.03.10,979,1,1,8,225,12,-213,A
waxmatiwaxmati 2008.03.10,979,1,1,8,194,12,-182,B
frankpid 2008.03.06,831,1,0,17,229,47,-182,A
frankpid 2008.03.06,831,1,0,17,237,41,-196,B
Caduceus 2008.03.06,1121,1,1,22,349,36,-313,A
Caduceus 2008.03.06,1121,1,1,22,318,36,-282,B
maravich 2008.02.25,996,1,0,13,285,23,-262,A
maravich 2008.02.25,996,1,0,13,272,23,-249,B
WhiteSide 2008.02.25,973,1,1,11,154,36,-118,A
WhiteSide 2008.02.25,973,1,1,11,143,36,-107,B
FollyFrog 2008.02.24,875,1,1,11,140,27,-113,A
FollyFrog 2008.02.24,875,1,1,11,162,27,-135,B
yackal 2008.02.24,1057,1,0,11,268,27,-241,A
yackal 2008.02.24,1057,1,0,11,306,0,-306,B
lesterjack 2008.03.10,932,1,0,10,241,20,-221,A
lesterjack 2008.03.10,932,1,0,10,241,40,-201,B
Krikke 2008.03.10,1030,1,1,9,87,44,-43,A
Krikke 2008.03.10,1030,1,1,9,138,33,-105,B
louiswei 2008.03.03,999,1,0,33,98,27,-71,A
louiswei 2008.03.03,999,1,0,33,91,30,-61,B
Shatranzi 2008.03.03,988,1,1,36,124,39,-85,A
Shatranzi 2008.03.03,988,1,1,36,125,33,-92,B
drunkenmonkey 2008.02.15,1004,1,1,19,173,37,-136,A
drunkenmonkey 2008.02.15,1004,1,1,19,225,37,-188,B
WhiteSide 2008.02.15,958,2,1,33,172,33,-139,A
WhiteSide 2008.02.15,958,2,1,33,200,42,-158,B
DEDEE 2008.02.11,974,1,1,21,232,33,-199,A
DEDEE 2008.02.11,974,1,1,21,257,29,-228,B
SanderDee 2008.02.11,1000,1,0,20,254,25,-229,A
SanderDee 2008.02.11,1000,1,0,20,229,30,-199,B
viaaurea 2008.03.03,915,1,1,27,84,41,-43,A
viaaurea 2008.03.03,915,1,1,27,94,37,-57,B
Chrisasdf 2008.03.03,1066,1,0,28,187,29,-158,A
Chrisasdf 2008.03.03,1066,1,0,28,190,25,-165,B
moibeatle 2008.03.05,976,2,1,25,138,20,-118,A
moibeatle 2008.03.05,976,2,1,25,133,28,-105,B
waxmatiwaxmati 2008.03.05,996,1,0,4,292,0,-292,A
waxmatiwaxmati 2008.03.05,996,1,0,4,324,0,-324,B
louiswei 2008.03.05,980,1,1,20,102,50,-52,A
louiswei 2008.03.05,980,1,1,20,91,55,-36,B
louiswei 2008.03.05,980,1,1,20,98,55,-43,C
johnsacko 2008.03.02,952,1,0,18,342,6,-336,A
johnsacko 2008.03.02,952,1,0,18,369,6,-363,B
vetteboy 2008.03.02,944,1,1,17,284,12,-272,A
vetteboy 2008.03.02,944,1,1,17,308,18,-290,B
nelb 2008.02.19,959,2,2,60,110,27,-83,A
nelb 2008.02.19,959,2,2,60,106,28,-78,B
DHamm 2008.02.19,1012,2,0,61,180,26,-154,A
DHamm 2008.02.19,1012,2,0,61,167,26,-141,B
Krikke 2008.02.29,1030,1,0,7,214,29,-185,A
Krikke 2008.02.29,1030,1,0,7,236,29,-207,B
kyleelhs 2008.02.29,946,1,1,3,87,0,-87,A
kyleelhs 2008.02.29,946,1,1,3,100,0,-100,B
lpalossy 2008.02.21,955,1,1,24,192,29,-163,A
lpalossy 2008.02.21,955,1,1,24,178,38,-140,B
nelb 2008.03.04,972,1,0,16,174,25,-149,A
nelb 2008.03.04,972,1,0,16,167,19,-148,B
Temppeliaukio 2008.03.04,1019,1,1,15,96,27,-69,A
Temppeliaukio 2008.03.04,1019,1,1,15,95,33,-62,B
johnsacko 2008.02.17,894,4,1,39,264,26,-238,A
johnsacko 2008.02.17,894,4,1,39,236,26,-210,B
Bottledwater 2008.02.17,1046,1,1,5,32,40,8,A
Bottledwater 2008.02.17,1046,1,1,5,43,40,-3,B
WhiteSide 2008.02.08,908,1,0,6,352,33,-319,A
WhiteSide 2008.02.08,908,1,0,6,347,33,-314,B
mattbarber 2008.02.08,1054,1,1,3,74,33,-41,A
mattbarber 2008.02.08,1054,1,1,3,81,33,-48,B
thebrickwall 2008.01.09,978,4,2,48,217,31,-186,A
thebrickwall 2008.01.09,978,4,2,48,219,29,-190,B
louiswei 2008.01.09,1008,2,0,52,144,35,-109,A
louiswei 2008.01.09,1008,2,0,52,149,31,-118,B
SanderDee 2008.02.29,919,1,0,19,300,21,-279,A
SanderDee 2008.02.29,919,1,0,19,309,26,-283,B
Aeroplanes 2008.02.29,1036,1,1,17,247,41,-206,A
Aeroplanes 2008.02.29,1036,1,1,17,217,29,-188,B
moibeatle 2008.03.04,928,1,1,28,163,36,-127,A
moibeatle 2008.03.04,928,1,1,28,178,39,-139,B
stabinandmoley 2008.03.04,989,1,0,33,263,15,-248,A
stabinandmoley 2008.03.04,989,1,0,33,272,18,-254,B
paperchasdvincent 2008.01.01,964,2,1.5,52,229,29,-200,A
paperchasdvincent 2008.01.01,964,2,1.5,52,227,31,-196,B
Artmachine 2008.01.01,1003,1,0,21,186,29,-157,A
Artmachine 2008.01.01,1003,1,0,21,184,43,-141,B
pendaggie 2008.02.15,1024,1,0,14,238,21,-217,A
pendaggie 2008.02.15,1024,1,0,14,236,29,-207,B
stabinandmoley 2008.02.15,942,1,1,12,141,33,-108,A
stabinandmoley 2008.02.15,942,1,1,12,96,33,-63,B
FollyFrog 2008.02.23,865,2,0.5,49,213,25,-188,A
FollyFrog 2008.02.23,865,2,0.5,49,230,20,-210,B
mray 2008.02.23,1033,1,1,11,64,36,-28,A
mray 2008.02.23,1033,1,1,11,63,36,-27,B
DHamm 2008.02.23,983,1,0,18,165,33,-132,A
DHamm 2008.02.23,983,1,0,18,198,22,-176,B
Krikke 2008.02.23,1015,1,1,18,122,33,-89,A
Krikke 2008.02.23,1015,1,1,18,107,39,-68,B
markssixtyfour 2008.02.25,1105,1,1,11,57,54,-3,A
markssixtyfour 2008.02.25,1105,1,1,11,46,64,18,B
johnsacko 2008.02.25,882,1,0,11,187,18,-169,A
johnsacko 2008.02.25,882,1,0,11,179,18,-161,B
FollyFrog 2008.02.22,892,1,0,23,294,17,-277,A
FollyFrog 2008.02.22,892,1,0,23,266,17,-249,B
yackal 2008.02.22,1036,1,1,8,112,37,-75,A
yackal 2008.02.22,1036,1,1,8,106,25,-81,B
zhouzhou 2008.02.25,915,1,1,8,178,13,-165,A
zhouzhou 2008.02.25,915,1,1,8,197,12,-185,B
paperchasdvincent 2008.02.25,1052,1,0,9,281,33,-248,A
paperchasdvincent 2008.02.25,1052,1,0,9,273,22,-251,B
achieve 2008.02.22,942,1,0,21,223,38,-185,A
achieve 2008.02.22,942,1,0,21,198,33,-165,B
mray 2008.02.22,1032,1,1,20,213,40,-173,A
mray 2008.02.22,1032,1,1,20,183,45,-138,B
johnsacko 2008.02.15,995,1,0,18,220,17,-203,A
johnsacko 2008.02.15,995,1,0,18,207,17,-190,B
KINGRICH 2008.02.20,977,1,1,6,271,33,-238,A
KINGRICH 2008.02.20,977,1,1,6,288,50,-238,B
Chuckccac 2008.02.19,1095,1,1,29,214,28,-186,A
Chuckccac 2008.02.19,1095,1,1,29,214,21,-193,B
RandyMc 2008.02.19,875,1,0,27,278,18,-260,A
RandyMc 2008.02.19,875,1,0,27,290,18,-272,B
vascobimbo 2008.01.24,950,1,1,6,240,50,-190,A
vascobimbo 2008.01.24,950,1,1,6,249,50,-199,B
HammandClov 2008.01.24,978,2,1,17,342,18,-324,A
HammandClov 2008.01.24,978,2,1,17,333,29,-304,B
LaurentDelaon 2008.02.18,1061,1,1,11,208,18,-190,A
LaurentDelaon 2008.02.18,1061,1,1,11,169,27,-142,B
johnsacko 2008.02.18,887,1,0,13,344,31,-313,A
johnsacko 2008.02.18,887,1,0,13,328,31,-297,B
WhiteSide 2008.02.17,962,1,1,17,256,12,-244,A
WhiteSide 2008.02.17,962,1,1,17,256,6,-250,B
louiswei 2008.02.07,1003,1,0,18,234,22,-212,A
louiswei 2008.02.07,1003,1,0,18,214,17,-197,B
Krikke 2008.02.07,995,1,1,14,93,43,-50,A
Krikke 2008.02.07,995,1,1,14,72,43,-29,B
colinman 2008.02.07,989,1,0,7,373,14,-359,A
colinman 2008.02.07,989,1,0,7,381,14,-367,B
Whipsnapper 2008.02.07,960,2,2,14,314,36,-278,A
Whipsnapper 2008.02.07,960,2,2,14,320,36,-284,B
Aydo 2008.02.17,1081,2,1,11,171,27,-144,A
Aydo 2008.02.17,1081,2,1,11,131,18,-113,B
johnsacko 2008.02.23,870,1,0.5,37,176,32,-144,A
johnsacko 2008.02.23,870,1,0.5,37,208,27,-181,B
bangs 2008.03.01,1035,1,1,29,149,28,-121,A
bangs 2008.03.01,1035,1,1,29,151,31,-120,B
PlainsDrifter 2008.03.01,961,1,0,25,105,40,-65,A
PlainsDrifter 2008.03.01,961,1,0,25,111,36,-75,B
JohnWinthrop 2008.02.19,960,2,1.5,21,348,14,-334,A
JohnWinthrop 2008.02.19,960,2,1.5,21,336,24,-312,B
achieve 2008.02.19,970,1,0.5,16,203,44,-159,A
achieve 2008.02.19,970,1,0.5,16,218,38,-180,B
FollyFrog 2008.02.20,894,1,0,12,321,25,-296,A
FollyFrog 2008.02.20,894,1,0,12,308,25,-283,B
mray 2008.02.20,1052,1,1,7,21,71,50,A
mray 2008.02.20,1052,1,1,7,18,57,39,B
sdormeus 2008.02.16,1065,1,0,19,370,26,-344,A
sdormeus 2008.02.16,1065,1,0,19,388,26,-362,B
SanderDee 2008.02.16,900,1,1,17,295,41,-254,A
SanderDee 2008.02.16,900,1,1,17,274,35,-239,B
LarryLido 2008.02.19,1023,1,0,4,14,50,36,A
LarryLido 2008.02.19,1023,1,0,4,39,50,11,B
dewie 2008.02.16,943,1,0.5,50,104,32,-72,A
dewie 2008.02.16,943,1,0.5,50,106,34,-72,B
heychee 2008.02.16,961,1,0.5,46,116,37,-79,A
heychee 2008.02.16,961,1,0.5,46,107,39,-68,B
Caduceus 2008.01.22,1061,1,1,9,331,11,-320,A
Caduceus 2008.01.22,1061,1,1,9,256,22,-234,B
frankpid 2008.01.22,812,1,0,12,502,17,-485,A
frankpid 2008.01.22,812,1,0,12,481,17,-464,B
emorej 2008.02.04,995,2,2,36,79,42,-37,A
emorej 2008.02.04,995,2,2,36,56,42,-14,B
JBChessPontchat 2008.02.04,936,2,0,41,189,37,-152,A
JBChessPontchat 2008.02.04,936,2,0,41,183,32,-151,B
rockyspirit 2008.02.14,878,1,0,19,396,21,-375,A
rockyspirit 2008.02.14,878,1,0,19,237,26,-211,B
NPAV 2008.02.14,1103,1,1,20,263,30,-233,A
NPAV 2008.02.14,1103,1,1,20,241,30,-211,B
DHamm 2008.02.20,974,1,1,20,115,30,-85,A
DHamm 2008.02.20,974,1,1,20,88,25,-63,B
johnsacko 2008.02.20,896,1,0,27,267,18,-249,A
johnsacko 2008.02.20,896,1,0,27,272,18,-254,B
HammandClov 2008.02.01,1102,2,2,17,278,29,-249,A
HammandClov 2008.02.01,1102,2,2,17,290,24,-266,B
stabinandmoley 2008.02.01,905,3,0,47,217,28,-189,A
stabinandmoley 2008.02.01,905,3,0,47,211,26,-185,B
shoving 2008.01.24,906,1,0,12,253,17,-236,A
shoving 2008.01.24,906,1,0,12,234,17,-217,B
RandyMc 2008.02.13,911,1,0,11,271,27,-244,A
RandyMc 2008.02.13,911,1,0,11,238,18,-220,B
stabinandmoley 2008.02.13,812,1,1,9,193,33,-160,A
stabinandmoley 2008.02.13,812,1,1,9,117,22,-95,B
Staindone 2008.02.08,1026,1,1,9,172,22,-150,A
Staindone 2008.02.08,1026,1,1,9,110,22,-88,B
Klewein 2008.02.08,925,1,0,11,293,18,-275,A
Klewein 2008.02.08,925,1,0,11,328,18,-310,B
shoving 2008.01.22,932,1,0,16,152,19,-133,A
shoving 2008.01.22,932,1,0,16,144,12,-132,B
louiswei 2008.01.22,998,1,1,15,103,20,-83,A
louiswei 2008.01.22,998,1,1,15,78,20,-58,B
Turbotank 2008.01.09,937,1,1,33,117,33,-84,A
Turbotank 2008.01.09,937,1,1,33,121,33,-88,B
onetwothreebob 2008.02.07,1004,1,0,6,226,50,-176,A
onetwothreebob 2008.02.07,1004,1,0,6,227,50,-177,B
achieve 2008.01.19,973,2,1,10,223,30,-193,A
achieve 2008.01.19,973,2,1,10,236,30,-206,B
DHamm 2008.01.19,1051,1,0,6,249,33,-216,A
DHamm 2008.01.19,1051,1,0,6,254,33,-221,B
kugatz 2008.01.10,998,1,1,8,209,25,-184,A
kugatz 2008.01.10,998,1,1,8,206,38,-168,B
thebrickwall 2008.01.10,956,1,0,8,344,38,-306,A
thebrickwall 2008.01.10,956,1,0,8,324,38,-286,B
nirt 2008.02.12,1144,1,0,13,156,31,-125,A
nirt 2008.02.12,1144,1,0,13,141,31,-110,B
jdlibbey 2008.02.12,836,1,1,12,64,42,-22,A
jdlibbey 2008.02.12,836,1,1,12,68,42,-26,B
arifabesha 2008.01.24,1039,1,0,21,207,19,-188,A
arifabesha 2008.01.24,1039,1,0,21,187,29,-158,B
DINOCO 2008.01.24,853,1,1,19,126,21,-105,A
DINOCO 2008.01.24,853,1,1,19,112,21,-91,B
ephraimhanks 2008.01.09,1008,1,1,4,93,50,-43,A
ephraimhanks 2008.01.09,1008,1,1,4,107,50,-57,B
DINOCO 2008.01.12,871,1,0,11,213,18,-195,A
DINOCO 2008.01.12,871,1,0,11,128,27,-101,B
BurtForFun 2008.01.12,1122,1,1,9,99,33,-66,A
BurtForFun 2008.01.12,1122,1,1,9,91,33,-58,B
thebrickwall 2008.01.02,970,2,2,97,107,51,-56,A
thebrickwall 2008.01.02,970,2,2,97,107,52,-55,B
thebrickwall 2008.01.02,970,2,2,97,102,52,-50,C
paperchasdvincent 2008.01.02,1027,1,0,35,109,29,-80,A
paperchasdvincent 2008.01.02,1027,1,0,35,118,34,-84,B
paperchasdvincent 2008.01.02,1027,1,0,35,110,37,-73,C
TJPOT 2008.01.28,1149,1,1,3,359,0,-359,A
TJPOT 2008.01.28,1149,1,1,3,324,0,-324,B
aresquibel 2008.01.28,844,1,0,6,808,0,-808,A
aresquibel 2008.01.28,844,1,0,6,782,0,-782,B
Kayode 2008.02.01,943,1,1,19,109,47,-62,A
Kayode 2008.02.01,943,1,1,19,122,53,-69,B
ckchessmaster 2008.02.07,1107,1,0,31,281,26,-255,A
ckchessmaster 2008.02.07,1107,1,0,31,252,19,-233,B
WhiteSide 2008.02.07,807,1,1,29,226,24,-202,A
WhiteSide 2008.02.07,807,1,1,29,196,24,-172,B
arcarsenal 2008.02.01,1153,1,1,15,169,27,-142,A
arcarsenal 2008.02.01,1153,1,1,15,157,40,-117,B
aresquibel 2008.02.01,794,1,0,15,215,20,-195,A
aresquibel 2008.02.01,794,1,0,15,209,7,-202,B
JBChessPontchat 2008.01.29,1006,1,1,50,128,30,-98,A
JBChessPontchat 2008.01.29,1006,1,1,50,124,30,-94,B
Caledonian 2008.01.29,853,1,0,51,162,14,-148,A
Caledonian 2008.01.29,853,1,0,51,155,20,-135,B
kfrumDABAY 2008.01.08,939,1,0,9,96,56,-40,A
kfrumDABAY 2008.01.08,939,1,0,9,101,56,-45,B
thebrickwall 2008.01.08,969,1,1,10,236,40,-196,A
thebrickwall 2008.01.08,969,1,1,10,234,30,-204,B
HammandClov 2008.01.31,1087,1,1,24,57,54,-3,A
HammandClov 2008.01.31,1087,1,1,24,54,38,-16,B
rockyspirit 2008.01.31,898,1,0,28,169,29,-140,A
rockyspirit 2008.01.31,898,1,0,28,152,32,-120,B
badsilva 2008.01.28,1010,1,1,18,141,28,-113,A
badsilva 2008.01.28,1010,1,1,18,143,28,-115,B
zhouzhou 2008.01.28,934,1,0,19,207,37,-170,A
zhouzhou 2008.01.28,934,1,0,19,233,21,-212,B
paperchasdvincent 2008.01.12,1008,1,1,10,112,10,-102,A
paperchasdvincent 2008.01.12,1008,1,1,10,105,30,-75,B
thebrickwall 2008.01.12,950,4,3,40,197,23,-174,A
thebrickwall 2008.01.12,950,4,3,40,199,22,-177,B
jdlibbey 2008.02.08,901,1,0,11,283,18,-265,A
jdlibbey 2008.02.08,901,1,0,11,305,18,-287,B
Artmachine 2008.02.08,1003,1,1,13,466,15,-451,A
Artmachine 2008.02.08,1003,1,1,13,464,15,-449,B
chadmhall 2008.01.12,990,2,0,20,320,20,-300,A
chadmhall 2008.01.12,990,2,0,20,303,15,-288,B
prodigiousbusines 2008.01.26,1032,1,1,13,336,23,-313,A
prodigiousbusines 2008.01.26,1032,1,1,13,332,23,-309,B
Whipsnapper 2008.01.26,961,1,0,13,450,15,-435,A
Whipsnapper 2008.01.26,961,1,0,13,415,8,-407,B
frankpid 2008.01.09,856,1,0,10,382,10,-372,A
frankpid 2008.01.09,856,1,0,10,406,10,-396,B
wackum 2008.01.05,986,1,1,14,207,0,-207,A
wackum 2008.01.05,986,1,1,14,215,7,-208,B
ippat 2008.01.05,1013,1,0,15,312,20,-292,A
ippat 2008.01.05,1013,1,0,15,316,33,-283,B
Bottledwater 2008.02.11,1132,1,0.5,42,55,36,-19,A
Bottledwater 2008.02.11,1132,1,0.5,42,46,36,-10,B
DINOCO 2008.02.11,845,1,0.5,41,120,34,-86,A
DINOCO 2008.02.11,845,1,0.5,41,88,34,-54,B
ippat 2008.01.19,1000,1,1,4,315,0,-315,A
ippat 2008.01.19,1000,1,1,4,371,0,-371,B
Raicore 2008.01.30,987,1,1,29,129,45,-84,A
Raicore 2008.01.30,987,1,1,29,138,38,-100,B
Raicore 2008.01.30,987,1,1,29,144,41,-103,C
luoyun 2008.01.30,886,1,0,26,167,54,-113,A
luoyun 2008.01.30,886,1,0,26,126,54,-72,B
luoyun 2008.01.30,886,1,0,26,133,54,-79,C
kfrumDABAY 2008.01.09,915,1,1,16,191,12,-179,A
kfrumDABAY 2008.01.09,915,1,1,16,181,25,-156,B
jinbu 2008.01.24,867,1,0,39,126,23,-103,A
jinbu 2008.01.24,867,1,0,39,119,26,-93,B
aleksthegreat 2008.01.24,1112,1,1,39,134,26,-108,A
aleksthegreat 2008.01.24,1112,1,1,39,124,26,-98,B
luoyun 2008.01.14,940,1,0,17,322,12,-310,A
luoyun 2008.01.14,940,1,0,17,317,12,-305,B
paperchasdvincent 2008.01.14,1020,1,1,12,100,50,-50,A
paperchasdvincent 2008.01.14,1020,1,1,12,58,58,0,B
prodigiousbusines 2008.01.12,1039,1,0,15,174,40,-134,A
prodigiousbusines 2008.01.12,1039,1,0,15,198,40,-158,B
grsshppr 2008.01.27,854,1,1,31,79,48,-31,A
grsshppr 2008.01.27,854,1,1,31,74,42,-32,B
grsshppr 2008.01.27,854,1,1,31,86,39,-47,C
skix 2008.01.27,1125,1,0,32,150,63,-87,A
skix 2008.01.27,1125,1,0,32,124,53,-71,B
skix 2008.01.27,1125,1,0,32,131,44,-87,C
jokersplay 2008.01.02,1058,1,0,10,183,70,-113,A
jokersplay 2008.01.02,1058,1,0,10,166,70,-96,B
TimoK 2008.01.02,900,1,1,16,484,38,-446,A
TimoK 2008.01.02,900,1,1,16,528,25,-503,B
DINOCO 2008.01.07,890,1,0,21,386,10,-376,A
DINOCO 2008.01.07,890,1,0,21,372,10,-362,B
sevenohnine 2008.01.07,1069,1,1,16,247,25,-222,A
sevenohnine 2008.01.07,1069,1,1,16,224,25,-199,B
frankpid 2008.01.02,912,1,0,35,398,20,-378,A
frankpid 2008.01.02,912,1,0,35,395,14,-381,B
frankpid 2008.01.02,912,1,0,35,395,14,-381,C
DINOCO 2008.01.10,882,1,0,22,199,14,-185,A
DINOCO 2008.01.10,882,1,0,22,245,18,-227,B
sevenohnine 2008.01.10,1066,1,1,20,120,40,-80,A
sevenohnine 2008.01.10,1066,1,1,20,157,35,-122,B
thebrickwall 2008.01.01,1004,1,0.5,28,157,39,-118,A
thebrickwall 2008.01.01,1004,1,0.5,28,146,39,-107,B
buddhajuke 2008.01.02,1030,1,1,15,106,40,-66,A
buddhajuke 2008.01.02,1030,1,1,15,125,33,-92,B
Doragon 2008.01.02,967,1,0,17,286,18,-268,A
Doragon 2008.01.02,967,1,0,17,299,18,-281,B
Artmachine 2008.01.05,983,1,1,10,120,30,-90,A
Artmachine 2008.01.05,983,1,1,10,111,20,-91,B
PinkClimax 2008.01.05,977,1,0,11,187,46,-141,A
PinkClimax 2008.01.05,977,1,0,11,190,46,-144,B
pmineiro 2008.09.07,804,1,0,15,316,20,-296,A
pmineiro 2008.09.07,804,1,0,15,299,20,-279,B
achieve 2008.09.07,1072,1,1,13,133,23,-110,A
achieve 2008.09.07,1072,1,1,13,202,23,-179,B
mipsparc 2008.08.24,1044,4,3,73,197,33,-164,A
mipsparc 2008.08.24,1044,4,3,73,178,33,-145,B
lacceroswaldo 2008.08.24,941,4,1,75,199,29,-170,A
lacceroswaldo 2008.08.24,941,4,1,75,188,29,-159,B
lacceroswaldo 2008.08.20,951,3,1,43,298,23,-275,A
lacceroswaldo 2008.08.20,951,3,1,43,280,26,-254,B
mipsparc 2008.08.20,1036,3,2,43,279,28,-251,A
mipsparc 2008.08.20,1036,3,2,43,264,28,-236,B
lacceroswaldo 2008.08.14,969,2,1,13,219,31,-188,A
lacceroswaldo 2008.08.14,969,2,1,13,212,31,-181,B
mipsparc 2008.08.14,1028,2,1,14,348,7,-341,A
mipsparc 2008.08.14,1028,2,1,14,333,14,-319,B
mipsparc 2008.09.02,1014,5,3,61,209,21,-188,A
mipsparc 2008.09.02,1014,5,3,61,207,20,-187,B
lacceroswaldo 2008.09.02,983,5,2,63,201,30,-171,A
lacceroswaldo 2008.09.02,983,5,2,63,185,30,-155,B
pendaggie 2008.08.23,847,1,0,9,285,22,-263,A
pendaggie 2008.08.23,847,1,0,9,293,22,-271,B
Erlanson 2008.08.23,1086,1,1,8,182,38,-144,A
Erlanson 2008.08.23,1086,1,1,8,190,25,-165,B
mipsparc 2008.09.03,1017,4,2.5,71,185,38,-147,A
mipsparc 2008.09.03,1017,4,2.5,71,183,32,-151,B
lacceroswaldo 2008.09.03,980,4,1.5,67,160,36,-124,A
lacceroswaldo 2008.09.03,980,4,1.5,67,132,37,-95,B
lacceroswaldo 2008.08.12,973,2,0,43,250,23,-227,A
lacceroswaldo 2008.08.12,973,2,0,43,229,23,-206,B
mipsparc 2008.08.12,1023,2,2,37,127,41,-86,A
mipsparc 2008.08.12,1023,2,2,37,139,43,-96,B
ozslap 2008.09.04,951,1,0,5,176,20,-156,A
ozslap 2008.09.04,951,1,0,5,188,0,-188,B
mbbane 2008.09.04,1008,1,1,4,79,50,-29,A
mbbane 2008.09.04,1008,1,1,4,72,50,-22,B
marearoja 2008.09.03,941,1,0,14,246,43,-203,A
marearoja 2008.09.03,941,1,0,14,202,29,-173,B
Mladenovic 2008.09.03,977,1,1,13,151,38,-113,A
Mladenovic 2008.09.03,977,1,1,13,146,38,-108,B
SGTMAJUSMC 2008.08.24,838,1,0,8,292,37,-255,A
SGTMAJUSMC 2008.08.24,838,1,0,8,198,25,-173,B
TheRedHood 2008.08.24,1141,1,1,7,39,43,4,A
TheRedHood 2008.08.24,1141,1,1,7,51,43,-8,B
JooBoo 2008.08.20,1019,1,0,10,250,30,-220,A
JooBoo 2008.08.20,1019,1,0,10,135,30,-105,B
marearoja 2008.08.20,901,1,1,13,154,54,-100,A
marearoja 2008.08.20,901,1,1,13,156,54,-102,B
mipsparc 2008.08.11,1006,5,3.5,113,145,35,-110,A
mipsparc 2008.08.11,1006,5,3.5,113,141,29,-112,B
lacceroswaldo 2008.08.11,985,5,1.5,115,184,30,-154,A
lacceroswaldo 2008.08.11,985,5,1.5,115,179,29,-150,B
dockson 2008.08.23,862,1,0,31,191,26,-165,A
dockson 2008.08.23,862,1,0,31,189,26,-163,B
oldchessbook 2008.08.23,1135,1,1,27,132,30,-102,A
oldchessbook 2008.08.23,1135,1,1,27,130,30,-100,B
lacceroswaldo 2008.08.18,972,3,0,51,334,26,-308,A
lacceroswaldo 2008.08.18,972,3,0,51,282,25,-257,B
mipsparc 2008.08.18,1016,3,3,43,151,42,-109,A
mipsparc 2008.08.18,1016,3,3,43,141,44,-97,B
lacceroswaldo 2008.08.15,972,1,1,13,125,46,-79,A
lacceroswaldo 2008.08.15,972,1,1,13,124,31,-93,B
mipsparc 2008.08.15,1025,1,0,13,211,23,-188,A
mipsparc 2008.08.15,1025,1,0,13,190,23,-167,B
Skribble 2008.08.18,869,1,1,15,291,27,-264,A
Skribble 2008.08.18,869,1,1,15,294,27,-267,B
MianMy 2008.08.18,1031,1,0,17,385,24,-361,A
MianMy 2008.08.18,1031,1,0,17,392,24,-368,B
sambang 2008.08.08,1041,1,1,6,65,33,-32,A
sambang 2008.08.08,1041,1,1,6,72,17,-55,B
bhAmco 2008.08.08,890,1,0,5,114,20,-94,A
bhAmco 2008.08.08,890,1,0,5,108,20,-88,B
Silias 2008.12.29,977,1,0,13,238,23,-215,A
Silias 2008.12.29,977,1,0,13,262,23,-239,B
nicksun 2008.12.29,944,1,1,9,51,33,-18,A
nicksun 2008.12.29,944,1,1,9,97,22,-75,B
JabZ 2008.08.17,894,1,0,5,125,40,-85,A
JabZ 2008.08.17,894,1,0,5,111,40,-71,B
zqnzt 2008.08.17,874,2,1,17,153,18,-135,A
zqnzt 2008.08.17,874,2,1,17,154,18,-136,B
lacceroswaldo 2008.08.10,983,3,1,46,221,22,-199,A
lacceroswaldo 2008.08.10,983,3,1,46,186,26,-160,B
mipsparc 2008.08.10,1010,3,2,40,152,42,-110,A
mipsparc 2008.08.10,1010,3,2,40,138,47,-91,B
zqnzt 2008.08.24,870,1,0.5,36,329,19,-310,A
zqnzt 2008.08.24,870,1,0.5,36,334,31,-303,B
Oriontwelve 2008.08.24,1033,1,0.5,25,190,32,-158,A
Oriontwelve 2008.08.24,1033,1,0.5,25,195,28,-167,B
zqnzt 2008.08.20,898,1,0,18,184,33,-151,A
zqnzt 2008.08.20,898,1,0,18,174,33,-141,B
JabZ 2008.08.20,846,1,1,17,94,41,-53,A
JabZ 2008.08.20,846,1,1,17,108,35,-73,B
madjoe 2008.08.08,985,1,0,19,389,16,-373,A
madjoe 2008.08.08,985,1,0,19,365,16,-349,B
theonejanitor 2008.08.08,956,2,1,16,226,6,-220,A
theonejanitor 2008.08.08,956,2,1,16,214,6,-208,B
marearoja 2008.08.19,896,1,0,16,432,25,-407,A
marearoja 2008.08.19,896,1,0,16,393,25,-368,B
JabZ 2008.08.19,827,1,1,13,182,23,-159,A
JabZ 2008.08.19,827,1,1,13,146,23,-123,B
drinkwater 2008.08.01,1013,1,1,4,0,100,100,A
drinkwater 2008.08.01,1013,1,1,4,0,100,100,B
zqnzt 2008.08.01,888,2,0,44,202,34,-168,A
zqnzt 2008.08.01,888,2,0,44,206,32,-174,B
SGTMAJUSMC 2008.08.30,1035,1,0,6,274,17,-257,A
SGTMAJUSMC 2008.08.30,1035,1,0,6,256,17,-239,B
MianMy 2008.08.30,986,1,1,5,142,40,-102,A
MianMy 2008.08.30,986,1,1,5,103,40,-63,B
SGTMAJUSMC 2008.08.23,877,1,0,5,435,0,-435,A
SGTMAJUSMC 2008.08.23,877,1,0,5,427,0,-427,B
darkkknight 2008.08.23,1080,1,1,4,98,75,-23,A
darkkknight 2008.08.23,1080,1,1,4,90,75,-15,B
kanderson 2008.08.07,943,1,0,7,402,0,-402,A
kanderson 2008.08.07,943,1,0,7,329,14,-315,B
viqous 2008.08.07,1024,1,1,6,248,33,-215,A
viqous 2008.08.07,1024,1,1,6,178,33,-145,B
Skribble 2008.08.23,969,1,1,10,226,10,-216,A
Skribble 2008.08.23,969,1,1,10,216,10,-206,B
NaraShikamaru 2008.08.23,912,1,0,11,305,27,-278,A
NaraShikamaru 2008.08.23,912,1,0,11,349,27,-322,B
lacceroswaldo 2008.08.06,966,2,1,42,198,29,-169,A
lacceroswaldo 2008.08.06,966,2,1,42,192,33,-159,B
mipsparc 2008.08.06,1018,2,1,46,172,35,-137,A
mipsparc 2008.08.06,1018,2,1,46,191,33,-158,B
Ghirlando 2008.08.14,934,1,0,10,116,40,-76,A
Ghirlando 2008.08.14,934,1,0,10,129,50,-79,B
oldchessbook 2008.08.14,1006,1,1,12,341,25,-316,A
oldchessbook 2008.08.14,1006,1,1,12,356,25,-331,B
NaraShikamaru 2008.08.11,898,1,0,34,261,26,-235,A
NaraShikamaru 2008.08.11,898,1,0,34,248,26,-222,B
Lucanus 2008.08.11,1083,1,1,32,190,22,-168,A
Lucanus 2008.08.11,1083,1,1,32,180,28,-152,B
takatsugu 2008.08.08,824,1,1,20,209,30,-179,A
takatsugu 2008.08.08,824,1,1,20,194,30,-164,B
Sinickas 2008.08.08,953,2,1,24,232,38,-194,A
Sinickas 2008.08.08,953,2,1,24,170,38,-132,B
Nicdog 2008.08.01,1108,1,1,34,120,47,-73,A
Nicdog 2008.08.01,1108,1,1,34,117,41,-76,B
fishmasters 2008.12.26,808,1,0,23,318,22,-296,A
fishmasters 2008.12.26,808,1,0,23,336,17,-319,B
MohanGH 2008.12.26,1043,1,1,27,408,22,-386,A
MohanGH 2008.12.26,1043,1,1,27,412,22,-390,B
Scrios 2008.08.17,1021,1,1,10,83,30,-53,A
Scrios 2008.08.17,1021,1,1,10,98,30,-68,B
Shagmaster 2008.12.23,1032,1,0,7,271,14,-257,A
Shagmaster 2008.12.23,1032,1,0,7,256,0,-256,B
calexander 2008.12.23,780,5,3,81,166,26,-140,A
calexander 2008.12.23,780,5,3,81,159,25,-134,B
sanavabitch 2008.08.17,1049,1,1,25,121,32,-89,A
sanavabitch 2008.08.17,1049,1,1,25,120,32,-88,B
madjoe 2008.08.17,942,1,0,26,186,15,-171,A
madjoe 2008.08.17,942,1,0,26,181,19,-162,B
Skribble 2008.08.15,841,1,1,10,98,20,-78,A
Skribble 2008.08.15,841,1,1,10,109,20,-89,B
KimN 2008.08.15,1154,1,0,10,109,40,-69,A
KimN 2008.08.15,1154,1,0,10,114,50,-64,B
zqnzt 2008.08.09,863,1,1,8,150,25,-125,A
zqnzt 2008.08.09,863,1,1,8,118,38,-80,B
shaaaft 2008.08.09,953,1,0,8,154,38,-116,A
shaaaft 2008.08.09,953,1,0,8,146,25,-121,B
MianMy 2008.08.08,1039,1,1,5,188,40,-148,A
MianMy 2008.08.08,1039,1,1,5,223,40,-183,B
viqous 2008.08.08,1009,2,1,18,227,22,-205,A
viqous 2008.08.08,1009,2,1,18,196,28,-168,B
pumpbuster 2008.08.05,1119,2,2,21,83,48,-35,A
pumpbuster 2008.08.05,1119,2,2,21,79,52,-27,B
pumpbuster 2008.08.05,1119,2,2,21,71,48,-23,C
isntheaqt 2008.08.05,866,2,0,22,211,23,-188,A
isntheaqt 2008.08.05,866,2,0,22,198,23,-175,B
isntheaqt 2008.08.05,866,2,0,22,198,18,-180,C
Sebbel 2008.08.08,839,2,1,16,161,56,-105,A
Sebbel 2008.08.08,839,2,1,16,74,69,-5,B
plumbo 2008.08.08,964,1,0,7,187,29,-158,A
plumbo 2008.08.08,964,1,0,7,202,29,-173,B
PABOY 2008.12.25,836,1,0.5,29,227,41,-186,A
PABOY 2008.12.25,836,1,0.5,29,225,38,-187,B
nottwoday 2008.12.25,1131,1,0.5,34,320,21,-299,A
nottwoday 2008.12.25,1131,1,0.5,34,334,26,-308,B
JabZ 2008.12.17,953,1,0,10,148,20,-128,A
JabZ 2008.12.17,953,1,0,10,210,20,-190,B
richess 2008.12.17,863,1,1,10,210,40,-170,A
richess 2008.12.17,863,1,1,10,220,50,-170,B
PauloZanol 2008.12.05,984,1,0,10,300,30,-270,A
PauloZanol 2008.12.05,984,1,0,10,215,30,-185,B
PauloZanol 2008.12.05,984,1,0,10,222,20,-202,C
sakarauka 2008.12.05,951,2,2,26,97,62,-35,A
sakarauka 2008.12.05,951,2,2,26,115,54,-61,B
sakarauka 2008.12.05,951,2,2,26,123,50,-73,C
isntheaqt 2008.08.08,843,1,1,23,123,39,-84,A
isntheaqt 2008.08.08,843,1,1,23,118,48,-70,B
pumpbuster 2008.08.08,1142,1,0,24,255,33,-222,A
pumpbuster 2008.08.08,1142,1,0,24,207,33,-174,B
viqous 2008.08.09,1009,1,0,7,249,29,-220,A
viqous 2008.08.09,1009,1,0,7,292,29,-263,B
pmineiro 2008.08.09,791,1,1,5,130,20,-110,A
pmineiro 2008.08.09,791,1,1,5,174,0,-174,B
mipsparc 2008.08.07,1014,2,1,32,263,25,-238,A
mipsparc 2008.08.07,1014,2,1,32,254,22,-232,B
lacceroswaldo 2008.08.07,966,2,1,23,198,22,-176,A
lacceroswaldo 2008.08.07,966,2,1,23,170,26,-144,B
dylanfanatic 2008.07.31,1066,1,1,10,78,40,-38,A
dylanfanatic 2008.07.31,1066,1,1,10,66,30,-36,B
DDJ 2008.07.31,878,1,0,10,257,0,-257,A
DDJ 2008.07.31,878,1,0,10,258,0,-258,B
jasonmyerss 2008.08.02,831,2,1,35,182,37,-145,A
jasonmyerss 2008.08.02,831,2,1,35,170,37,-133,B
haraldr 2008.08.02,1154,1,1,8,112,63,-49,A
haraldr 2008.08.02,1154,1,1,8,120,62,-58,B
lacceroswaldo 2008.12.22,966,3,1,73,193,45,-148,A
lacceroswaldo 2008.12.22,966,3,1,73,184,38,-146,B
mipsparc 2008.12.22,1031,3,2,71,147,31,-116,A
mipsparc 2008.12.22,1031,3,2,71,141,32,-109,B
karilo 2008.08.06,1124,1,1,44,138,34,-104,A
karilo 2008.08.06,1124,1,1,44,131,36,-95,B
vetteboy 2008.08.06,872,1,0,44,176,34,-142,A
vetteboy 2008.08.06,872,1,0,44,157,30,-127,B
mflood 2008.08.07,967,1,1,32,168,44,-124,A
mflood 2008.08.07,967,1,1,32,162,44,-118,B
drinkwater 2008.08.07,1018,1,0,30,160,30,-130,A
drinkwater 2008.08.07,1018,1,0,30,158,33,-125,B
gforced 2008.12.23,876,2,1,30,277,17,-260,A
gforced 2008.12.23,876,2,1,30,268,20,-248,B
ilovepie 2008.12.19,838,2,1,36,225,31,-194,A
ilovepie 2008.12.19,838,2,1,36,223,33,-190,B
madPhysicist 2008.12.19,1150,1,1,10,108,20,-88,A
madPhysicist 2008.12.19,1150,1,1,10,141,10,-131,B
thebrickwall 2007.12.12,984,1,0,10,122,50,-72,A
thebrickwall 2007.12.12,984,1,0,10,123,50,-73,B
Oscoap 2007.12.12,979,1,1,9,70,33,-37,A
Oscoap 2007.12.12,979,1,1,9,59,44,-15,B
nicksun 2008.12.21,945,1,0,8,190,38,-152,A
nicksun 2008.12.21,945,1,0,8,193,25,-168,B
oldchessbook 2008.12.21,1033,1,1,8,188,50,-138,A
oldchessbook 2008.12.21,1033,1,1,8,167,38,-129,B
gaiberner 2008.12.18,1123,1,1,17,263,18,-245,A
gaiberner 2008.12.18,1123,1,1,17,190,29,-161,B
PABOY 2008.12.18,851,2,0,25,244,40,-204,A
PABOY 2008.12.18,851,2,0,25,240,44,-196,B
musick 2008.12.18,842,1,1,5,117,20,-97,A
musick 2008.12.18,842,1,1,5,109,20,-89,B
darumsdad 2008.08.02,1159,1,0,25,223,36,-187,A
darumsdad 2008.08.02,1159,1,0,25,214,36,-178,B
isntheaqt 2008.08.04,875,1,0,17,224,29,-195,A
isntheaqt 2008.08.04,875,1,0,17,238,18,-220,B
pumpbuster 2008.08.04,1122,1,1,16,190,44,-146,A
pumpbuster 2008.08.04,1122,1,1,16,187,25,-162,B
HELENEMARIE 2008.12.29,1186,1,1,15,187,27,-160,A
HELENEMARIE 2008.12.29,1186,1,1,15,179,27,-152,B
Crashinator 2008.12.29,783,2,1,19,257,32,-225,A
Crashinator 2008.12.29,783,2,1,19,256,37,-219,B
licolo 2008.12.23,1096,1,0,15,365,27,-338,A
licolo 2008.12.23,1096,1,0,15,334,27,-307,B
melmothX 2008.12.23,1033,1,1,17,120,18,-102,A
melmothX 2008.12.23,1033,1,1,17,118,12,-106,B
craigzooka 2008.12.16,1073,1,1,9,100,11,-89,A
craigzooka 2008.12.16,1073,1,1,9,83,11,-72,B
Damppu 2008.12.16,987,1,0,10,222,20,-202,A
Damppu 2008.12.16,987,1,0,10,220,20,-200,B
zqnzt 2008.08.04,896,1,0,4,83,50,-33,A
zqnzt 2008.08.04,896,1,0,4,43,50,7,B
LordJesus 2008.08.04,1007,1,1,5,343,0,-343,A
LordJesus 2008.08.04,1007,1,1,5,377,0,-377,B
wontonguy 2008.08.05,1112,1,1,64,269,19,-250,A
wontonguy 2008.08.05,1112,1,1,64,262,20,-242,B
lbwest 2008.08.05,865,1,0,62,229,29,-200,A
lbwest 2008.08.05,865,1,0,62,231,24,-207,B
alexmaxflo 2008.12.14,950,1,1,5,388,0,-388,A
alexmaxflo 2008.12.14,950,1,1,5,420,0,-420,B
mariosaga 2008.12.14,860,1,0,5,497,20,-477,A
mariosaga 2008.12.14,860,1,0,5,532,20,-512,B
Crashinator 2008.12.11,801,1,0,7,334,29,-305,A
Crashinator 2008.12.11,801,1,0,7,337,29,-308,B
jkkcole 2008.12.11,1040,1,1,4,54,75,21,A
jkkcole 2008.12.11,1040,1,1,4,50,50,0,B
Lucanus 2008.08.07,1110,1,0,19,152,42,-110,A
Lucanus 2008.08.07,1110,1,0,19,159,42,-117,B
vetteboy 2008.08.07,863,1,1,25,220,24,-196,A
vetteboy 2008.08.07,863,1,1,25,192,28,-164,B
isntheaqt 2008.08.07,850,1,0,26,233,27,-206,A
isntheaqt 2008.08.07,850,1,0,26,265,27,-238,B
pumpbuster 2008.08.07,1131,1,1,23,171,30,-141,A
pumpbuster 2008.08.07,1131,1,1,23,181,30,-151,B
jkkcole 2008.12.20,981,1,0,22,117,41,-76,A
jkkcole 2008.12.20,981,1,0,22,127,41,-86,B
calexander 2008.12.20,820,2,1,78,111,41,-70,A
calexander 2008.12.20,820,2,1,78,120,38,-82,B
noncsi 2008.12.25,1004,1,1,8,84,50,-34,A
noncsi 2008.12.25,1004,1,1,8,61,50,-11,B
LDopa 2008.12.25,991,1,0,10,223,20,-203,A
LDopa 2008.12.25,991,1,0,10,203,10,-193,B
simmito 2008.12.20,959,3,1,47,170,26,-144,A
simmito 2008.12.20,959,3,1,47,152,26,-126,B
achieve 2008.12.20,1030,3,2,47,120,30,-90,A
achieve 2008.12.20,1030,3,2,47,125,28,-97,B
PABOY 2008.12.30,866,1,0,17,281,29,-252,A
PABOY 2008.12.30,866,1,0,17,266,24,-242,B
markssixtyfour 2008.12.30,1048,1,1,13,161,38,-123,A
markssixtyfour 2008.12.30,1048,1,1,13,126,38,-88,B
noncsi 2008.12.14,943,1,0,14,121,43,-78,A
noncsi 2008.12.14,943,1,0,14,122,43,-79,B
preux 2008.12.14,935,1,1,13,37,54,17,A
preux 2008.12.14,935,1,1,13,39,54,15,B
gforced 2008.10.05,907,1,0,11,338,9,-329,A
gforced 2008.10.05,907,1,0,11,314,9,-305,B
huzar 2008.10.05,1014,1,1,9,196,11,-185,A
huzar 2008.10.05,1014,1,1,9,158,11,-147,B
DHamm 2008.12.22,1079,1,0,20,83,35,-48,A
DHamm 2008.12.22,1079,1,0,20,100,30,-70,B
mariosaga 2008.12.22,840,1,1,21,180,19,-161,A
mariosaga 2008.12.22,840,1,1,21,201,24,-177,B
svenolof 2008.12.23,1074,1,0,26,242,23,-219,A
svenolof 2008.12.23,1074,1,0,26,207,23,-184,B
fishmasters 2008.12.23,917,1,0,18,98,17,-81,A
fishmasters 2008.12.23,917,1,0,18,96,22,-74,B
JabZ 2008.12.23,909,1,1,5,21,60,39,A
JabZ 2008.12.23,909,1,1,5,13,80,67,B
noncsi 2008.12.27,1008,1,0.5,51,47,29,-18,A
noncsi 2008.12.27,1008,1,0.5,51,40,31,-9,B
noncsi 2008.12.27,1008,1,0.5,51,47,33,-14,C
noncsi 2008.12.27,1008,1,0.5,51,44,33,-11,D
zaruda 2008.12.27,976,1,0.5,50,22,14,-8,A
zaruda 2008.12.27,976,1,0.5,50,19,14,-5,B
zaruda 2008.12.27,976,1,0.5,50,21,16,-5,C
zaruda 2008.12.27,976,1,0.5,50,18,16,-2,D
JForce 2008.12.28,987,1,0,9,179,0,-179,A
JForce 2008.12.28,987,1,0,9,178,0,-178,B
Birgie 2008.12.28,924,1,1,9,242,0,-242,A
Birgie 2008.12.28,924,1,1,9,231,0,-231,B
calexander 2008.12.26,979,2,1,23,220,35,-185,A
calexander 2008.12.26,979,2,1,23,213,35,-178,B
JForce 2008.12.26,1009,1,0,11,185,36,-149,A
JForce 2008.12.26,1009,1,0,11,186,46,-140,B
nicksun 2008.12.18,958,1,1,22,139,32,-107,A
nicksun 2008.12.18,958,1,1,22,128,36,-92,B
ilovepie 2008.12.18,865,1,0,25,281,20,-261,A
ilovepie 2008.12.18,865,1,0,25,241,20,-221,B
vetteboy 2008.12.15,931,1,1,39,189,28,-161,A
vetteboy 2008.12.15,931,1,1,39,191,26,-165,B
Jayrec 2008.12.15,981,1,0,42,341,19,-322,A
Jayrec 2008.12.15,981,1,0,42,277,21,-256,B
kampycss 2008.12.28,978,1,1,12,139,25,-114,A
kampycss 2008.12.28,978,1,1,12,111,33,-78,B
kanghyun 2008.12.28,1008,1,0,12,278,8,-270,A
kanghyun 2008.12.28,1008,1,0,12,254,8,-246,B
ValerianSimon 2008.12.27,1155,1,1,10,71,50,-21,A
ValerianSimon 2008.12.27,1155,1,1,10,59,60,1,B
Crashinator 2008.12.27,790,1,0,11,216,27,-189,A
Crashinator 2008.12.27,790,1,0,11,200,27,-173,B
LaurentDelaon 2008.12.26,1050,1,1,13,244,23,-221,A
LaurentDelaon 2008.12.26,1050,1,1,13,225,23,-202,B
Sebbel 2008.12.23,897,1,1,19,67,47,-20,A
Sebbel 2008.12.23,897,1,1,19,49,47,-2,B
LaurentDelaon 2008.12.29,1119,1,0,5,553,20,-533,A
LaurentDelaon 2008.12.29,1119,1,0,5,566,20,-546,B
skillzrfornewbs 2008.12.21,991,1,1,5,0,80,80,A
skillzrfornewbs 2008.12.21,991,1,1,5,0,80,80,B
jacobsthedog 2008.12.21,997,1,0,6,309,17,-292,A
jacobsthedog 2008.12.21,997,1,0,6,332,17,-315,B
DHamm 2008.12.21,1075,1,1,6,72,67,-5,A
DHamm 2008.12.21,1075,1,1,6,40,67,27,B
calexander 2008.12.21,853,4,0,95,198,26,-172,A
calexander 2008.12.21,853,4,0,95,200,27,-173,B
noncsi 2008.12.21,927,1,1,37,120,32,-88,A
noncsi 2008.12.21,927,1,1,37,118,38,-80,B
melmothX 2008.12.21,989,1,1,23,126,35,-91,A
melmothX 2008.12.21,989,1,1,23,138,39,-99,B
Crashinator 2008.12.12,804,1,0,13,166,31,-135,A
Crashinator 2008.12.12,804,1,0,13,184,31,-153,B
Kurkospede 2008.12.12,1144,1,1,8,111,62,-49,A
Kurkospede 2008.12.12,1144,1,1,8,108,50,-58,B
sarabande 2008.12.19,1147,1,0,22,287,36,-251,A
sarabande 2008.12.19,1147,1,0,22,240,27,-213,B
Sebbel 2008.12.21,873,1,1,25,75,72,-3,A
Sebbel 2008.12.21,873,1,1,25,72,60,-12,B
Sebbel 2008.12.21,873,1,1,25,72,60,-12,C
oldchessbook 2008.12.20,1088,1,1,59,112,46,-66,A
oldchessbook 2008.12.20,1088,1,1,59,123,46,-77,B
vetteboy 2008.12.11,907,1,0,14,240,7,-233,A
vetteboy 2008.12.11,907,1,0,14,231,7,-224,B
lesane 2008.12.11,1068,1,1,13,123,31,-92,A
lesane 2008.12.11,1068,1,1,13,124,38,-86,B
gforced 2008.11.22,878,1,0.5,23,201,26,-175,A
gforced 2008.11.22,878,1,0.5,23,203,30,-173,B
shahidul 2008.11.22,1096,1,0.5,22,259,18,-241,A
shahidul 2008.11.22,1096,1,0.5,22,244,14,-230,B
Afjaks 2008.11.02,993,1,1,7,114,29,-85,A
Afjaks 2008.11.02,993,1,1,7,114,14,-100,B
Devdan 2008.11.02,966,1,0,7,310,0,-310,A
Devdan 2008.11.02,966,1,0,7,299,0,-299,B
nicksun 2008.11.24,839,2,2,24,144,46,-98,A
nicksun 2008.11.24,839,2,2,24,160,46,-114,B
ralexander 2008.11.24,912,1,0,17,205,35,-170,A
ralexander 2008.11.24,912,1,0,17,217,29,-188,B
pedrosc 2008.10.23,991,2,2,49,75,35,-40,A
pedrosc 2008.10.23,991,2,2,49,75,35,-40,B
Birgie 2008.10.23,917,2,0,52,141,31,-110,A
Birgie 2008.10.23,917,2,0,52,143,37,-106,B
lapppi 2008.10.16,1090,1,1,8,76,38,-38,A
lapppi 2008.10.16,1090,1,1,8,38,38,0,B
nicksun 2008.10.16,850,1,0,9,316,22,-294,A
nicksun 2008.10.16,850,1,0,9,286,22,-264,B
calexander 2008.12.17,841,1,0,11,256,9,-247,A
calexander 2008.12.17,841,1,0,11,250,18,-232,B
SunRaphi 2008.12.17,984,1,1,9,118,22,-96,A
SunRaphi 2008.12.17,984,1,1,9,115,33,-82,B
mariosaga 2008.12.15,851,1,0,6,295,17,-278,A
mariosaga 2008.12.15,851,1,0,6,281,17,-264,B
calexander 2008.12.15,797,1,1,5,140,20,-120,A
calexander 2008.12.15,797,1,1,5,120,40,-80,B
MementoMoriAB 2008.12.16,983,1,1,37,350,22,-328,A
MementoMoriAB 2008.12.16,983,1,1,37,343,24,-319,B
musick 2008.12.16,868,1,0,29,238,31,-207,A
musick 2008.12.16,868,1,0,29,222,31,-191,B
Crashinator 2008.12.04,796,1,1,18,260,22,-238,A
Crashinator 2008.12.04,796,1,1,18,258,22,-236,B
FishyRats 2008.12.04,1109,1,0,19,362,10,-352,A
FishyRats 2008.12.04,1109,1,0,19,354,16,-338,B
SvartTorn 2008.12.07,1142,1,0,22,275,27,-248,A
SvartTorn 2008.12.07,1142,1,0,22,264,32,-232,B
SvartTorn 2008.12.07,1142,1,0,22,269,32,-237,C
saturnine 2008.12.07,773,1,1,19,177,47,-130,A
saturnine 2008.12.07,773,1,1,19,177,53,-124,B
saturnine 2008.12.07,773,1,1,19,142,53,-89,C
noncsi 2008.12.05,956,1,0,23,324,22,-302,A
noncsi 2008.12.05,956,1,0,23,321,26,-295,B
Hurricaine 2008.12.05,1037,1,1,20,179,25,-154,A
Hurricaine 2008.12.05,1037,1,1,20,233,25,-208,B
nibbio 2008.12.16,1036,1,1,8,77,62,-15,A
nibbio 2008.12.16,1036,1,1,8,65,62,-3,B
salius 2008.12.16,878,1,0,10,344,30,-314,A
salius 2008.12.16,878,1,0,10,342,20,-322,B
Hurricaine 2008.12.04,985,6,3,133,260,25,-235,A
Hurricaine 2008.12.04,985,6,3,133,250,22,-228,B
brainllama 2008.12.04,987,1,0,8,370,12,-358,A
brainllama 2008.12.04,987,1,0,8,303,12,-291,B
Noller 2008.11.30,1126,1,0,12,150,25,-125,A
Noller 2008.11.30,1126,1,0,12,188,8,-180,B
ralexander 2008.11.30,772,3,2,41,131,34,-97,A
ralexander 2008.11.30,772,3,2,41,150,39,-111,B
nicksun 2008.11.28,881,2,2,37,222,14,-208,A
nicksun 2008.11.28,881,2,2,37,226,11,-215,B
kiwa 2008.11.28,1006,2,0,41,222,20,-202,A
kiwa 2008.11.28,1006,2,0,41,226,22,-204,B
ZDIP 2008.11.12,872,1,0,15,129,27,-102,A
ZDIP 2008.11.12,872,1,0,15,125,20,-105,B
pedrosc 2008.11.12,1112,1,1,11,91,27,-64,A
pedrosc 2008.11.12,1112,1,1,11,82,27,-55,B
LDopa 2008.12.12,990,2,1,25,225,32,-193,A
LDopa 2008.12.12,990,2,1,25,216,28,-188,B
calexander 2008.12.12,768,3,1,40,225,25,-200,A
calexander 2008.12.12,768,3,1,40,230,23,-207,B
Crashinator 2008.12.10,781,2,0,23,247,17,-230,A
Crashinator 2008.12.10,781,2,0,23,246,13,-233,B
Checkonetwo 2008.12.10,1189,1,1,8,122,38,-84,A
Checkonetwo 2008.12.10,1189,1,1,8,160,25,-135,B
luizaquino 2008.12.03,1012,1,1,5,153,20,-133,A
luizaquino 2008.12.03,1012,1,1,5,123,20,-103,B
richess 2008.12.03,900,1,0,6,325,0,-325,A
richess 2008.12.03,900,1,0,6,354,33,-321,B
nicksun 2008.12.03,955,1,1,21,130,38,-92,A
nicksun 2008.12.03,955,1,1,21,135,38,-97,B
gforced 2008.12.03,894,1,0,22,221,27,-194,A
gforced 2008.12.03,894,1,0,22,235,32,-203,B
lacceroswaldo 2008.12.03,933,2,2,28,104,57,-47,A
lacceroswaldo 2008.12.03,933,2,2,28,115,50,-65,B
lacceroswaldo 2008.12.03,933,2,2,28,126,39,-87,C
brainllama 2008.12.03,1016,2,0,33,286,24,-262,A
brainllama 2008.12.03,1016,2,0,33,271,24,-247,B
brainllama 2008.12.03,1016,2,0,33,275,21,-254,C
BranimirM 2008.11.26,1072,1,1,10,90,50,-40,A
BranimirM 2008.11.26,1072,1,1,10,95,50,-45,B
salius 2008.11.26,918,1,0,10,272,30,-242,A
salius 2008.11.26,918,1,0,10,275,30,-245,B
PauloZanol 2008.12.02,952,1,0,14,344,14,-330,A
PauloZanol 2008.12.02,952,1,0,14,348,14,-334,B
gforced 2008.12.02,855,1,1,10,191,40,-151,A
gforced 2008.12.02,855,1,1,10,207,20,-187,B
ScottJoplin 2008.12.10,1150,1,1,14,157,29,-128,A
ScottJoplin 2008.12.10,1150,1,1,14,171,29,-142,B
Checkonetwo 2008.11.20,1094,1,1,5,32,60,28,A
Checkonetwo 2008.11.20,1094,1,1,5,22,60,38,B
Crashinator 2008.11.20,843,1,0,4,114,50,-64,A
Crashinator 2008.11.20,843,1,0,4,93,50,-43,B
calexander 2008.12.01,899,2,0,32,231,28,-203,A
calexander 2008.12.01,899,2,0,32,221,25,-196,B
richess 2008.12.01,925,2,1,19,216,32,-184,A
richess 2008.12.01,925,2,1,19,224,32,-192,B
calexander 2008.11.30,1065,1,0,9,145,56,-89,A
calexander 2008.11.30,1065,1,0,9,133,44,-89,B
richess 2008.11.30,922,2,1,19,288,21,-267,A
richess 2008.11.30,922,2,1,19,304,16,-288,B
ralexander 2008.12.12,1030,1,1,18,178,22,-156,A
ralexander 2008.12.12,1030,1,1,18,172,22,-150,B
PauloZanol 2008.12.04,870,5,3,126,257,31,-226,A
PauloZanol 2008.12.04,870,5,3,126,228,29,-199,B
LDopa 2008.12.01,961,1,1,6,105,33,-72,A
LDopa 2008.12.01,961,1,1,6,141,33,-108,B
ScottJoplin 2008.12.06,1113,1,1,28,65,39,-26,A
ScottJoplin 2008.12.06,1113,1,1,28,67,39,-28,B
richess 2008.12.06,876,1,0,29,124,48,-76,A
richess 2008.12.06,876,1,0,29,142,45,-97,B
richess 2008.12.04,874,1,0.5,8,278,12,-266,A
richess 2008.12.04,874,1,0.5,8,243,12,-231,B
Livvy 2008.12.04,1077,1,0.5,6,129,33,-96,A
Livvy 2008.12.04,1077,1,0.5,6,111,33,-78,B
oldchessbook 2008.11.30,1073,1,1,6,25,83,58,A
oldchessbook 2008.11.30,1073,1,1,6,21,83,62,B
Jacknottheripper 2008.11.18,1087,1,1,13,37,46,9,A
Jacknottheripper 2008.11.18,1087,1,1,13,43,46,3,B
nicksun 2008.11.18,832,1,0,12,107,50,-57,A
nicksun 2008.11.18,832,1,0,12,108,50,-58,B
mariosaga 2008.12.03,870,1,0,29,185,34,-151,A
mariosaga 2008.12.03,870,1,0,29,181,41,-140,B
booxey 2008.12.03,1116,1,1,23,141,35,-106,A
booxey 2008.12.03,1116,1,1,23,147,35,-112,B
Crashinator 2008.11.14,825,2,1,14,211,43,-168,A
Crashinator 2008.11.14,825,2,1,14,191,36,-155,B
dahuigou 2008.11.14,1207,1,0,8,420,0,-420,A
dahuigou 2008.11.14,1207,1,0,8,263,12,-251,B
wolfmoon 2008.10.16,988,1,1,27,336,15,-321,A
wolfmoon 2008.10.16,988,1,1,27,387,11,-376,B
WhiteWarrior 2008.10.16,893,1,0,21,357,5,-352,A
WhiteWarrior 2008.10.16,893,1,0,21,383,5,-378,B
adamfg 2008.11.27,861,1,1,12,111,8,-103,A
adamfg 2008.11.27,861,1,1,12,90,17,-73,B
ddleale 2008.11.27,1094,1,0,13,222,8,-214,A
ddleale 2008.11.27,1094,1,0,13,224,15,-209,B
lacceroswaldo 2008.11.06,982,3,0,40,337,30,-307,A
lacceroswaldo 2008.11.06,982,3,0,40,340,25,-315,B
lacceroswaldo 2008.11.06,982,3,0,40,327,25,-302,C
mipsparc 2008.11.06,1013,3,3,29,97,45,-52,A
mipsparc 2008.11.06,1013,3,3,29,100,52,-48,B
mipsparc 2008.11.06,1013,3,3,29,103,48,-55,C
mipsparc 2008.10.28,1047,3,0,53,221,42,-179,A
mipsparc 2008.10.28,1047,3,0,53,197,42,-155,B
lacceroswaldo 2008.10.28,932,3,3,49,212,37,-175,A
lacceroswaldo 2008.10.28,932,3,3,49,211,35,-176,B
nicksun 2008.11.23,851,1,0,11,292,27,-265,A
nicksun 2008.11.23,851,1,0,11,346,18,-328,B
josephkain 2008.11.23,1026,1,1,6,40,33,-7,A
josephkain 2008.11.23,1026,1,1,6,32,33,1,B
sakarauka 2008.11.06,1072,1,1,4,74,50,-24,A
sakarauka 2008.11.06,1072,1,1,4,67,50,-17,B
bkpbkpbkpbkp 2008.11.06,923,1,0,4,338,0,-338,A
bkpbkpbkpbkp 2008.11.06,923,1,0,4,308,0,-308,B
sakarauka 2008.12.02,993,2,0,9,374,11,-363,A
sakarauka 2008.12.02,993,2,0,9,354,11,-343,B
brainllama 2008.12.02,952,2,2,8,89,50,-39,A
brainllama 2008.12.02,952,2,2,8,84,50,-34,B
Tribune 2008.12.02,951,1,1,11,199,27,-172,A
Tribune 2008.12.02,951,1,1,11,237,18,-219,B
louieshao 2008.12.02,1040,1,0,10,53,60,7,A
louieshao 2008.12.02,1040,1,0,10,40,50,10,B
calexander 2008.12.05,800,1,0,17,101,35,-66,A
calexander 2008.12.05,800,1,0,17,64,41,-23,B
calexander 2008.12.05,800,1,0,17,85,53,-32,C
nicksun 2008.11.30,930,1,0,23,260,17,-243,A
nicksun 2008.11.30,930,1,0,23,284,17,-267,B
gforced 2008.11.30,972,1,0,6,338,17,-321,A
gforced 2008.11.30,972,1,0,6,304,17,-287,B
wumblebumble 2008.11.30,1015,1,1,5,112,60,-52,A
wumblebumble 2008.11.30,1015,1,1,5,66,60,-6,B
noncsi 2008.12.01,950,1,1,17,211,24,-187,A
noncsi 2008.12.01,950,1,1,17,207,24,-183,B
nnoah 2008.11.28,1029,3,2.5,58,129,33,-96,A
nnoah 2008.11.28,1029,3,2.5,58,155,33,-122,B
jasonsonly 2008.11.28,947,3,0.5,65,268,29,-239,A
jasonsonly 2008.11.28,947,3,0.5,65,256,29,-227,B
gforced 2008.12.01,890,1,0,9,212,0,-212,A
gforced 2008.12.01,890,1,0,9,163,0,-163,B
brainllama 2008.12.01,922,2,1,13,179,31,-148,A
brainllama 2008.12.01,922,2,1,13,173,31,-142,B
nicksun 2008.11.16,853,2,0,57,291,32,-259,A
nicksun 2008.11.16,853,2,0,57,260,30,-230,B
hmmy 2008.11.16,1097,1,1,19,137,37,-100,A
hmmy 2008.11.16,1097,1,1,19,142,32,-110,B
krugarius 2008.11.30,892,1,1,8,65,50,-15,A
krugarius 2008.11.30,892,1,1,8,70,50,-20,B
jasonsonly 2008.11.25,869,2,0.5,62,155,34,-121,A
jasonsonly 2008.11.25,869,2,0.5,62,150,31,-119,B
tabbykt 2008.11.25,1036,2,1.5,64,125,28,-97,A
tabbykt 2008.11.25,1036,2,1.5,64,127,28,-99,B
vaportrail 2008.11.29,1131,1,0,15,148,33,-115,A
vaportrail 2008.11.29,1131,1,0,15,157,27,-130,B
PABOY 2008.11.29,823,1,1,16,248,12,-236,A
PABOY 2008.11.29,823,1,1,16,246,6,-240,B
jasonsonly 2008.11.20,881,2,0.5,45,280,18,-262,A
jasonsonly 2008.11.20,881,2,0.5,45,264,18,-246,B
tabbykt 2008.11.20,1033,2,1.5,33,161,21,-140,A
tabbykt 2008.11.20,1033,2,1.5,33,142,27,-115,B
DoctorTommy 2008.12.01,960,1,1,5,170,40,-130,A
DoctorTommy 2008.12.01,960,1,1,5,149,40,-109,B
LibertasProVita 2008.11.30,1034,1,0,17,347,18,-329,A
LibertasProVita 2008.11.30,1034,1,0,17,326,18,-308,B
noncsi 2008.11.30,919,1,1,14,131,50,-81,A
noncsi 2008.11.30,919,1,1,14,189,50,-139,B
Simplicus 2008.10.26,1102,2,2,15,164,27,-137,A
Simplicus 2008.10.26,1102,2,2,15,169,27,-142,B
SchwarzeKatze 2008.10.26,835,2,0,13,249,23,-226,A
SchwarzeKatze 2008.10.26,835,2,0,13,247,31,-216,B
JabZ 2008.10.14,889,1,1,12,47,50,3,A
JabZ 2008.10.14,889,1,1,12,47,50,3,B
WhiteWarrior 2008.10.14,929,1,0,13,161,8,-153,A
WhiteWarrior 2008.10.14,929,1,0,13,154,8,-146,B
jasonsonly 2008.11.27,863,1,1,8,157,38,-119,A
jasonsonly 2008.11.27,863,1,1,8,103,50,-53,B
LKD 2008.11.27,1100,1,0,7,232,29,-203,A
LKD 2008.11.27,1100,1,0,7,171,29,-142,B
Kitanopp 2008.11.24,955,1,0,10,323,10,-313,A
Kitanopp 2008.11.24,955,1,0,10,369,10,-359,B
lucasdawn 2008.11.22,1055,1,0,7,431,14,-417,A
lucasdawn 2008.11.22,1055,1,0,7,434,14,-420,B
nicksun 2008.11.22,823,1,1,3,172,33,-139,A
nicksun 2008.11.22,823,1,1,3,136,33,-103,B
AnotherPawn 2008.11.14,1170,1,1,7,147,14,-133,A
AnotherPawn 2008.11.14,1170,1,1,7,85,43,-42,B
owzat 2008.10.12,740,1,0,23,199,26,-173,A
owzat 2008.10.12,740,1,0,23,206,26,-180,B
hamstartype 2008.10.12,1212,1,1,17,111,47,-64,A
hamstartype 2008.10.12,1212,1,1,17,109,47,-62,B
EndlessWC 2008.10.12,1007,2,2,69,201,26,-175,A
EndlessWC 2008.10.12,1007,2,2,69,200,26,-174,B
vetteboy 2008.10.12,871,1,0,53,138,26,-112,A
vetteboy 2008.10.12,871,1,0,53,136,30,-106,B
Intactive 2008.10.03,971,1,0,15,253,40,-213,A
Intactive 2008.10.03,971,1,0,15,250,27,-223,B
jacquesmoll 2008.10.03,991,1,1,19,374,26,-348,A
jacquesmoll 2008.10.03,991,1,1,19,352,21,-331,B
chrisreeh 2008.11.16,1050,1,1,31,274,26,-248,A
chrisreeh 2008.11.16,1050,1,1,31,249,23,-226,B
billington 2008.11.04,1009,1,1,11,253,36,-217,A
billington 2008.11.04,1009,1,1,11,258,36,-222,B
mariosaga 2008.11.04,876,1,0,10,393,10,-383,A
mariosaga 2008.11.04,876,1,0,10,405,10,-395,B
lacceroswaldo 2008.09.28,969,2,0,21,361,29,-332,A
lacceroswaldo 2008.09.28,969,2,0,21,237,29,-208,B
mipsparc 2008.09.28,1025,2,2,22,221,50,-171,A
mipsparc 2008.09.28,1025,2,2,22,218,45,-173,B
ArtexHarimau 2008.10.04,1032,1,1,18,134,44,-90,A
ArtexHarimau 2008.10.04,1032,1,1,18,93,44,-49,B
BayDragoy 2008.10.04,910,1,0,20,190,50,-140,A
BayDragoy 2008.10.04,910,1,0,20,181,35,-146,B
vulturemort 2008.11.21,964,1,1,18,236,33,-203,A
vulturemort 2008.11.21,964,1,1,18,242,33,-209,B
PABOY 2008.11.21,856,1,0,19,265,16,-249,A
PABOY 2008.11.21,856,1,0,19,290,16,-274,B
vannman 2008.11.24,1109,1,1,22,204,45,-159,A
vannman 2008.11.24,1109,1,1,22,171,46,-125,B
PABOY 2008.11.24,830,1,0,24,282,21,-261,A
PABOY 2008.11.24,830,1,0,24,284,17,-267,B
sobecripa 2008.11.04,896,1,0,11,239,36,-203,A
sobecripa 2008.11.04,896,1,0,11,207,36,-171,B
kwe 2008.11.04,1012,1,1,10,242,50,-192,A
kwe 2008.11.04,1012,1,1,10,232,40,-192,B
WhiteWarrior 2008.10.21,818,1,0.5,12,232,33,-199,A
WhiteWarrior 2008.10.21,818,1,0.5,12,220,33,-187,B
PABOY 2008.10.21,921,1,0.5,9,106,33,-73,A
PABOY 2008.10.21,921,1,0.5,9,103,22,-81,B
salius 2008.11.18,958,1,0,9,313,11,-302,A
salius 2008.11.18,958,1,0,9,299,11,-288,B
ticetice 2008.11.18,985,1,1,7,78,29,-49,A
ticetice 2008.11.18,985,1,1,7,73,43,-30,B
Girdot 2008.11.10,993,1,1,16,56,25,-31,A
Girdot 2008.11.10,993,1,1,16,43,25,-18,B
LDopa 2008.11.10,991,1,0,17,128,18,-110,A
LDopa 2008.11.10,991,1,0,17,130,12,-118,B
LDopa 2008.11.20,971,1,0,17,162,12,-150,A
LDopa 2008.11.20,971,1,0,17,157,18,-139,B
CaptainWooly 2008.11.20,966,1,1,16,148,25,-123,A
CaptainWooly 2008.11.20,966,1,1,16,140,25,-115,B
WildHogSM 2008.10.12,868,2,1,14,403,21,-382,A
WildHogSM 2008.10.12,868,2,1,14,301,29,-272,B
SGTMAJUSMC 2008.10.12,1020,1,0,7,225,14,-211,A
SGTMAJUSMC 2008.10.12,1020,1,0,7,168,14,-154,B
vetteboy 2008.09.18,868,1,1,15,144,33,-111,A
vetteboy 2008.09.18,868,1,1,15,129,33,-96,B
Yokain 2008.09.18,990,1,0,15,230,13,-217,A
Yokain 2008.09.18,990,1,0,15,212,13,-199,B
SkyBrain 2008.11.18,970,1,1,27,192,37,-155,A
SkyBrain 2008.11.18,970,1,1,27,197,37,-160,B
GauiSig 2008.11.18,1023,1,0,23,148,30,-118,A
GauiSig 2008.11.18,1023,1,0,23,123,44,-79,B
nicksun 2008.11.15,814,1,1,8,58,38,-20,A
nicksun 2008.11.15,814,1,1,8,53,50,-3,B
golmman 2008.11.15,1077,1,0,8,217,37,-180,A
golmman 2008.11.15,1077,1,0,8,183,38,-145,B
Uncrowned 2008.11.11,992,1,0,18,129,44,-85,A
Uncrowned 2008.11.11,992,1,0,18,137,28,-109,B
madcardinal 2008.11.11,873,1,1,17,92,29,-63,A
madcardinal 2008.11.11,873,1,1,17,88,35,-53,B
headroad 2008.10.31,1089,1,1,22,215,27,-188,A
headroad 2008.10.31,1089,1,1,22,248,27,-221,B
mariosaga 2008.10.31,838,1,0,29,410,17,-393,A
mariosaga 2008.10.31,838,1,0,29,410,17,-393,B
Ephphatha 2008.01.29,979,1,1,13,259,15,-244,A
Ephphatha 2008.01.29,979,1,1,13,261,15,-246,B
louiswei 2008.01.29,1007,1,0,12,171,42,-129,A
louiswei 2008.01.29,1007,1,0,12,179,42,-137,B
greghyde 2008.09.21,805,2,0,10,631,20,-611,A
greghyde 2008.09.21,805,2,0,10,634,20,-614,B
tamusachess 2008.09.21,1190,2,2,6,202,33,-169,A
tamusachess 2008.09.21,1190,2,2,6,214,33,-181,B
Imbolt 2008.11.16,1153,1,1,33,82,46,-36,A
Imbolt 2008.11.16,1153,1,1,33,88,39,-49,B
JohntheChristian 2008.11.16,846,1,0,34,201,24,-177,A
JohntheChristian 2008.11.16,846,1,0,34,155,26,-129,B
sakarauka 2008.11.11,1011,1,1,18,73,33,-40,A
sakarauka 2008.11.11,1011,1,1,18,98,39,-59,B
rayizmi 2008.11.11,867,1,0,19,190,26,-164,A
rayizmi 2008.11.11,867,1,0,19,196,32,-164,B
CharlesCornner 2008.11.09,1072,1,1,9,40,44,4,A
CharlesCornner 2008.11.09,1072,1,1,9,44,44,0,B
nicksun 2008.11.09,835,1,0,13,213,31,-182,A
nicksun 2008.11.09,835,1,0,13,261,23,-238,B
pmineiro 2008.11.05,880,1,0,17,382,12,-370,A
pmineiro 2008.11.05,880,1,0,17,315,6,-309,B
nnoah 2008.11.05,1053,1,1,14,153,21,-132,A
nnoah 2008.11.05,1053,1,1,14,172,21,-151,B
SchwarzeKatze 2008.10.27,835,2,1,62,285,27,-258,A
SchwarzeKatze 2008.10.27,835,2,1,62,275,27,-248,B
Simplicus 2008.10.27,1102,2,1,52,199,33,-166,A
Simplicus 2008.10.27,1102,2,1,52,192,35,-157,B
karpovasparov 2008.10.07,934,2,2,40,145,25,-120,A
karpovasparov 2008.10.07,934,2,2,40,153,22,-131,B
JabZ 2008.10.07,920,1,0,15,50,40,-10,A
JabZ 2008.10.07,920,1,0,15,43,53,10,B
lacceroswaldo 2008.10.07,942,3,0.5,53,279,40,-239,A
lacceroswaldo 2008.10.07,942,3,0.5,53,283,36,-247,B
mipsparc 2008.10.07,1052,3,2.5,51,275,31,-244,A
mipsparc 2008.10.07,1052,3,2.5,51,262,37,-225,B
huzar 2008.11.10,1072,1,1,4,85,25,-60,A
huzar 2008.11.10,1072,1,1,4,129,25,-104,B
PABOY 2008.11.10,882,1,0,5,465,20,-445,A
PABOY 2008.11.10,882,1,0,5,507,20,-487,B
kiper 2008.11.10,974,1,1,17,153,35,-118,A
kiper 2008.11.10,974,1,1,17,155,35,-120,B
bkpbkpbkpbkp 2008.11.10,1011,1,0,17,184,35,-149,A
bkpbkpbkpbkp 2008.11.10,1011,1,0,17,195,47,-148,B
mariosaga 2008.11.01,823,1,0,7,155,14,-141,A
mariosaga 2008.11.01,823,1,0,7,230,14,-216,B
deermaster 2008.11.01,1159,1,1,5,124,20,-104,A
deermaster 2008.11.01,1159,1,1,5,105,0,-105,B
cazzimeo 2008.10.25,968,1,0,32,136,41,-95,A
cazzimeo 2008.10.25,968,1,0,32,135,44,-91,B
jacquesmoll 2008.10.25,1003,1,1,29,96,48,-48,A
jacquesmoll 2008.10.25,1003,1,1,29,71,48,-23,B
PABOY 2008.10.09,825,1,1,8,120,38,-82,A
PABOY 2008.10.09,825,1,1,8,116,50,-66,B
mateone 2008.10.09,1013,1,0,8,258,12,-246,A
mateone 2008.10.09,1013,1,0,8,250,12,-238,B
LDopa 2008.11.04,990,1,0,13,383,15,-368,A
LDopa 2008.11.04,990,1,0,13,294,23,-271,B
pmineiro 2008.11.04,835,1,1,11,198,45,-153,A
pmineiro 2008.11.04,835,1,1,11,215,46,-169,B
pmineiro 2008.11.02,832,1,0.5,22,200,14,-186,A
pmineiro 2008.11.02,832,1,0.5,22,198,14,-184,B
mariosaga 2008.11.02,854,1,0.5,26,286,23,-263,A
mariosaga 2008.11.02,854,1,0.5,26,324,27,-297,B
thebrickwall 2008.10.30,1092,1,1,10,154,10,-144,A
thebrickwall 2008.10.30,1092,1,1,10,162,10,-152,B
louieshao 2008.10.30,906,1,0,10,213,40,-173,A
louieshao 2008.10.30,906,1,0,10,223,30,-193,B
kwe 2008.11.05,1031,1,1,16,148,44,-104,A
kwe 2008.11.05,1031,1,1,16,141,44,-97,B
leobrazer 2008.11.05,963,1,0,17,203,24,-179,A
leobrazer 2008.11.05,963,1,0,17,249,29,-220,B
milehicheckmater 2008.10.30,994,1,1,9,107,22,-85,A
milehicheckmater 2008.10.30,994,1,1,9,99,22,-77,B
jacquesmoll 2008.10.30,986,1,0,11,196,9,-187,A
jacquesmoll 2008.10.30,986,1,0,11,195,18,-177,B
nicksun 2008.10.25,838,1,0,14,131,29,-102,A
nicksun 2008.10.25,838,1,0,14,141,29,-112,B
SumitNarayan 2008.10.25,996,1,1,9,54,67,13,A
SumitNarayan 2008.10.25,996,1,1,9,40,67,27,B
nicksun 2008.10.26,822,1,0.5,8,221,25,-196,A
nicksun 2008.10.26,822,1,0.5,8,226,12,-214,B
SumitNarayan 2008.10.26,1016,1,0.5,7,110,43,-67,A
SumitNarayan 2008.10.26,1016,1,0.5,7,87,43,-44,B
AJLee 2008.10.22,990,1,1,9,530,11,-519,A
AJLee 2008.10.22,990,1,1,9,422,11,-411,B
WhiteWarrior 2008.10.22,825,1,0,11,544,9,-535,A
WhiteWarrior 2008.10.22,825,1,0,11,491,9,-482,B
LaurentDelaon 2008.10.13,1076,1,1,28,184,32,-152,A
LaurentDelaon 2008.10.13,1076,1,1,28,178,36,-142,B
nicksun 2008.10.13,884,1,0,28,233,36,-197,A
nicksun 2008.10.13,884,1,0,28,223,39,-184,B
Intactive 2008.09.16,943,1,1,18,27,67,40,A
Intactive 2008.09.16,943,1,1,18,24,56,32,B
thewingedweasel 2008.09.16,1010,1,0,17,92,41,-51,A
thewingedweasel 2008.09.16,1010,1,0,17,92,35,-57,B
mariosaga 2008.10.30,917,2,0,19,244,26,-218,A
mariosaga 2008.10.30,917,2,0,19,242,26,-216,B
JooBoo 2008.10.30,923,2,2,17,87,24,-63,A
JooBoo 2008.10.30,923,2,2,17,92,29,-63,B
LDopa 2008.10.28,987,1,0.5,15,240,7,-233,A
LDopa 2008.10.28,987,1,0.5,15,221,13,-208,B
PABOY 2008.10.28,938,1,0.5,14,198,21,-177,A
PABOY 2008.10.28,938,1,0.5,14,186,14,-172,B
smittyohtwohund 2008.10.31,891,1,0.5,41,106,46,-60,A
smittyohtwohund 2008.10.31,891,1,0.5,41,101,44,-57,B
privateschultz 2008.10.31,1096,1,0.5,43,79,49,-30,A
privateschultz 2008.10.31,1096,1,0.5,43,76,44,-32,B
WhiteWarrior 2008.10.19,870,2,0,43,184,19,-165,A
WhiteWarrior 2008.10.19,870,2,0,43,171,21,-150,B
SumitNarayan 2008.10.19,946,1,1,29,146,41,-105,A
SumitNarayan 2008.10.19,946,1,1,29,132,38,-94,B
lacceroswaldo 2008.09.21,957,3,2,88,171,31,-140,A
lacceroswaldo 2008.09.21,957,3,2,88,157,26,-131,B
mipsparc 2008.09.21,1037,3,1,102,185,41,-144,A
mipsparc 2008.09.21,1037,3,1,102,193,35,-158,B
PABOY 2008.10.16,880,1,1,17,266,12,-254,A
PABOY 2008.10.16,880,1,1,17,306,12,-294,B
nottwoday 2008.10.16,1066,1,0,23,474,17,-457,A
nottwoday 2008.10.16,1066,1,0,23,454,13,-441,B
mipsparc 2008.10.04,1044,4,3,65,201,34,-167,A
mipsparc 2008.10.04,1044,4,3,65,207,35,-172,B
lacceroswaldo 2008.10.04,950,4,1,64,251,27,-224,A
lacceroswaldo 2008.10.04,950,4,1,64,251,25,-226,B
nicksun 2008.10.12,904,1,0,9,237,33,-204,A
nicksun 2008.10.12,904,1,0,9,137,33,-104,B
Simplicus 2008.10.11,1087,1,1,12,96,42,-54,A
Simplicus 2008.10.11,1087,1,1,12,106,33,-73,B
SchwarzeKatze 2008.10.11,856,1,0,13,195,23,-172,A
SchwarzeKatze 2008.10.11,856,1,0,13,194,31,-163,B
BlindOsaridSaris 2008.10.07,1023,1,0,23,92,26,-66,A
BlindOsaridSaris 2008.10.07,1023,1,0,23,75,26,-49,B
pmineiro 2008.10.19,792,1,1,14,126,21,-105,A
pmineiro 2008.10.19,792,1,1,14,113,21,-92,B
owzat 2008.10.11,836,1,0,41,107,27,-80,A
owzat 2008.10.11,836,1,0,41,112,34,-78,B
plumbo 2008.10.11,821,1,1,40,79,48,-31,A
plumbo 2008.10.11,821,1,1,40,84,45,-39,B
vetteboy 2008.10.17,881,1,0,22,250,14,-236,A
vetteboy 2008.10.17,881,1,0,22,261,18,-243,B
Society 2008.10.17,1056,1,1,15,114,40,-74,A
Society 2008.10.17,1056,1,1,15,106,40,-66,B
Ekwalyzer 2008.10.11,1076,1,0,9,152,56,-96,A
Ekwalyzer 2008.10.11,1076,1,0,9,91,44,-47,B
vetteboy 2008.10.11,856,1,1,9,263,22,-241,A
vetteboy 2008.10.11,856,1,1,9,195,11,-184,B
vetteboy 2008.10.15,881,2,1,78,205,28,-177,A
vetteboy 2008.10.15,881,2,1,78,217,32,-185,B
MohanGH 2008.10.15,1069,2,1,79,155,33,-122,A
MohanGH 2008.10.15,1069,2,1,79,169,32,-137,B
cyrdro 2008.09.12,948,1,1,17,118,29,-89,A
cyrdro 2008.09.12,948,1,1,17,117,29,-88,B
mjcsjo 2008.09.12,1043,1,0,17,154,41,-113,A
mjcsjo 2008.09.12,1043,1,0,17,165,29,-136,B
Zleeper 2008.10.12,1097,1,1,8,86,12,-74,A
Zleeper 2008.10.12,1097,1,1,8,70,25,-45,B
MCalkins 2008.10.10,991,3,2,117,105,44,-61,A
MCalkins 2008.10.10,991,3,2,117,111,43,-68,B
huzar 2008.10.10,954,3,1,117,106,37,-69,A
huzar 2008.10.10,954,3,1,117,103,39,-64,B
lacceroswaldo 2008.10.08,933,1,1,61,114,39,-75,A
lacceroswaldo 2008.10.08,933,1,1,61,110,34,-76,B
huzar 2008.10.08,985,2,1,74,105,35,-70,A
huzar 2008.10.08,985,2,1,74,112,38,-74,B
HawkX 2008.09.17,1030,1,0,10,302,20,-282,A
HawkX 2008.09.17,1030,1,0,10,306,10,-296,B
ChrisBeginner 2008.09.17,954,1,1,7,103,43,-60,A
ChrisBeginner 2008.09.17,954,1,1,7,82,43,-39,B
mbranimir 2008.10.08,990,1,0,15,199,13,-186,A
mbranimir 2008.10.08,990,1,0,15,191,13,-178,B
vetteboy 2008.10.05,847,1,0,11,300,9,-291,A
vetteboy 2008.10.05,847,1,0,11,314,9,-305,B
Leonidovich 2008.10.05,935,1,1,11,267,36,-231,A
Leonidovich 2008.10.05,935,1,1,11,278,36,-242,B
SchwarzeKatze 2008.09.20,878,1,0,11,224,18,-206,A
SchwarzeKatze 2008.09.20,878,1,0,11,176,27,-149,B
Simplicus 2008.09.20,1099,1,1,13,302,31,-271,A
Simplicus 2008.09.20,1099,1,1,13,252,38,-214,B
lacceroswaldo 2008.10.02,956,1,0,25,269,32,-237,A
lacceroswaldo 2008.10.02,956,1,0,25,266,40,-226,B
mipsparc 2008.10.02,1038,1,1,25,255,24,-231,A
mipsparc 2008.10.02,1038,1,1,25,258,20,-238,B
vetteboy 2008.09.28,874,1,0,21,305,10,-295,A
vetteboy 2008.09.28,874,1,0,21,269,14,-255,B
lauraT 2008.09.28,1087,1,1,22,251,27,-224,A
lauraT 2008.09.28,1087,1,1,22,245,23,-222,B
JooBoo 2008.09.15,981,1,0,16,206,19,-187,A
JooBoo 2008.09.15,981,1,0,16,194,31,-163,B
ChrisBeginner 2008.09.15,830,3,1.5,95,137,41,-96,A
ChrisBeginner 2008.09.15,830,3,1.5,95,156,40,-116,B
Intactive 2008.09.23,998,2,0,35,201,29,-172,A
Intactive 2008.09.23,998,2,0,35,196,29,-167,B
aleksthegreat 2008.09.23,955,2,2,37,267,19,-248,A
aleksthegreat 2008.09.23,955,2,2,37,257,19,-238,B
civiliansoldier 2008.09.20,902,1,1,18,177,33,-144,A
civiliansoldier 2008.09.20,902,1,1,18,182,28,-154,B
Intactive 2008.09.20,1005,1,0,16,157,25,-132,A
Intactive 2008.09.20,1005,1,0,16,137,25,-112,B
ChrisBeginner 2008.09.18,932,1,0,18,119,28,-91,A
ChrisBeginner 2008.09.18,932,1,0,18,121,28,-93,B
dickdale 2008.09.18,982,1,1,18,77,33,-44,A
dickdale 2008.09.18,982,1,1,18,86,33,-53,B
mikemandrake 2008.09.15,951,1,1,10,236,30,-206,A
mikemandrake 2008.09.15,951,1,1,10,314,40,-274,B
giospoto 2008.09.15,1036,1,0,7,139,43,-96,A
giospoto 2008.09.15,1036,1,0,7,153,57,-96,B
PABOY 2008.10.01,850,1,0,8,225,25,-200,A
PABOY 2008.10.01,850,1,0,8,308,25,-283,B
Tremeoc 2008.10.01,1121,1,1,6,62,67,5,A
Tremeoc 2008.10.01,1121,1,1,6,71,67,-4,B
laksen 2008.09.21,973,1,0,9,151,22,-129,A
laksen 2008.09.21,973,1,0,9,147,22,-125,B
EverythingIsTaken 2008.09.21,1001,1,1,8,58,62,4,A
EverythingIsTaken 2008.09.21,1001,1,1,8,62,62,0,B
ChrisBeginner 2008.09.20,909,2,1,65,137,45,-92,A
ChrisBeginner 2008.09.20,909,2,1,65,133,45,-88,B
Jackiw 2008.09.20,1090,2,1,68,143,38,-105,A
Jackiw 2008.09.20,1090,2,1,68,145,34,-111,B
nottwoday 2008.09.16,1095,1,1,25,365,24,-341,A
nottwoday 2008.09.16,1095,1,1,25,384,24,-360,B
marearoja 2008.09.16,894,1,0,24,454,25,-429,A
marearoja 2008.09.16,894,1,0,24,461,25,-436,B
mjcsjo 2008.09.15,1139,2,1.5,75,96,35,-61,A
mjcsjo 2008.09.15,1139,2,1.5,75,92,36,-56,B
ChrisBeginner 2008.09.13,906,1,0,4,151,25,-126,A
ChrisBeginner 2008.09.13,906,1,0,4,438,25,-413,B
mateone 2008.09.13,988,1,1,9,427,22,-405,A
mateone 2008.09.13,988,1,1,9,409,22,-387,B
mariusmattheus 2009.08.12,1111,3,3,25,76,40,-36,A
mariusmattheus 2009.08.12,1111,3,3,25,94,44,-50,B
Loran 2009.08.12,774,3,0,27,250,19,-231,A
Loran 2009.08.12,774,3,0,27,227,15,-212,B
nathy 2009.08.11,746,3,1,29,377,17,-360,A
nathy 2009.08.11,746,3,1,29,366,14,-352,B
Booyens 2009.08.11,927,1,1,5,114,80,-34,A
Booyens 2009.08.11,927,1,1,5,121,80,-41,B
nathy 2009.12.25,736,4,0,64,267,22,-245,A
nathy 2009.12.25,736,4,0,64,256,17,-239,B
Sokka 2009.12.25,1062,1,1,23,180,30,-150,A
Sokka 2009.12.25,1062,1,1,23,182,26,-156,B
powerfail 2009.12.28,1009,1,1,8,173,25,-148,A
powerfail 2009.12.28,1009,1,1,8,153,25,-128,B
nathy 2009.12.28,722,1,0,8,283,38,-245,A
nathy 2009.12.28,722,1,0,8,269,25,-244,B
OSZCAR 2009.08.07,1003,1,1,6,108,17,-91,A
OSZCAR 2009.08.07,1003,1,1,6,88,17,-71,B
nathy 2009.08.07,732,4,0,37,361,27,-334,A
nathy 2009.08.07,732,4,0,37,404,19,-385,B
nathy 2009.08.12,736,1,0,11,286,9,-277,A
nathy 2009.08.12,736,1,0,11,203,18,-185,B
getit 2009.08.12,1010,1,1,4,40,75,35,A
getit 2009.08.12,1010,1,1,4,16,75,59,B
reframed 2009.08.11,909,1,0.5,31,122,39,-83,A
reframed 2009.08.11,909,1,0.5,31,113,45,-68,B
OSZCAR 2009.08.11,1031,1,0.5,35,257,43,-214,A
OSZCAR 2009.08.11,1031,1,0.5,35,222,43,-179,B
kybrai 2009.12.27,759,2,1,20,303,30,-273,A
kybrai 2009.12.27,759,2,1,20,342,30,-312,B
japhet 2009.12.27,1087,2,1,17,337,35,-302,A
japhet 2009.12.27,1087,2,1,17,374,29,-345,B
EvilQueen 2009.08.11,958,1,1,15,289,13,-276,A
EvilQueen 2009.08.11,958,1,1,15,297,13,-284,B
TheDancingQueen 2009.08.11,891,1,0,16,321,19,-302,A
TheDancingQueen 2009.08.11,891,1,0,16,302,19,-283,B
nathy 2009.08.09,728,1,0,12,322,33,-289,A
nathy 2009.08.09,728,1,0,12,304,17,-287,B
samoancharger 2009.08.09,1081,1,1,11,274,18,-256,A
samoancharger 2009.08.09,1081,1,1,11,242,18,-224,B
nathy 2009.12.26,721,7,1,111,236,26,-210,A
nathy 2009.12.26,721,7,1,111,233,25,-208,B
fektija 2009.12.26,1046,2,1,36,173,25,-148,A
fektija 2009.12.26,1046,2,1,36,180,22,-158,B
Shurka 2009.10.02,1167,1,1,13,115,46,-69,A
Shurka 2009.10.02,1167,1,1,13,103,54,-49,B
Loran 2009.10.02,752,1,0,16,268,13,-255,A
Loran 2009.10.02,752,1,0,16,238,12,-226,B
francod 2009.12.26,996,1,1,17,264,24,-240,A
francod 2009.12.26,996,1,1,17,247,24,-223,B
Hosed 2009.08.11,1055,2,1,18,190,22,-168,A
Hosed 2009.08.11,1055,2,1,18,168,22,-146,B
kybrai 2009.12.30,862,2,0,36,215,31,-184,A
kybrai 2009.12.30,862,2,0,36,200,36,-164,B
japhet 2009.12.30,1057,2,2,41,211,32,-179,A
japhet 2009.12.30,1057,2,2,41,211,29,-182,B
smalldreams 2009.08.07,1027,1,1,8,164,12,-152,A
smalldreams 2009.08.07,1027,1,1,8,173,12,-161,B
hippyman 2009.12.22,900,4,3,52,294,23,-271,A
hippyman 2009.12.22,900,4,3,52,293,17,-276,B
nathy 2009.12.22,747,5,0.5,99,275,28,-247,A
nathy 2009.12.22,747,5,0.5,99,260,25,-235,B
Hazardo 2009.08.04,929,1,0.5,38,151,50,-101,A
Hazardo 2009.08.04,929,1,0.5,38,146,42,-104,B
Bhunt 2009.08.04,1050,1,0.5,40,203,22,-181,A
Bhunt 2009.08.04,1050,1,0.5,40,230,25,-205,B
Bhunt 2009.08.03,1049,1,1,26,240,23,-217,A
Bhunt 2009.08.03,1049,1,1,26,243,19,-224,B
Adolar 2009.08.03,1023,7,2,120,287,23,-264,A
Adolar 2009.08.03,1023,7,2,120,282,22,-260,B
EdSleazy 2009.12.17,1046,1,1,12,326,17,-309,A
EdSleazy 2009.12.17,1046,1,1,12,322,17,-305,B
Boofstrini 2009.12.17,929,1,0,11,254,9,-245,A
Boofstrini 2009.12.17,929,1,0,11,238,9,-229,B
russkime 2009.08.08,1012,1,0,12,112,42,-70,A
russkime 2009.08.08,1012,1,0,12,107,33,-74,B
byronjmilhall 2009.08.08,980,1,1,12,70,50,-20,A
byronjmilhall 2009.08.08,980,1,1,12,64,33,-31,B
japhet 2009.12.20,1086,2,2,24,191,25,-166,A
japhet 2009.12.20,1086,2,2,24,172,25,-147,B
kybrai 2009.12.20,778,2,0,29,323,24,-299,A
kybrai 2009.12.20,778,2,0,29,281,24,-257,B
Kloth 2009.12.26,987,3,3,39,68,51,-17,A
Kloth 2009.12.26,987,3,3,39,67,56,-11,B
Kloth 2009.12.26,987,3,3,39,62,54,-8,C
intellow 2009.10.06,911,1,0,22,214,23,-191,A
intellow 2009.10.06,911,1,0,22,195,23,-172,B
gobemouche 2009.10.06,966,1,1,19,239,26,-213,A
gobemouche 2009.10.06,966,1,1,19,166,21,-145,B
smalldreams 2009.08.06,1025,1,1,2,156,0,-156,A
smalldreams 2009.08.06,1025,1,1,2,166,50,-116,B
brntout 2009.08.06,947,1,0,6,265,33,-232,A
brntout 2009.08.06,947,1,0,6,263,33,-230,B
nathy 2009.12.27,718,2,0.5,15,158,27,-131,A
nathy 2009.12.27,718,2,0.5,15,186,27,-159,B
powerfail 2009.12.27,1048,1,0.5,11,131,27,-104,A
powerfail 2009.12.27,1048,1,0.5,11,136,18,-118,B
mergall 2009.12.25,1056,1,1,22,82,50,-32,A
mergall 2009.12.25,1056,1,1,22,154,50,-104,B
mergall 2009.12.25,1056,1,1,22,158,46,-112,C
Nopolis 2009.12.23,884,1,1,14,242,21,-221,A
Nopolis 2009.12.23,884,1,1,14,235,29,-206,B
farofero 2009.12.23,999,1,0,16,380,25,-355,A
farofero 2009.12.23,999,1,0,16,402,12,-390,B
Roquinho 2009.10.01,1010,1,0,5,312,0,-312,A
Roquinho 2009.10.01,1010,1,0,5,338,0,-338,B
praxodes 2009.10.01,982,1,1,5,177,40,-137,A
praxodes 2009.10.01,982,1,1,5,208,20,-188,B
stota 2009.09.29,972,2,0,67,151,33,-118,A
stota 2009.09.29,972,2,0,67,152,36,-116,B
samoancharger 2009.09.29,1024,2,2,66,108,47,-61,A
samoancharger 2009.09.29,1024,2,2,66,102,48,-54,B
kybrai 2009.12.28,848,1,0.5,16,256,25,-231,A
kybrai 2009.12.28,848,1,0.5,16,286,12,-274,B
japhet 2009.12.28,1058,1,0.5,16,301,25,-276,A
japhet 2009.12.28,1058,1,0.5,16,283,25,-258,B
ktinfl 2009.10.04,890,1,0,12,191,42,-149,A
ktinfl 2009.10.04,890,1,0,12,196,33,-163,B
silverspruce 2009.10.04,994,1,1,8,64,50,-14,A
silverspruce 2009.10.04,994,1,1,8,66,38,-28,B
Giully 2009.12.30,1020,1,1,9,112,33,-79,A
Giully 2009.12.30,1020,1,1,9,135,22,-113,B
Khotaa 2009.12.30,843,1,0,9,265,33,-232,A
Khotaa 2009.12.30,843,1,0,9,287,33,-254,B
gobemouche 2009.12.26,1013,1,1,5,116,40,-76,A
gobemouche 2009.12.26,1013,1,1,5,107,40,-67,B
gobemouche 2009.10.04,971,1,1,11,102,9,-93,A
gobemouche 2009.10.04,971,1,1,11,102,18,-84,B
intellow 2009.10.04,909,2,0,54,182,13,-169,A
intellow 2009.10.04,909,2,0,54,179,11,-168,B
nathy 2009.08.05,742,5,0,70,277,21,-256,A
nathy 2009.08.05,742,5,0,70,278,23,-255,B
holmesianman 2009.08.05,880,2,2,27,101,41,-60,A
holmesianman 2009.08.05,880,2,2,27,95,37,-58,B
nathy 2009.12.20,750,2,0.5,38,289,24,-265,A
nathy 2009.12.20,750,2,0.5,38,296,26,-270,B
charlestacda 2009.12.20,1026,1,1,14,149,21,-128,A
charlestacda 2009.12.20,1026,1,1,14,100,21,-79,B
nathy 2009.08.04,757,3,0,26,334,15,-319,A
nathy 2009.08.04,757,3,0,26,339,12,-327,B
tomys 2009.08.04,1054,2,2,13,147,15,-132,A
tomys 2009.08.04,1054,2,2,13,151,38,-113,B
Hazardo 2009.08.03,894,2,2,18,222,22,-200,A
Hazardo 2009.08.03,894,2,2,18,200,22,-178,B
Hazardo 2009.08.11,956,1,1,20,153,40,-113,A
Hazardo 2009.08.11,956,1,1,20,153,40,-113,B
ElevatorJoe 2009.08.11,1024,1,0,18,236,28,-208,A
ElevatorJoe 2009.08.11,1024,1,0,18,235,28,-207,B
badstep 2009.08.07,1064,1,0,21,146,38,-108,A
badstep 2009.08.07,1064,1,0,21,183,24,-159,B
Hazardo 2009.08.07,929,1,1,22,215,41,-174,A
Hazardo 2009.08.07,929,1,1,22,204,36,-168,B
SundanceKidIN 2009.12.25,1059,2,2,14,143,36,-107,A
SundanceKidIN 2009.12.25,1059,2,2,14,108,36,-72,B
nathy 2009.12.23,728,2,0,71,240,17,-223,A
nathy 2009.12.23,728,2,0,71,246,18,-228,B
ZAMMA 2009.12.23,1021,1,1,30,288,20,-268,A
ZAMMA 2009.12.23,1021,1,1,30,306,10,-296,B
karpovasparov 2009.12.20,919,1,1,16,260,38,-222,A
karpovasparov 2009.12.20,919,1,1,16,262,44,-218,B
KingzKill 2009.12.20,1072,1,0,14,226,36,-190,A
KingzKill 2009.12.20,1072,1,0,14,251,36,-215,B
Hazardo 2009.08.05,932,2,2,26,259,27,-232,A
Hazardo 2009.08.05,932,2,2,26,248,35,-213,B
intellow 2009.09.30,918,2,0,65,202,32,-170,A
intellow 2009.09.30,918,2,0,65,187,31,-156,B
zqnzt 2009.09.30,1071,2,2,69,240,20,-220,A
zqnzt 2009.09.30,1071,2,2,69,223,22,-201,B
markhodges 2009.07.27,1116,1,1,8,260,12,-248,A
markhodges 2009.07.27,1116,1,1,8,259,12,-247,B
ktinfl 2009.07.27,863,1,0,8,289,0,-289,A
ktinfl 2009.07.27,863,1,0,8,277,0,-277,B
stota 2009.09.23,1004,1,1,8,132,62,-70,A
stota 2009.09.23,1004,1,1,8,127,62,-65,B
Ifex 2009.09.23,953,1,0,16,282,25,-257,A
Ifex 2009.09.23,953,1,0,16,272,25,-247,B
scoroyale 2009.08.02,925,2,1.5,45,171,31,-140,A
scoroyale 2009.08.02,925,2,1.5,45,161,31,-130,B
dadoc 2009.08.02,965,1,0,15,376,27,-349,A
dadoc 2009.08.02,965,1,0,15,361,27,-334,B
mergall 2009.12.27,1074,1,1,4,186,50,-136,A
mergall 2009.12.27,1074,1,1,4,246,25,-221,B
AndyYuk 2009.08.07,935,1,1,7,139,57,-82,A
AndyYuk 2009.08.07,935,1,1,7,167,43,-124,B
Hazardo 2009.08.06,940,2,0,17,465,24,-441,A
Hazardo 2009.08.06,940,2,0,17,482,18,-464,B
badstep 2009.08.06,1045,2,2,12,169,67,-102,A
badstep 2009.08.06,1045,2,2,12,169,58,-111,B
hippyman 2009.12.21,886,3,2,31,284,19,-265,A
hippyman 2009.12.21,886,3,2,31,230,19,-211,B
dhally 2009.12.21,1104,1,0,9,215,33,-182,A
dhally 2009.12.21,1104,1,0,9,237,33,-204,B
QuantumMystic 2009.09.30,987,1,0,10,253,10,-243,A
QuantumMystic 2009.09.30,987,1,0,10,285,10,-275,B
Hazardo 2009.09.30,953,1,1,9,126,33,-93,A
Hazardo 2009.09.30,953,1,1,9,153,33,-120,B
ANDYTASTIC 2009.08.10,970,1,0,18,260,28,-232,A
ANDYTASTIC 2009.08.10,970,1,0,18,239,28,-211,B
Hazardo 2009.08.10,939,1,1,17,176,41,-135,A
Hazardo 2009.08.10,939,1,1,17,164,41,-123,B
catfu 2009.08.07,1045,1,1,6,212,67,-145,A
catfu 2009.08.07,1045,1,1,6,155,67,-88,B
ivebeenabducted 2009.08.10,995,1,1,22,254,14,-240,A
ivebeenabducted 2009.08.10,995,1,1,22,231,9,-222,B
brntout 2009.08.10,858,1,0,24,329,25,-304,A
brntout 2009.08.10,858,1,0,24,333,25,-308,B
rseymoure 2009.10.02,1063,1,0,21,142,38,-104,A
rseymoure 2009.10.02,1063,1,0,21,98,43,-55,B
HareBrain 2009.10.02,850,1,1,15,64,47,-17,A
HareBrain 2009.10.02,850,1,1,15,59,47,-12,B
Adolar 2009.08.04,909,1,1,6,99,17,-82,A
Adolar 2009.08.04,909,1,1,6,91,33,-58,B
Jia 2009.08.04,1044,1,0,6,276,0,-276,A
Jia 2009.08.04,1044,1,0,6,289,0,-289,B
remotoots 2009.08.06,970,1,1,9,38,56,18,A
remotoots 2009.08.06,970,1,1,9,42,67,25,B
ANDYTASTIC 2009.08.06,1015,1,0,9,160,22,-138,A
ANDYTASTIC 2009.08.06,1015,1,0,9,187,22,-165,B
OxoCube 2009.10.04,1066,1,1,39,157,26,-131,A
OxoCube 2009.10.04,1066,1,1,39,147,23,-124,B
catfu 2009.08.06,1039,1,1,13,126,31,-95,A
catfu 2009.08.06,1039,1,1,13,131,31,-100,B
nathy 2009.08.06,735,2,0,30,220,20,-200,A
nathy 2009.08.06,735,2,0,30,202,20,-182,B
thechrisfactor 2009.12.21,1091,1,0,12,380,33,-347,A
thechrisfactor 2009.12.21,1091,1,0,12,372,33,-339,B
egidio 2009.10.05,1085,1,1,8,132,38,-94,A
egidio 2009.10.05,1085,1,1,8,148,25,-123,B
niCeMoovez 2009.10.05,908,1,0,8,351,0,-351,A
niCeMoovez 2009.10.05,908,1,0,8,352,0,-352,B
HareBrain 2009.08.04,1001,1,0,8,347,0,-347,A
HareBrain 2009.08.04,1001,1,0,8,419,0,-419,B
ktinfl 2009.08.04,863,1,1,14,363,21,-342,A
ktinfl 2009.08.04,863,1,1,14,346,21,-325,B
kybrai 2009.12.18,799,6,1,59,286,24,-262,A
kybrai 2009.12.18,799,6,1,59,259,22,-237,B
japhet 2009.12.18,1076,6,5,54,267,30,-237,A
japhet 2009.12.18,1076,6,5,54,270,26,-244,B
Sawedoff 2009.09.22,1093,1,1,6,140,0,-140,A
Sawedoff 2009.09.22,1093,1,1,6,133,0,-133,B
Kundeohmar 2009.09.22,904,1,0,5,70,20,-50,A
Kundeohmar 2009.09.22,904,1,0,5,77,20,-57,B
Hazardo 2009.08.02,902,1,0,18,236,44,-192,A
Hazardo 2009.08.02,902,1,0,18,240,44,-196,B
beverlyframingham 2009.08.02,1095,1,1,15,158,60,-98,A
beverlyframingham 2009.08.02,1095,1,1,15,131,60,-71,B
SecondQueen 2009.08.06,1069,1,1,15,110,33,-77,A
SecondQueen 2009.08.06,1069,1,1,15,94,33,-61,B
JTKhouw 2009.08.04,949,1,1,9,80,56,-24,A
JTKhouw 2009.08.04,949,1,1,9,73,56,-17,B
fektija 2009.12.18,1020,1,1,9,157,33,-124,A
fektija 2009.12.18,1020,1,1,9,140,33,-107,B
hippyman 2009.12.18,929,3,0,37,226,32,-194,A
hippyman 2009.12.18,929,3,0,37,232,27,-205,B
SkyMeadow 2009.10.03,957,1,0,13,335,38,-297,A
SkyMeadow 2009.10.03,957,1,0,13,338,38,-300,B
HareBrain 2009.10.03,916,1,1,11,226,36,-190,A
HareBrain 2009.10.03,916,1,1,11,228,27,-201,B
stota 2009.10.01,938,1,0,18,222,22,-200,A
stota 2009.10.01,938,1,0,18,219,11,-208,B
happyelk 2009.10.01,1051,1,1,15,121,40,-81,A
happyelk 2009.10.01,1051,1,1,15,121,40,-81,B
onomatopeia 2009.10.01,1095,1,1,13,55,31,-24,A
onomatopeia 2009.10.01,1095,1,1,13,49,31,-18,B
WoodyMac 2009.10.01,893,1,0,13,106,31,-75,A
WoodyMac 2009.10.01,893,1,0,13,100,38,-62,B
onomatopeia 2009.09.27,1066,1,1,8,349,0,-349,A
onomatopeia 2009.09.27,1066,1,1,8,338,0,-338,B
nathy 2009.09.27,775,1,0,8,444,12,-432,A
nathy 2009.09.27,775,1,0,8,438,12,-426,B
kybrai 2009.12.16,891,1,0,8,203,38,-165,A
kybrai 2009.12.16,891,1,0,8,224,38,-186,B
japhet 2009.12.16,1061,1,1,11,295,27,-268,A
japhet 2009.12.16,1061,1,1,11,315,27,-288,B
xuch 2009.09.21,846,1,0,6,304,17,-287,A
xuch 2009.09.21,846,1,0,6,319,17,-302,B
sisohristov 2009.09.21,1127,1,1,5,151,40,-111,A
sisohristov 2009.09.21,1127,1,1,5,162,40,-122,B
WoodyMac 2009.10.02,855,1,1,3,161,0,-161,A
WoodyMac 2009.10.02,855,1,1,3,215,0,-215,B
lowandbehold 2009.10.02,998,1,0,5,686,0,-686,A
lowandbehold 2009.10.02,998,1,0,5,732,0,-732,B
intellow 2009.09.29,913,1,0,14,257,50,-207,A
intellow 2009.09.29,913,1,0,14,280,29,-251,B
onomatopeia 2009.09.29,1080,1,1,16,348,12,-336,A
onomatopeia 2009.09.29,1080,1,1,16,345,19,-326,B
chessboyjazz 2009.08.03,1072,1,1,5,34,60,26,A
chessboyjazz 2009.08.03,1072,1,1,5,57,40,-17,B
corrosiv 2009.09.22,972,1,1,11,242,27,-215,A
corrosiv 2009.09.22,972,1,1,11,266,18,-248,B
gobemouche 2009.09.22,1014,1,0,11,350,18,-332,A
gobemouche 2009.09.22,1014,1,0,11,328,18,-310,B
vannman 2009.12.22,1063,1,1,5,90,40,-50,A
vannman 2009.12.22,1063,1,1,5,91,40,-51,B
Loran 2009.09.29,759,1,0,15,231,27,-204,A
Loran 2009.09.29,759,1,0,15,237,27,-210,B
Acdtume 2009.09.29,1222,1,1,12,54,50,-4,A
Acdtume 2009.09.29,1222,1,1,12,47,42,-5,B
graphiboy 2009.12.10,990,1,0,17,301,18,-283,A
graphiboy 2009.12.10,990,1,0,17,274,18,-256,B
kevincollins 2009.12.10,1005,1,1,16,249,25,-224,A
kevincollins 2009.12.10,1005,1,1,16,221,25,-196,B
PieceMover 2009.09.20,1221,1,1,7,89,29,-60,A
PieceMover 2009.09.20,1221,1,1,7,109,14,-95,B
Loran 2009.09.20,740,1,0,7,171,57,-114,A
Loran 2009.09.20,740,1,0,7,191,29,-162,B
beatleeleven 2009.12.19,998,1,0,13,370,15,-355,A
beatleeleven 2009.12.19,998,1,0,13,383,8,-375,B
newscot 2009.12.19,900,1,1,10,200,40,-160,A
newscot 2009.12.19,900,1,1,10,214,40,-174,B
pets 2009.12.23,1062,1,1,37,140,22,-118,A
pets 2009.12.23,1062,1,1,37,139,32,-107,B
nathy 2009.12.19,757,1,0,8,128,25,-103,A
nathy 2009.12.19,757,1,0,8,157,12,-145,B
onexdata 2009.12.19,952,1,1,6,93,50,-43,A
onexdata 2009.12.19,952,1,1,6,75,33,-42,B
nathy 2009.08.03,763,3,0,45,264,18,-246,A
nathy 2009.08.03,763,3,0,45,273,22,-251,B
Nebri 2009.12.23,1149,1,1,11,65,46,-19,A
Nebri 2009.12.23,1149,1,1,11,67,54,-13,B
Plainzero 2009.12.23,806,1,0,11,213,36,-177,A
Plainzero 2009.12.23,806,1,0,11,142,36,-106,B
Fukiyama 2009.12.20,997,1,1,10,176,20,-156,A
Fukiyama 2009.12.20,997,1,1,10,188,20,-168,B
beatleeleven 2009.12.20,958,1,0,10,218,40,-178,A
beatleeleven 2009.12.20,958,1,0,10,240,30,-210,B
youwereromeo 2009.10.03,898,1,0,5,335,20,-315,A
youwereromeo 2009.10.03,898,1,0,5,345,20,-325,B
musick 2009.10.03,1029,1,1,4,53,50,-3,A
musick 2009.10.03,1029,1,1,4,42,75,33,B
Konta 2009.08.05,1081,1,1,8,246,12,-234,A
Konta 2009.08.05,1081,1,1,8,226,38,-188,B
holmesianman 2009.08.03,1018,1,0,12,383,17,-366,A
holmesianman 2009.08.03,1018,1,0,12,204,17,-187,B
Mnika 2009.12.22,991,1,1,16,312,38,-274,A
Mnika 2009.12.22,991,1,1,16,299,31,-268,B
blackknightwa 2009.12.20,1025,1,1,10,96,40,-56,A
blackknightwa 2009.12.20,1025,1,1,10,114,30,-84,B
schnookLberry 2009.12.20,936,1,0,10,147,40,-107,A
schnookLberry 2009.12.20,936,1,0,10,173,50,-123,B
chakmo 2009.12.22,983,1,1,23,320,26,-294,A
chakmo 2009.12.22,983,1,1,23,385,30,-355,B
Nopolis 2009.12.22,886,1,0,14,151,57,-94,A
Nopolis 2009.12.22,886,1,0,14,160,50,-110,B
andrejas 2009.08.05,1087,1,1,21,86,33,-53,A
andrejas 2009.08.05,1087,1,1,21,74,33,-41,B
Adolar 2009.08.05,903,1,0,28,188,32,-156,A
Adolar 2009.08.05,903,1,0,28,189,29,-160,B
Fukiyama 2009.12.22,1044,1,0.5,36,165,33,-132,A
Fukiyama 2009.12.22,1044,1,0.5,36,160,31,-129,B
Fukiyama 2009.12.21,982,1,1,5,83,40,-43,A
Fukiyama 2009.12.21,982,1,1,5,33,60,27,B
Kkidplayer 2009.12.21,1010,1,0,4,44,75,31,A
Kkidplayer 2009.12.21,1010,1,0,4,64,50,-14,B
chaosmonger 2009.12.21,1028,1,1,16,172,25,-147,A
chaosmonger 2009.12.21,1028,1,1,16,190,19,-171,B
Loran 2009.10.01,757,1,0,19,482,16,-466,A
Loran 2009.10.01,757,1,0,19,485,16,-469,B
corrosiv 2009.10.01,1034,1,1,18,409,17,-392,A
corrosiv 2009.10.01,1034,1,1,18,415,17,-398,B
nabisko 2009.12.18,1051,1,1,11,140,36,-104,A
nabisko 2009.12.18,1051,1,1,11,137,36,-101,B
danielbmarques 2009.12.18,1093,1,1,14,92,36,-56,A
danielbmarques 2009.12.18,1093,1,1,14,90,21,-69,B
xuch 2009.09.27,886,1,0,14,147,36,-111,A
xuch 2009.09.27,886,1,0,14,189,36,-153,B
NRking 2009.09.27,1042,1,1,14,159,36,-123,A
NRking 2009.09.27,1042,1,1,14,182,43,-139,B
adnjrw 2009.08.03,811,1,0,10,57,70,13,A
adnjrw 2009.08.03,811,1,0,10,55,70,15,B
gobemouche 2009.12.18,995,1,0,33,281,33,-248,A
gobemouche 2009.12.18,995,1,0,33,213,33,-180,B
Kkidplayer 2009.12.18,987,1,1,29,193,52,-141,A
Kkidplayer 2009.12.18,987,1,1,29,211,45,-166,B
hedgardo 2009.09.24,1075,1,1,11,173,27,-146,A
hedgardo 2009.09.24,1075,1,1,11,168,27,-141,B
nathy 2009.09.24,778,1,0,12,318,17,-301,A
nathy 2009.09.24,778,1,0,12,280,25,-255,B
nathy 2009.09.21,789,1,0,15,267,20,-247,A
nathy 2009.09.21,789,1,0,15,314,20,-294,B
kkj 2009.09.21,1007,1,1,15,306,13,-293,A
kkj 2009.09.21,1007,1,1,15,302,13,-289,B
Volodymir 2009.12.14,1102,2,2,23,181,22,-159,A
Volodymir 2009.12.14,1102,2,2,23,161,26,-135,B
hippyman 2009.12.14,863,2,0,22,275,23,-252,A
hippyman 2009.12.14,863,2,0,22,255,27,-228,B
hamaa 2009.12.20,952,1,0.5,22,481,23,-458,A
hamaa 2009.12.20,952,1,0.5,22,475,18,-457,B
happyelk 2009.09.25,1066,1,1,22,168,14,-154,A
happyelk 2009.09.25,1066,1,1,22,144,18,-126,B
BessieBoodle 2009.09.25,933,1,0,21,176,19,-157,A
BessieBoodle 2009.09.25,933,1,0,21,155,14,-141,B
maggiedog 2009.12.09,1057,1,1,4,144,50,-94,A
maggiedog 2009.12.09,1057,1,1,4,145,50,-95,B
hippyman 2009.12.09,886,2,0,33,235,27,-208,A
hippyman 2009.12.09,886,2,0,33,271,27,-244,B
elfrieda 2009.11.16,1006,1,0,11,65,54,-11,A
elfrieda 2009.11.16,1006,1,0,11,70,54,-16,B
topherpalmtree 2009.11.16,925,1,1,10,69,50,-19,A
topherpalmtree 2009.11.16,925,1,1,10,69,60,-9,B
SGTMAJUSMC 2009.11.11,898,1,1,5,23,100,77,A
SGTMAJUSMC 2009.11.11,898,1,1,5,61,60,-1,B
xXxghostxXx 2009.11.11,987,1,0,10,174,30,-144,A
xXxghostxXx 2009.11.11,987,1,0,10,179,30,-149,B
ANDYTASTIC 2009.08.03,973,3,3,49,165,33,-132,A
ANDYTASTIC 2009.08.03,973,3,3,49,166,29,-137,B
ANDYTASTIC 2009.08.02,973,1,0.5,33,144,24,-120,A
ANDYTASTIC 2009.08.02,973,1,0.5,33,138,42,-96,B
lacceroswaldo 2009.12.14,1060,1,1,25,148,36,-112,A
lacceroswaldo 2009.12.14,1060,1,1,25,140,32,-108,B
Nopolis 2009.12.14,888,2,0,43,173,30,-143,A
Nopolis 2009.12.14,888,2,0,43,175,26,-149,B
nathy 2009.09.19,771,3,2,29,243,31,-212,A
nathy 2009.09.19,771,3,2,29,241,28,-213,B
raysfan 2009.09.19,1080,2,1,19,253,21,-232,A
raysfan 2009.09.19,1080,2,1,19,240,26,-214,B
Hazardo 2009.09.25,931,1,1,10,237,0,-237,A
Hazardo 2009.09.25,931,1,1,10,230,0,-230,B
Bhunt 2009.09.25,1066,1,0,10,290,0,-290,A
Bhunt 2009.09.25,1066,1,0,10,282,0,-282,B
zqnzt 2009.12.15,1218,1,1,6,40,0,-40,A
zqnzt 2009.12.15,1218,1,1,6,39,17,-22,B
saipanislandboy 2009.12.15,696,1,0,6,193,17,-176,A
saipanislandboy 2009.12.15,696,1,0,6,191,0,-191,B
sccoach 2009.12.13,960,2,2,15,240,67,-173,A
sccoach 2009.12.13,960,2,2,15,207,53,-154,B
mergall 2009.12.13,1023,2,0,15,480,7,-473,A
mergall 2009.12.13,1023,2,0,15,412,20,-392,B
intellow 2009.09.21,988,1,0,10,180,20,-160,A
intellow 2009.09.21,988,1,0,10,182,20,-162,B
owzat 2009.09.21,928,1,1,9,41,44,3,A
owzat 2009.09.21,928,1,1,9,46,44,-2,B
mrmackenfan 2009.11.23,839,1,0,11,244,0,-244,A
mrmackenfan 2009.11.23,839,1,0,11,248,0,-248,B
Quien 2009.11.23,932,1,1,9,190,33,-157,A
Quien 2009.11.23,932,1,1,9,140,22,-118,B
Loran 2009.09.17,748,1,0,4,296,0,-296,A
Loran 2009.09.17,748,1,0,4,282,0,-282,B
nokto 2009.09.17,1071,1,1,4,9,75,66,A
nokto 2009.09.17,1071,1,1,4,0,100,100,B
southerncastle 2009.11.18,1046,1,1,4,208,50,-158,A
southerncastle 2009.11.18,1046,1,1,4,252,50,-202,B
mergall 2009.11.18,946,1,0,6,179,33,-146,A
mergall 2009.11.18,946,1,0,6,209,50,-159,B
elfrieda 2009.11.14,997,1,1,19,213,21,-192,A
elfrieda 2009.11.14,997,1,1,19,191,26,-165,B
silverspruce 2009.11.14,994,1,0,17,240,18,-222,A
silverspruce 2009.11.14,994,1,0,17,222,24,-198,B
intellow 2009.11.05,912,1,1,7,42,43,1,A
intellow 2009.11.05,912,1,1,7,59,43,-16,B
Langan 2009.11.05,1085,1,0,8,185,12,-173,A
Langan 2009.11.05,1085,1,0,8,199,12,-187,B
bigtruckrida 2009.09.23,1032,1,1,2,134,50,-84,A
bigtruckrida 2009.09.23,1032,1,1,2,123,50,-73,B
intellow 2009.09.23,955,1,0,7,546,0,-546,A
intellow 2009.09.23,955,1,0,7,549,0,-549,B
uetuseuu 2009.09.22,1019,1,0,10,238,50,-188,A
uetuseuu 2009.09.22,1019,1,0,10,241,20,-221,B
xuch 2009.09.22,821,1,1,6,138,33,-105,A
xuch 2009.09.22,821,1,1,6,122,33,-89,B
Yumster 2009.09.21,922,1,1,7,60,71,11,A
Yumster 2009.09.21,922,1,1,7,42,71,29,B
tanimachi 2009.09.21,1057,2,1,25,294,12,-282,A
tanimachi 2009.09.21,1057,2,1,25,312,8,-304,B
powerfail 2009.12.16,994,1,1,34,106,47,-59,A
powerfail 2009.12.16,994,1,1,34,101,47,-54,B
powerfail 2009.12.16,994,1,1,34,104,47,-57,C
Puscifer 2009.12.16,994,1,0,30,98,50,-48,A
Puscifer 2009.12.16,994,1,0,30,101,53,-48,B
Puscifer 2009.12.16,994,1,0,30,107,50,-57,C
mergall 2009.12.11,984,1,1,13,182,46,-136,A
mergall 2009.12.11,984,1,1,13,221,46,-175,B
Dconneen 2009.12.11,937,1,0,15,280,27,-253,A
Dconneen 2009.12.11,937,1,0,15,314,27,-287,B
mmjchess 2009.12.04,923,5,0,53,270,28,-242,A
mmjchess 2009.12.04,923,5,0,53,266,28,-238,B
Kkidplayer 2009.12.04,957,1,1,18,234,39,-195,A
Kkidplayer 2009.12.04,957,1,1,18,230,39,-191,B
uetuseuu 2009.09.23,992,1,1,14,368,43,-325,A
uetuseuu 2009.09.23,992,1,1,14,364,43,-321,B
niCeMoovez 2009.09.23,890,1,0,11,254,46,-208,A
niCeMoovez 2009.09.23,890,1,0,11,255,46,-209,B
kybrai 2009.12.17,854,1,0,28,176,29,-147,A
kybrai 2009.12.17,854,1,0,28,168,21,-147,B
japhet 2009.12.17,1067,1,1,23,123,48,-75,A
japhet 2009.12.17,1067,1,1,23,108,48,-60,B
BTX 2009.12.16,1029,1,0,12,195,8,-187,A
BTX 2009.12.16,1029,1,0,12,223,8,-215,B
Kkidplayer 2009.12.16,930,1,1,11,86,36,-50,A
Kkidplayer 2009.12.16,930,1,1,11,104,36,-68,B
lashaberulava 2009.12.09,1011,1,1,22,90,23,-67,A
lashaberulava 2009.12.09,1011,1,1,22,88,23,-65,B
Ifex 2009.09.19,1039,1,0,13,374,15,-359,A
Ifex 2009.09.19,1039,1,0,13,379,15,-364,B
Sokka 2009.09.15,1027,1,1,6,232,67,-165,A
Sokka 2009.09.15,1027,1,1,6,235,50,-185,B
nathy 2009.09.15,786,1,0,6,507,17,-490,A
nathy 2009.09.15,786,1,0,6,515,17,-498,B
kwe 2009.11.21,1036,2,1,20,322,35,-287,A
kwe 2009.11.21,1036,2,1,20,305,30,-275,B
mergall 2009.11.21,923,2,1,19,272,21,-251,A
mergall 2009.11.21,923,2,1,19,276,16,-260,B
Sawedoff 2009.09.23,1169,1,1,5,213,0,-213,A
Sawedoff 2009.09.23,1169,1,1,5,195,20,-175,B
tangelo 2009.09.23,821,1,0,9,381,33,-348,A
tangelo 2009.09.23,821,1,0,9,382,22,-360,B
notrightnow 2009.12.07,993,1,1,4,128,50,-78,A
notrightnow 2009.12.07,993,1,1,4,141,50,-91,B
ChessOwnU 2009.12.07,966,2,1,13,169,23,-146,A
ChessOwnU 2009.12.07,966,2,1,13,203,31,-172,B
nathy 2009.08.26,731,8,2,94,211,21,-190,A
nathy 2009.08.26,731,8,2,94,205,21,-184,B
Marcvz 2009.08.26,1045,1,1,10,172,30,-142,A
Marcvz 2009.08.26,1045,1,1,10,193,30,-163,B
gobemouche 2009.09.12,973,1,0,27,287,11,-276,A
gobemouche 2009.09.12,973,1,0,27,294,11,-283,B
Hazardo 2009.09.12,946,1,1,27,245,30,-215,A
Hazardo 2009.09.12,946,1,1,27,243,33,-210,B
gobemouche 2009.09.11,965,2,1,48,173,29,-144,A
gobemouche 2009.09.11,965,2,1,48,159,27,-132,B
Shridaren 2009.09.11,1005,1,1,8,82,25,-57,A
Shridaren 2009.09.11,1005,1,1,8,82,38,-44,B
Hazardo 2009.09.11,962,1,0,43,208,26,-182,A
Hazardo 2009.09.11,962,1,0,43,199,30,-169,B
TRADICIONAL 2009.09.06,1121,1,1,10,58,50,-8,A
TRADICIONAL 2009.09.06,1121,1,1,10,58,50,-8,B
Loran 2009.09.06,734,1,0,14,202,14,-188,A
Loran 2009.09.06,734,1,0,14,217,14,-203,B
lukeex 2009.12.14,1029,1,1,19,195,32,-163,A
lukeex 2009.12.14,1029,1,1,19,194,32,-162,B
Lovesin 2009.09.20,1142,1,0,4,230,25,-205,A
Lovesin 2009.09.20,1142,1,0,4,195,25,-170,B
Baskoot 2009.09.20,850,1,1,5,359,0,-359,A
Baskoot 2009.09.20,850,1,1,5,313,0,-313,B
nathy 2009.09.17,780,1,0,14,150,29,-121,A
nathy 2009.09.17,780,1,0,14,172,29,-143,B
dewie 2009.09.17,1065,1,1,13,238,31,-207,A
dewie 2009.09.17,1065,1,1,13,244,31,-213,B
chakmo 2009.12.09,951,1,0,16,294,12,-282,A
chakmo 2009.12.09,951,1,0,16,286,12,-274,B
robbienorma 2009.12.09,1045,1,1,15,223,33,-190,A
robbienorma 2009.12.09,1045,1,1,15,208,33,-175,B
chakmo 2009.12.07,947,1,1,17,287,41,-246,A
chakmo 2009.12.07,947,1,1,17,288,41,-247,B
hippyman 2009.12.07,934,2,0,44,364,27,-337,A
hippyman 2009.12.07,934,2,0,44,363,20,-343,B
azote 2009.08.03,1009,1,1,36,204,33,-171,A
azote 2009.08.03,1009,1,1,36,194,36,-158,B
MikiD 2009.12.06,961,2,2,13,71,38,-33,A
MikiD 2009.12.06,961,2,2,13,77,38,-39,B
ChessOwnU 2009.12.06,884,1,0,8,134,38,-96,A
ChessOwnU 2009.12.06,884,1,0,8,140,25,-115,B
guisbi 2009.12.07,965,2,1,34,337,29,-308,A
guisbi 2009.12.07,965,2,1,34,346,26,-320,B
Contranigma 2009.09.17,934,1,1,30,146,17,-129,A
Contranigma 2009.09.17,934,1,1,30,141,23,-118,B
mathspriyanka 2009.09.17,1060,1,0,28,121,32,-89,A
mathspriyanka 2009.09.17,1060,1,0,28,118,36,-82,B
Loran 2009.09.21,738,1,0,21,315,19,-296,A
Loran 2009.09.21,738,1,0,21,336,19,-317,B
Laskerson 2009.12.05,1031,1,1,17,319,24,-295,A
Laskerson 2009.12.05,1031,1,1,17,317,18,-299,B
hippyman 2009.12.05,905,1,0,17,260,35,-225,A
hippyman 2009.12.05,905,1,0,17,281,24,-257,B
HareBrain 2009.11.27,962,1,1,23,221,13,-208,A
HareBrain 2009.11.27,962,1,1,23,214,13,-201,B
Hempnotic 2009.11.27,997,1,0,19,265,26,-239,A
Hempnotic 2009.11.27,997,1,0,19,223,21,-202,B
duesse 2009.11.06,729,1,0,8,424,12,-412,A
duesse 2009.11.06,729,1,0,8,374,25,-349,B
planetchess 2009.11.06,1239,1,1,7,237,43,-194,A
planetchess 2009.11.06,1239,1,1,7,253,29,-224,B
tangelo 2009.09.20,849,1,0,39,336,20,-316,A
tangelo 2009.09.20,849,1,0,39,318,20,-298,B
gobemouche 2009.09.20,1014,1,1,34,226,21,-205,A
gobemouche 2009.09.20,1014,1,1,34,232,24,-208,B
SkyMeadow 2009.11.19,1112,1,1,11,393,9,-384,A
SkyMeadow 2009.11.19,1112,1,1,11,421,0,-421,B
weshoward 2009.11.19,886,1,0,16,586,19,-567,A
weshoward 2009.11.19,886,1,0,16,589,19,-570,B
SkyMeadow 2009.11.15,980,1,1,20,141,35,-106,A
SkyMeadow 2009.11.15,980,1,1,20,128,30,-98,B
Quien 2009.11.15,942,1,0,20,237,20,-217,A
Quien 2009.11.15,942,1,0,20,232,30,-202,B
Loran 2009.11.08,734,1,0,14,312,7,-305,A
Loran 2009.11.08,734,1,0,14,308,7,-301,B
pmineirov 2009.11.08,1109,1,1,12,158,42,-116,A
pmineirov 2009.11.08,1109,1,1,12,161,33,-128,B
nathy 2009.08.29,773,9,1,112,301,25,-276,A
nathy 2009.08.29,773,9,1,112,290,26,-264,B
CHIMOL 2009.08.29,958,1,1,5,407,0,-407,A
CHIMOL 2009.08.29,958,1,1,5,440,0,-440,B
nathy 2009.12.06,773,1,0,18,282,39,-243,A
nathy 2009.12.06,773,1,0,18,245,39,-206,B
Nopolis 2009.12.06,855,1,1,19,346,32,-314,A
Nopolis 2009.12.06,855,1,1,19,222,21,-201,B
gobemouche 2009.09.17,972,1,0,35,138,34,-104,A
gobemouche 2009.09.17,972,1,0,35,135,34,-101,B
stota 2009.09.17,972,2,1,48,119,25,-94,A
stota 2009.09.17,972,2,1,48,103,27,-76,B
MrWannaB 2009.09.14,942,1,1,6,30,67,37,A
MrWannaB 2009.09.14,942,1,1,6,22,83,61,B
Bhunt 2009.09.14,992,1,0,7,262,0,-262,A
Bhunt 2009.09.14,992,1,0,7,273,0,-273,B
nathy 2009.11.05,803,2,0,28,193,32,-161,A
nathy 2009.11.05,803,2,0,28,173,32,-141,B
SkyMeadow 2009.11.05,938,1,1,12,323,25,-298,A
SkyMeadow 2009.11.05,938,1,1,12,300,25,-275,B
Fukiyama 2009.12.12,1032,1,1,10,89,30,-59,A
Fukiyama 2009.12.12,1032,1,1,10,82,40,-42,B
hippyman 2009.12.12,872,1,0,12,222,33,-189,A
hippyman 2009.12.12,872,1,0,12,226,33,-193,B
SexyTime 2009.12.04,1091,2,2,14,169,36,-133,A
SexyTime 2009.12.04,1091,2,2,14,176,29,-147,B
berthusganja 2009.11.27,1081,1,1,21,388,33,-355,A
berthusganja 2009.11.27,1081,1,1,21,407,24,-383,B
fargeklatt 2009.11.27,920,2,0,28,310,29,-281,A
fargeklatt 2009.11.27,920,2,0,28,342,25,-317,B
Minkowsky 2009.11.26,1069,1,1,9,161,22,-139,A
Minkowsky 2009.11.26,1069,1,1,9,226,11,-215,B
fargeklatt 2009.11.26,922,3,1,29,313,21,-292,A
fargeklatt 2009.11.26,922,3,1,29,293,24,-269,B
stota 2009.09.14,971,1,0.5,48,172,25,-147,A
stota 2009.09.14,971,1,0.5,48,164,33,-131,B
kkj 2009.09.14,1026,1,0.5,48,175,27,-148,A
kkj 2009.09.14,1026,1,0.5,48,182,25,-157,B
Bhunt 2009.09.13,1012,1,0,17,293,12,-281,A
Bhunt 2009.09.13,1012,1,0,17,273,6,-267,B
gobemouche 2009.09.13,972,1,1,13,121,38,-83,A
gobemouche 2009.09.13,972,1,1,13,132,38,-94,B
LaurentDelaon 2009.12.09,1149,1,1,10,225,20,-205,A
LaurentDelaon 2009.12.09,1149,1,1,10,292,20,-272,B
duesse 2009.12.09,722,1,0,13,466,8,-458,A
duesse 2009.12.09,722,1,0,13,440,8,-432,B
kakenrni 2009.12.04,977,1,1,4,70,75,5,A
kakenrni 2009.12.04,977,1,1,4,50,50,0,B
jpjcalculator 2009.09.17,925,1,1,8,45,38,-7,A
jpjcalculator 2009.09.17,925,1,1,8,38,38,0,B
tangelo 2009.09.17,963,1,0,7,142,29,-113,A
tangelo 2009.09.17,963,1,0,7,143,14,-129,B
Loran 2009.09.12,724,1,0,9,249,22,-227,A
Loran 2009.09.12,724,1,0,9,259,11,-248,B
ziglag 2009.09.12,1199,1,1,8,169,25,-144,A
ziglag 2009.09.12,1199,1,1,8,157,38,-119,B
SkyMeadow 2009.11.26,1042,1,1,20,140,25,-115,A
SkyMeadow 2009.11.26,1042,1,1,20,164,25,-139,B
HareBrain 2009.11.26,951,1,0,25,303,24,-279,A
HareBrain 2009.11.26,951,1,0,25,314,24,-290,B
bluetac 2009.11.22,985,1,0,23,115,35,-80,A
bluetac 2009.11.22,985,1,0,23,131,30,-101,B
StarAsia 2009.11.22,982,1,1,21,64,33,-31,A
StarAsia 2009.11.22,982,1,1,21,72,33,-39,B
onexdata 2009.12.06,979,1,0,6,392,0,-392,A
onexdata 2009.12.06,979,1,0,6,376,0,-376,B
weshoward 2009.11.22,906,2,2,23,191,22,-169,A
weshoward 2009.11.22,906,2,2,23,193,17,-176,B
HareBrain 2009.11.22,1015,2,0,23,275,9,-266,A
HareBrain 2009.11.22,1015,2,0,23,289,9,-280,B
nathy 2009.11.09,792,6,1,61,270,23,-247,A
nathy 2009.11.09,792,6,1,61,284,21,-263,B
mawhin 2009.11.09,942,1,0,9,249,11,-238,A
mawhin 2009.11.09,942,1,0,9,242,11,-231,B
TheDuster 2009.11.11,913,1,1,18,186,22,-164,A
TheDuster 2009.11.11,913,1,1,18,182,28,-154,B
Azerath 2009.11.11,907,1,0,18,254,6,-248,A
Azerath 2009.11.11,907,1,0,18,260,11,-249,B
nathy 2009.09.18,774,1,0,17,143,24,-119,A
nathy 2009.09.18,774,1,0,17,110,29,-81,B
raysfan 2009.09.18,1017,1,1,16,36,50,14,A
raysfan 2009.09.18,1017,1,1,16,34,56,22,B
sccoach 2009.11.26,1004,2,1,21,232,29,-203,A
sccoach 2009.11.26,1004,2,1,21,241,29,-212,B
intellow 2009.11.21,966,2,0.5,61,170,31,-139,A
intellow 2009.11.21,966,2,0.5,61,162,36,-126,B
HareBrain 2009.11.21,995,2,1.5,61,168,33,-135,A
HareBrain 2009.11.21,995,2,1.5,61,161,38,-123,B
graphiboy 2009.11.09,1051,1,1,13,201,23,-178,A
graphiboy 2009.11.09,1051,1,1,13,210,23,-187,B
TheDuster 2009.10.31,894,2,1,20,162,40,-122,A
TheDuster 2009.10.31,894,2,1,20,164,35,-129,B
sccoach 2009.10.31,1070,2,1,23,263,35,-228,A
sccoach 2009.10.31,1070,2,1,23,235,30,-205,B
dadop 2009.11.02,1254,1,1,6,125,50,-75,A
dadop 2009.11.02,1254,1,1,6,122,50,-72,B
Loran 2009.11.02,737,1,0,7,286,14,-272,A
Loran 2009.11.02,737,1,0,7,281,14,-267,B
praxodes 2009.11.20,1124,1,1,61,180,33,-147,A
praxodes 2009.11.20,1124,1,1,61,180,38,-142,B
karpovasparov 2009.11.20,836,1,0,53,86,34,-52,A
karpovasparov 2009.11.20,836,1,0,53,78,42,-36,B
Admirn 2009.11.27,995,1,1,8,212,38,-174,A
Admirn 2009.11.27,995,1,1,8,223,38,-185,B
JBWALKER 2009.12.04,967,1,1,13,289,31,-258,A
JBWALKER 2009.12.04,967,1,1,13,272,31,-241,B
mergall 2009.11.29,961,1,1,11,127,18,-109,A
mergall 2009.11.29,961,1,1,11,107,18,-89,B
Phye 2009.11.29,1031,1,0,10,170,30,-140,A
Phye 2009.11.29,1031,1,0,10,141,40,-101,B
Ifex 2009.09.17,981,1,1,17,285,24,-261,A
Ifex 2009.09.17,981,1,1,17,259,24,-235,B
aixrad 2009.11.18,1015,1,1,3,154,100,-54,A
aixrad 2009.11.18,1015,1,1,3,143,67,-76,B
Kkidplayer 2009.11.18,971,1,0,5,445,20,-425,A
Kkidplayer 2009.11.18,971,1,0,5,440,20,-420,B
whowant 2009.08.29,1012,2,2,24,155,21,-134,A
whowant 2009.08.29,1012,2,2,24,162,21,-141,B
Nebri 2009.11.29,1092,1,1,9,88,56,-32,A
Nebri 2009.11.29,1092,1,1,9,90,67,-23,B
Plainzero 2009.11.29,847,1,0,10,210,10,-200,A
Plainzero 2009.11.29,847,1,0,10,211,10,-201,B
kardsplz 2009.11.26,937,1,0,30,107,40,-67,A
kardsplz 2009.11.26,937,1,0,30,111,33,-78,B
drinkingwater 2009.11.26,1029,1,1,28,77,50,-27,A
drinkingwater 2009.11.26,1029,1,1,28,76,43,-33,B
Quien 2009.11.30,942,1,1,11,275,27,-248,A
Quien 2009.11.30,942,1,1,11,261,18,-243,B
topherpalmtree 2009.11.30,914,1,0,10,190,20,-170,A
topherpalmtree 2009.11.30,914,1,0,10,167,20,-147,B
lowandbehold 2009.09.15,1012,1,1,26,237,35,-202,A
lowandbehold 2009.09.15,1012,1,1,26,234,31,-203,B
Bhunt 2009.09.15,987,1,0,28,296,25,-271,A
Bhunt 2009.09.15,987,1,0,28,254,21,-233,B
Tyzore 2009.10.28,937,2,0.5,37,147,19,-128,A
Tyzore 2009.10.28,937,2,0.5,37,145,24,-121,B
Hosed 2009.10.28,1031,2,1.5,36,75,44,-31,A
Hosed 2009.10.28,1031,2,1.5,36,81,42,-39,B
intellow 2009.08.28,1024,1,0.5,12,269,17,-252,A
intellow 2009.08.28,1024,1,0.5,12,259,17,-242,B
nathy 2009.08.28,755,5,1.5,62,317,18,-299,A
nathy 2009.08.28,755,5,1.5,62,321,19,-302,B
whowant 2009.08.27,971,3,2,45,313,36,-277,A
whowant 2009.08.27,971,3,2,45,312,27,-285,B
HareBrain 2009.08.27,917,1,0,14,247,36,-211,A
HareBrain 2009.08.27,917,1,0,14,197,36,-161,B
chessboyjazz 2009.11.25,1106,1,0.5,24,204,50,-154,A
chessboyjazz 2009.11.25,1106,1,0.5,24,219,46,-173,B
SGTMAJUSMC 2009.11.25,882,1,0.5,19,143,42,-101,A
SGTMAJUSMC 2009.11.25,882,1,0.5,19,126,37,-89,B
kardsplz 2009.11.08,994,2,0,51,193,24,-169,A
kardsplz 2009.11.08,994,2,0,51,189,22,-167,B
antharas 2009.11.08,1003,2,2,48,126,29,-97,A
antharas 2009.11.08,1003,2,2,48,122,27,-95,B
michaelhu 2009.09.04,1158,2,2,23,104,39,-65,A
michaelhu 2009.09.04,1158,2,2,23,102,43,-59,B
Loran 2009.09.04,752,2,0,27,196,19,-177,A
Loran 2009.09.04,752,2,0,27,197,26,-171,B
GaKK 2009.10.27,968,1,0,17,149,41,-108,A
GaKK 2009.10.27,968,1,0,17,157,29,-128,B
mdxp 2009.10.27,1006,2,1,29,230,31,-199,A
mdxp 2009.10.27,1006,2,1,29,231,24,-207,B
gobemouche 2009.08.28,955,2,0,21,170,24,-146,A
gobemouche 2009.08.28,955,2,0,21,171,24,-147,B
hailu 2009.08.28,961,1,1,10,79,50,-29,A
hailu 2009.08.28,961,1,1,10,71,50,-21,B
IanRemsen 2009.11.26,1085,1,0.5,17,186,29,-157,A
IanRemsen 2009.11.26,1085,1,0.5,17,191,35,-156,B
SGTMAJUSMC 2009.11.26,886,1,0.5,18,230,22,-208,A
SGTMAJUSMC 2009.11.26,886,1,0.5,18,259,22,-237,B
Sirenus 2009.09.13,1123,1,1,8,138,38,-100,A
Sirenus 2009.09.13,1123,1,1,8,198,25,-173,B
Contranigma 2009.09.13,876,1,0,10,318,20,-298,A
Contranigma 2009.09.13,876,1,0,10,350,10,-340,B
SkyMeadow 2009.11.16,984,2,2,31,269,23,-246,A
SkyMeadow 2009.11.16,984,2,2,31,266,32,-234,B
Quien 2009.11.16,920,1,0,9,674,0,-674,A
Quien 2009.11.16,920,1,0,9,653,0,-653,B
intellow 2009.11.09,934,1,1,12,272,17,-255,A
intellow 2009.11.09,934,1,1,12,282,25,-257,B
powerpass 2009.11.07,968,1,1,6,237,50,-187,A
powerpass 2009.11.07,968,1,1,6,218,50,-168,B
SkyMeadow 2009.11.07,955,1,0,8,370,12,-358,A
SkyMeadow 2009.11.07,955,1,0,8,359,12,-347,B
soffan 2009.11.05,1068,1,1,18,95,33,-62,A
soffan 2009.11.05,1068,1,1,18,90,39,-51,B
Marcvz 2009.09.07,1168,1,1,5,16,80,64,A
Marcvz 2009.09.07,1168,1,1,5,16,80,64,B
Loran 2009.09.07,731,2,0,14,221,0,-221,A
Loran 2009.09.07,731,2,0,14,207,0,-207,B
nathy 2009.09.16,783,1,0,8,365,12,-353,A
nathy 2009.09.16,783,1,0,8,407,25,-382,B
sarduspater 2009.09.16,1079,1,1,6,126,33,-93,A
sarduspater 2009.09.16,1079,1,1,6,137,33,-104,B
zEviscerator 2009.09.13,955,1,1,22,172,36,-136,A
zEviscerator 2009.09.13,955,1,1,22,174,36,-138,B
gwhatever 2009.09.13,945,1,0,23,238,22,-216,A
gwhatever 2009.09.13,945,1,0,23,233,22,-211,B
gobemouche 2009.09.10,965,1,0,9,512,0,-512,A
gobemouche 2009.09.10,965,1,0,9,526,0,-526,B
BeRelax 2009.09.10,1030,1,1,6,420,0,-420,A
BeRelax 2009.09.10,1030,1,1,6,448,0,-448,B
Gasparinho 2009.08.29,1028,2,2,28,180,36,-144,A
Gasparinho 2009.08.29,1028,2,2,28,221,32,-189,B
xDieInAFirex 2009.10.27,667,1,0,19,205,32,-173,A
xDieInAFirex 2009.10.27,667,1,0,19,209,32,-177,B
RichardJohnson 2009.10.27,1322,1,1,17,155,24,-131,A
RichardJohnson 2009.10.27,1322,1,1,17,160,24,-136,B
ironwutang 2009.08.27,841,2,1,19,256,16,-240,A
ironwutang 2009.08.27,841,2,1,19,252,21,-231,B
nathy 2009.11.17,778,1,0,19,133,21,-112,A
nathy 2009.11.17,778,1,0,19,159,21,-138,B
Phye 2009.11.17,1008,1,1,17,67,65,-2,A
Phye 2009.11.17,1008,1,1,17,78,65,-13,B
niCeMoovez 2009.10.29,902,2,1,31,288,23,-265,A
niCeMoovez 2009.10.29,902,2,1,31,254,23,-231,B
BrootFaus 2009.10.29,1003,2,1,29,324,28,-296,A
BrootFaus 2009.10.29,1003,2,1,29,322,28,-294,B
drewblastoff 2009.09.13,957,1,1,12,245,17,-228,A
drewblastoff 2009.09.13,957,1,1,12,258,17,-241,B
nathy 2009.09.13,792,1,0,13,319,38,-281,A
nathy 2009.09.13,792,1,0,13,332,38,-294,B
mergall 2009.11.17,919,1,1,8,43,62,19,A
mergall 2009.11.17,919,1,1,8,63,50,-13,B
SkyMeadow 2009.11.17,1016,1,0,9,233,22,-211,A
SkyMeadow 2009.11.17,1016,1,0,9,236,33,-203,B
Loran 2009.11.14,727,2,0,15,293,33,-260,A
Loran 2009.11.14,727,2,0,15,311,27,-284,B
hedgardo 2009.11.14,1187,2,2,12,81,42,-39,A
hedgardo 2009.11.14,1187,2,2,12,81,42,-39,B
sarduspater 2009.11.09,1037,3,3,21,227,43,-184,A
sarduspater 2009.11.09,1037,3,3,21,233,48,-185,B
timeToLive 2009.09.11,1077,1,1,14,56,21,-35,A
timeToLive 2009.09.11,1077,1,1,14,66,14,-52,B
SeanMohsin 2009.09.11,889,1,0,14,131,21,-110,A
SeanMohsin 2009.09.11,889,1,0,14,133,36,-97,B
thotthescribe 2009.09.08,1097,1,1,9,114,33,-81,A
thotthescribe 2009.09.08,1097,1,1,9,108,33,-75,B
Contranigma 2009.09.08,891,1,0,10,285,10,-275,A
Contranigma 2009.09.08,891,1,0,10,297,10,-287,B
mrdigital 2009.09.05,1177,2,2,9,93,33,-60,A
mrdigital 2009.09.05,1177,2,2,9,72,44,-28,B
Loran 2009.09.05,743,3,0,22,422,41,-381,A
Loran 2009.09.05,743,3,0,22,433,32,-401,B
LaurentDelaon 2009.09.05,1075,1,1,7,393,14,-379,A
LaurentDelaon 2009.09.05,1075,1,1,7,407,14,-393,B
nathy 2009.09.05,781,1,0,7,496,29,-467,A
nathy 2009.09.05,781,1,0,7,505,29,-476,B
mdxp 2009.10.28,1018,1,1,13,127,31,-96,A
mdxp 2009.10.28,1018,1,1,13,112,38,-74,B
SkyMeadow 2009.10.28,923,2,1,38,201,34,-167,A
SkyMeadow 2009.10.28,923,2,1,38,167,34,-133,B
joulu 2009.08.28,835,1,1,8,126,38,-88,A
joulu 2009.08.28,835,1,1,8,132,38,-94,B
Hazardo 2009.08.28,963,1,0,7,166,29,-137,A
Hazardo 2009.08.28,963,1,0,7,184,29,-155,B
mergall 2009.11.16,972,1,0,20,85,30,-55,A
mergall 2009.11.16,972,1,0,20,93,25,-68,B
drewblastoff 2009.09.11,1007,1,1,20,216,30,-186,A
drewblastoff 2009.09.11,1007,1,1,20,153,40,-113,B
niCeMoovez 2009.09.11,921,1,0,24,263,25,-238,A
niCeMoovez 2009.09.11,921,1,0,24,244,25,-219,B
jiamenguk 2009.11.12,1115,1,1,4,192,50,-142,A
jiamenguk 2009.11.12,1115,1,1,4,164,25,-139,B
BattlerV 2009.11.12,870,1,0,5,429,20,-409,A
BattlerV 2009.11.12,870,1,0,5,426,20,-406,B
Hosed 2009.11.04,1035,1,1,7,75,43,-32,A
Hosed 2009.11.04,1035,1,1,7,77,43,-34,B
SkyMeadow 2009.11.04,947,1,0,7,219,0,-219,A
SkyMeadow 2009.11.04,947,1,0,7,212,0,-212,B
ktinfl 2009.10.27,858,1,0,17,228,24,-204,A
ktinfl 2009.10.27,858,1,0,17,207,6,-201,B
biondy 2009.10.27,1019,2,1,29,195,28,-167,A
biondy 2009.10.27,1019,2,1,29,189,24,-165,B
gobemouche 2009.10.12,915,2,1,41,280,24,-256,A
gobemouche 2009.10.12,915,2,1,41,235,24,-211,B
MaximilliannKidd 2009.10.12,1056,1,1,22,194,18,-176,A
MaximilliannKidd 2009.10.12,1056,1,1,22,190,14,-176,B
fargeklatt 2009.11.14,1049,1,1,5,302,20,-282,A
fargeklatt 2009.11.14,1049,1,1,5,272,20,-252,B
ACGD 2009.11.14,888,1,0,3,127,67,-60,A
ACGD 2009.11.14,888,1,0,3,138,33,-105,B
ktinfl 2009.11.01,841,1,1,21,277,48,-229,A
ktinfl 2009.11.01,841,1,1,21,247,48,-199,B
SkyMeadow 2009.11.01,919,1,0,25,393,32,-361,A
SkyMeadow 2009.11.01,919,1,0,25,414,28,-386,B
intellow 2009.11.14,939,1,0,15,218,27,-191,A
intellow 2009.11.14,939,1,0,15,234,20,-214,B
Phye 2009.11.14,1008,1,1,15,227,13,-214,A
Phye 2009.11.14,1008,1,1,15,230,20,-210,B
tangelo 2009.09.10,934,1,0,15,189,13,-176,A
tangelo 2009.09.10,934,1,0,15,180,20,-160,B
phuziOn 2009.09.10,965,1,1,11,138,46,-92,A
phuziOn 2009.09.10,965,1,1,11,139,46,-93,B
saipanislandboy 2009.10.30,721,1,0,8,336,12,-324,A
saipanislandboy 2009.10.30,721,1,0,8,352,0,-352,B
chagf 2009.10.30,1052,1,1,8,162,25,-137,A
chagf 2009.10.30,1052,1,1,8,205,0,-205,B
bennywalsh 2009.08.30,1047,2,2,29,213,17,-196,A
bennywalsh 2009.08.30,1047,2,2,29,191,24,-167,B
nathy 2009.08.30,793,5,0,74,270,26,-244,A
nathy 2009.08.30,793,5,0,74,281,26,-255,B
MasterBelch 2009.10.20,888,1,0,16,141,12,-129,A
MasterBelch 2009.10.20,888,1,0,16,151,12,-139,B
kkj 2009.10.20,1053,1,1,15,95,40,-55,A
kkj 2009.10.20,1053,1,1,15,101,40,-61,B
kinkobel 2009.11.07,1038,1,0.5,32,209,12,-197,A
kinkobel 2009.11.07,1038,1,0.5,32,222,9,-213,B
HareBrain 2009.11.07,957,1,0.5,31,173,19,-154,A
HareBrain 2009.11.07,957,1,0.5,31,182,19,-163,B
Hazardo 2009.11.06,1029,1,1,6,174,33,-141,A
Hazardo 2009.11.06,1029,1,1,6,175,33,-142,B
intellow 2009.11.06,936,1,0,5,67,60,-7,A
intellow 2009.11.06,936,1,0,5,74,60,-14,B
drunkindurham 2009.09.07,1264,1,1,9,48,44,-4,A
drunkindurham 2009.09.07,1264,1,1,9,49,33,-16,B
ElectronTheory 2009.09.05,1153,1,1,10,385,40,-345,A
ElectronTheory 2009.09.05,1153,1,1,10,226,50,-176,B
gobemouche 2009.10.31,957,1,0.5,23,229,22,-207,A
gobemouche 2009.10.31,957,1,0.5,23,197,22,-175,B
intellow 2009.10.31,904,1,0.5,24,248,21,-227,A
intellow 2009.10.31,904,1,0.5,24,219,21,-198,B
SameerMalik 2009.09.05,1047,1,1,8,55,50,-5,A
SameerMalik 2009.09.05,1047,1,1,8,52,50,-2,B
GMenBigBlue 2009.09.05,916,1,0,8,248,0,-248,A
GMenBigBlue 2009.09.05,916,1,0,8,231,0,-231,B
whowant 2009.08.30,1011,2,2,23,171,39,-132,A
whowant 2009.08.30,1011,2,2,23,174,35,-139,B
nathy 2009.08.31,781,1,0,11,161,46,-115,A
nathy 2009.08.31,781,1,0,11,178,36,-142,B
LaurentDelaon 2009.08.31,1099,1,1,10,28,80,52,A
LaurentDelaon 2009.08.31,1099,1,1,10,31,70,39,B
gwhatever 2009.09.09,942,1,0,27,141,26,-115,A
gwhatever 2009.09.09,942,1,0,27,136,33,-103,B
sammakkon 2009.09.09,1029,1,1,27,113,37,-76,A
sammakkon 2009.09.09,1029,1,1,27,115,44,-71,B
SkyMeadow 2009.10.27,936,4,2,47,247,19,-228,A
SkyMeadow 2009.10.27,936,4,2,47,228,19,-209,B
smalldreams 2009.08.29,1099,1,1,3,86,67,-19,A
smalldreams 2009.08.29,1099,1,1,3,39,67,28,B
gobemouche 2009.10.23,980,2,1,23,118,61,-57,A
gobemouche 2009.10.23,980,2,1,23,119,44,-75,B
MasterBelch 2009.10.23,1018,2,1,22,254,36,-218,A
MasterBelch 2009.10.23,1018,2,1,22,253,27,-226,B
Giully 2009.10.27,1048,1,1,8,53,38,-15,A
Giully 2009.10.27,1048,1,1,8,46,50,4,B
pendaggie 2009.10.25,899,1,0,6,145,17,-128,A
pendaggie 2009.10.25,899,1,0,6,152,17,-135,B
asewasew 2009.10.25,1081,1,1,5,15,80,65,A
asewasew 2009.10.25,1081,1,1,5,35,60,25,B
nathy 2009.09.08,778,1,0,16,224,31,-193,A
nathy 2009.09.08,778,1,0,16,216,31,-185,B
dafics 2009.09.08,1099,1,1,13,143,8,-135,A
dafics 2009.09.08,1099,1,1,13,131,15,-116,B
mrmackenfan 2009.10.25,849,1,0,7,252,29,-223,A
mrmackenfan 2009.10.25,849,1,0,7,256,29,-227,B
sccoach 2009.10.25,1096,1,1,5,74,20,-54,A
sccoach 2009.10.25,1096,1,1,5,82,20,-62,B
soffan 2009.09.03,1033,1,0,7,56,57,1,A
soffan 2009.09.03,1033,1,0,7,70,57,-13,B
gobemouche 2009.09.03,954,1,1,13,290,23,-267,A
gobemouche 2009.09.03,954,1,1,13,315,23,-292,B
TheDuster 2009.10.29,952,1,0,11,284,9,-275,A
TheDuster 2009.10.29,952,1,0,11,270,9,-261,B
SkyMeadow 2009.10.29,914,2,1,29,198,24,-174,A
SkyMeadow 2009.10.29,914,2,1,29,182,24,-158,B
antharas 2009.10.31,987,1,1,40,140,35,-105,A
antharas 2009.10.31,987,1,1,40,148,30,-118,B
ktinfl 2009.10.31,848,1,0,41,221,27,-194,A
ktinfl 2009.10.31,848,1,0,41,202,29,-173,B
SkyMeadow 2009.10.30,916,1,1,29,101,38,-63,A
SkyMeadow 2009.10.30,916,1,1,29,92,38,-54,B
biondy 2009.10.30,1066,1,0,29,157,24,-133,A
biondy 2009.10.30,1066,1,0,29,134,31,-103,B
SkyMeadow 2009.10.21,943,2,0,20,371,10,-361,A
SkyMeadow 2009.10.21,943,2,0,20,359,10,-349,B
tanimachi 2009.10.21,1018,2,2,11,232,0,-232,A
tanimachi 2009.10.21,1018,2,2,11,224,0,-224,B
topherpalmtree 2009.10.20,815,1,1,9,19,67,48,A
topherpalmtree 2009.10.20,815,1,1,9,14,78,64,B
duesse 2009.10.20,920,1,0,11,155,27,-128,A
duesse 2009.10.20,920,1,0,11,153,27,-126,B
pendaggie 2009.10.18,957,1,0,4,386,0,-386,A
pendaggie 2009.10.18,957,1,0,4,367,0,-367,B
intellow 2009.10.18,895,1,1,4,254,25,-229,A
intellow 2009.10.18,895,1,1,4,204,25,-179,B
ironwutang 2009.08.26,999,1,0,20,261,25,-236,A
ironwutang 2009.08.26,999,1,0,20,267,25,-242,B
JooBoo 2009.08.26,986,1,1,16,147,44,-103,A
JooBoo 2009.08.26,986,1,1,16,136,44,-92,B
SkyMeadow 2009.10.31,925,1,0,23,289,22,-267,A
SkyMeadow 2009.10.31,925,1,0,23,300,22,-278,B
japhet 2009.10.31,1056,1,1,24,297,25,-272,A
japhet 2009.10.31,1056,1,1,24,311,25,-286,B
auglaize 2009.08.29,1052,1,1,10,59,50,-9,A
auglaize 2009.08.29,1052,1,1,10,65,40,-25,B
GMenBigBlue 2009.08.29,945,1,0,10,56,40,-16,A
GMenBigBlue 2009.08.29,945,1,0,10,71,40,-31,B
shailen 2009.08.27,947,1,1,11,220,46,-174,A
shailen 2009.08.27,947,1,1,11,238,36,-202,B
andrejas 2009.08.27,1028,1,0,14,431,43,-388,A
andrejas 2009.08.27,1028,1,0,14,432,21,-411,B
protoz 2009.10.15,1009,1,1,11,186,27,-159,A
protoz 2009.10.15,1009,1,1,11,197,9,-188,B
intellow 2009.10.15,905,1,0,11,219,36,-183,A
intellow 2009.10.15,905,1,0,11,208,27,-181,B
antharas 2009.10.11,955,1,1,7,135,0,-135,A
antharas 2009.10.11,955,1,1,7,125,0,-125,B
intellow 2009.10.11,916,1,0,8,130,38,-92,A
intellow 2009.10.11,916,1,0,8,121,38,-83,B
markhodges 2009.09.05,1127,1,0,24,193,29,-164,A
markhodges 2009.09.05,1127,1,0,24,202,25,-177,B
soffan 2009.09.05,844,1,1,26,286,35,-251,A
soffan 2009.09.05,844,1,1,26,270,31,-239,B
AlfredJ 2009.08.28,1080,1,1,9,87,56,-31,A
AlfredJ 2009.08.28,1080,1,1,9,81,56,-25,B
SkyMeadow 2009.10.22,915,2,0,21,288,14,-274,A
SkyMeadow 2009.10.22,915,2,0,21,308,10,-298,B
antharas 2009.10.22,1004,1,1,7,110,57,-53,A
antharas 2009.10.22,1004,1,1,7,100,43,-57,B
yanfen 2009.10.13,994,1,1,11,131,18,-113,A
yanfen 2009.10.13,994,1,1,11,111,46,-65,B
antharas 2009.10.13,978,1,0,12,179,17,-162,A
antharas 2009.10.13,978,1,0,12,174,8,-166,B
HareBrain 2009.08.29,869,2,1,36,213,19,-194,A
HareBrain 2009.08.29,869,2,1,36,229,22,-207,B
niCeMoovez 2009.10.26,903,1,0,8,248,12,-236,A
niCeMoovez 2009.10.26,903,1,0,8,238,38,-200,B
tomecki 2009.10.26,756,1,1,7,31,43,12,A
tomecki 2009.10.26,756,1,1,7,24,57,33,B
DeathKnights 2009.08.28,951,1,1,21,96,33,-63,A
DeathKnights 2009.08.28,951,1,1,21,124,29,-95,B
badstep 2009.08.28,1028,1,0,23,242,35,-207,A
badstep 2009.08.28,1028,1,0,23,223,35,-188,B
Loran 2009.09.02,743,1,0.5,13,245,23,-222,A
Loran 2009.09.02,743,1,0.5,13,276,23,-253,B
Thantos 2009.09.02,1141,1,0.5,8,108,38,-70,A
Thantos 2009.09.02,1141,1,0.5,8,108,38,-70,B
owzat 2009.10.24,997,1,1,21,366,33,-333,A
owzat 2009.10.24,997,1,1,21,373,24,-349,B
ACECAKER 2009.10.24,987,1,0,14,384,14,-370,A
ACECAKER 2009.10.24,987,1,0,14,311,29,-282,B
DrillOp 2009.10.22,960,2,1,17,293,29,-264,A
DrillOp 2009.10.22,960,2,1,17,308,24,-284,B
Demolishor 2009.10.10,900,2,0,21,215,29,-186,A
Demolishor 2009.10.10,900,2,0,21,208,29,-179,B
intellow 2009.10.10,905,2,2,17,72,35,-37,A
intellow 2009.10.10,905,2,2,17,77,35,-42,B
tdalex 2009.08.16,1080,1,1,20,114,30,-84,A
tdalex 2009.08.16,1080,1,1,20,98,30,-68,B
nathy 2009.08.16,733,1,0,22,205,14,-191,A
nathy 2009.08.16,733,1,0,22,196,23,-173,B
Musclorman 2009.08.30,884,1,1,10,442,0,-442,A
Musclorman 2009.08.30,884,1,1,10,426,0,-426,B
bgilby 2009.10.28,1043,1,0,29,244,31,-213,A
bgilby 2009.10.28,1043,1,0,29,211,34,-177,B
Sagi 2009.10.29,1051,1,1,14,211,50,-161,A
Sagi 2009.10.29,1051,1,1,14,190,50,-140,B
Hosed 2009.10.27,1020,1,1,12,160,25,-135,A
Hosed 2009.10.27,1020,1,1,12,162,25,-137,B
HareBrain 2009.10.22,959,1,1,3,193,33,-160,A
HareBrain 2009.10.22,959,1,1,3,221,33,-188,B
Enato 2009.10.13,1107,1,1,20,221,5,-216,A
Enato 2009.10.13,1107,1,1,20,235,5,-230,B
intellow 2009.10.13,881,1,0,20,314,10,-304,A
intellow 2009.10.13,881,1,0,20,296,5,-291,B
jumpinggreenfrog 2009.08.24,909,4,2,72,165,37,-128,A
jumpinggreenfrog 2009.08.24,909,4,2,72,164,39,-125,B
GoGoYubari 2009.08.24,1087,2,2,35,179,34,-145,A
GoGoYubari 2009.08.24,1087,2,2,35,187,37,-150,B
sxsonar 2009.01.13,987,1,1,25,219,28,-191,A
sxsonar 2009.01.13,987,1,1,25,221,32,-189,B
Crashinator 2009.01.13,814,1,0,22,169,27,-142,A
Crashinator 2009.01.13,814,1,0,22,156,32,-124,B
LucasKerberHara 2009.08.28,957,1,0,9,275,11,-264,A
LucasKerberHara 2009.08.28,957,1,0,9,273,11,-262,B
tomecki 2009.10.19,836,2,0,30,200,27,-173,A
tomecki 2009.10.19,836,2,0,30,198,27,-171,B
WillByron 2009.10.19,1128,2,2,29,125,45,-80,A
WillByron 2009.10.19,1128,2,2,29,117,45,-72,B
chagf 2009.10.12,999,1,1,22,139,32,-107,A
chagf 2009.10.12,999,1,1,22,137,27,-110,B
saipanislandboy 2009.10.12,942,1,0,24,218,12,-206,A
saipanislandboy 2009.10.12,942,1,0,24,209,12,-197,B
intellow 2009.10.07,899,3,2,68,237,26,-211,A
intellow 2009.10.07,899,3,2,68,228,24,-204,B
lowandbehold 2009.10.07,976,2,2,44,235,39,-196,A
lowandbehold 2009.10.07,976,2,2,44,224,39,-185,B
ironwutang 2009.08.28,828,1,1,11,256,36,-220,A
ironwutang 2009.08.28,828,1,1,11,246,36,-210,B
smalldreams 2009.08.28,1131,1,0,10,348,30,-318,A
smalldreams 2009.08.28,1131,1,0,10,343,30,-313,B
FaustArp 2009.08.28,945,1,1,12,168,17,-151,A
FaustArp 2009.08.28,945,1,1,12,164,17,-147,B
spiritswords 2009.08.22,970,3,2,82,89,50,-39,A
spiritswords 2009.08.22,970,3,2,82,82,52,-30,B
spiritswords 2009.08.22,970,3,2,82,78,48,-30,C
hailu 2009.08.22,953,3,1,84,183,37,-146,A
hailu 2009.08.22,953,3,1,84,161,37,-124,B
hailu 2009.08.22,953,3,1,84,147,33,-114,C
Loran 2009.08.23,754,2,0,18,338,6,-332,A
Loran 2009.08.23,754,2,0,18,317,11,-306,B
Tyranth 2009.08.23,1070,2,2,16,150,25,-125,A
Tyranth 2009.08.23,1070,2,2,16,163,25,-138,B
Loran 2009.08.15,756,1,0,13,174,23,-151,A
Loran 2009.08.15,756,1,0,13,174,31,-143,B
mariusmattheus 2009.08.15,1203,1,1,11,121,36,-85,A
mariusmattheus 2009.08.15,1203,1,1,11,124,36,-88,B
sammyblade 2009.08.29,1031,1,1,10,83,50,-33,A
sammyblade 2009.08.29,1031,1,1,10,99,50,-49,B
brickell 2009.08.28,902,1,0,5,264,40,-224,A
brickell 2009.08.28,902,1,0,5,261,40,-221,B
Mikemm 2009.08.28,1040,1,1,4,88,50,-38,A
Mikemm 2009.08.28,1040,1,1,4,101,50,-51,B
getit 2009.08.28,1008,1,1,16,414,12,-402,A
getit 2009.08.28,1008,1,1,16,394,12,-382,B
graphiboy 2009.10.21,1023,1,1,11,256,36,-220,A
graphiboy 2009.10.21,1023,1,1,11,230,46,-184,B
Dreamlight 2009.08.26,1048,1,1,9,125,33,-92,A
Dreamlight 2009.08.26,1048,1,1,9,130,22,-108,B
pendaggie 2009.10.23,943,1,0,6,285,0,-285,A
pendaggie 2009.10.23,943,1,0,6,254,17,-237,B
candries 2009.10.23,1042,1,1,5,378,20,-358,A
candries 2009.10.23,1042,1,1,5,385,20,-365,B
nathy 2009.10.23,806,1,0,20,279,25,-254,A
nathy 2009.10.23,806,1,0,20,275,35,-240,B
pmineirov 2009.10.23,1097,1,1,19,235,26,-209,A
pmineirov 2009.10.23,1097,1,1,19,228,21,-207,B
gobemouche 2009.10.16,947,1,0,24,273,25,-248,A
gobemouche 2009.10.16,947,1,0,24,241,29,-212,B
sandiren 2009.10.16,1048,1,1,19,196,32,-164,A
sandiren 2009.10.16,1048,1,1,19,147,26,-121,B
Demolishor 2009.10.11,923,1,0,7,258,29,-229,A
Demolishor 2009.10.11,923,1,0,7,248,14,-234,B
Kundeohmar 2009.10.11,913,1,1,5,24,40,16,A
Kundeohmar 2009.10.11,913,1,1,5,25,40,15,B
sigggih 2009.08.26,1045,1,1,19,142,42,-100,A
sigggih 2009.08.26,1045,1,1,19,144,37,-107,B
brickell 2009.08.25,883,1,0.5,46,241,37,-204,A
brickell 2009.08.25,883,1,0.5,46,248,33,-215,B
andrejas 2009.08.25,1019,1,0.5,36,123,39,-84,A
andrejas 2009.08.25,1019,1,0.5,36,128,42,-86,B
paderboots 2009.08.28,944,1,1,10,257,10,-247,A
paderboots 2009.08.28,944,1,1,10,195,20,-175,B
uetuseuu 2009.10.17,990,1,0,17,259,24,-235,A
uetuseuu 2009.10.17,990,1,0,17,262,29,-233,B
owzat 2009.10.17,979,1,1,11,140,27,-113,A
owzat 2009.10.17,979,1,1,11,138,27,-111,B
topherpalmtree 2009.10.13,900,1,0,7,80,29,-51,A
topherpalmtree 2009.10.13,900,1,0,7,98,14,-84,B
lowandbehold 2009.10.13,1028,1,1,7,126,29,-97,A
lowandbehold 2009.10.13,1028,1,1,7,125,29,-96,B
TheBlack 2009.10.21,923,1,0,5,398,0,-398,A
TheBlack 2009.10.21,923,1,0,5,431,0,-431,B
ElectronTheory 2009.10.11,1163,2,1,25,276,28,-248,A
ElectronTheory 2009.10.11,1163,2,1,25,245,32,-213,B
hautefoxx 2009.10.11,831,2,1,27,305,18,-287,A
hautefoxx 2009.10.11,831,2,1,27,291,18,-273,B
ElectronTheory 2009.10.10,1160,2,1.5,40,198,30,-168,A
ElectronTheory 2009.10.10,1160,2,1.5,40,190,35,-155,B
hautefoxx 2009.10.10,836,2,0.5,39,191,36,-155,A
hautefoxx 2009.10.10,836,2,0.5,39,180,36,-144,B
getit 2009.08.26,1007,1,1,8,126,12,-114,A
getit 2009.08.26,1007,1,1,8,116,25,-91,B
Kundeohmar 2009.10.09,893,1,0.5,8,46,25,-21,A
Kundeohmar 2009.10.09,893,1,0.5,8,45,38,-7,B
gobemouche 2009.10.09,949,1,0.5,9,159,33,-126,A
gobemouche 2009.10.09,949,1,0.5,9,157,22,-135,B
lowandbehold 2009.08.21,904,3,1,23,249,22,-227,A
lowandbehold 2009.08.21,904,3,1,23,235,22,-213,B
Bhunt 2009.08.21,1050,2,1,27,176,30,-146,A
Bhunt 2009.08.21,1050,2,1,27,191,26,-165,B
Musclorman 2009.08.20,927,2,0.5,27,327,33,-294,A
Musclorman 2009.08.20,927,2,0.5,27,321,33,-288,B
Ravacholsixneuf 2009.08.20,991,1,1,14,151,36,-115,A
Ravacholsixneuf 2009.08.20,991,1,1,14,142,43,-99,B
protoz 2009.10.10,953,1,1,9,137,33,-104,A
protoz 2009.10.10,953,1,1,9,126,33,-93,B
gobemouche 2009.10.10,927,1,0,11,230,46,-184,A
gobemouche 2009.10.10,927,1,0,11,239,46,-193,B
chagf 2009.10.20,1018,1,1,34,119,35,-84,A
chagf 2009.10.20,1018,1,1,34,116,29,-87,B
saipanislandboy 2009.10.20,785,1,0,35,190,26,-164,A
saipanislandboy 2009.10.20,785,1,0,35,182,17,-165,B
Mels 2009.08.26,1051,1,1,19,206,26,-180,A
Mels 2009.08.26,1051,1,1,19,239,21,-218,B
Loran 2009.10.09,752,1,0,18,328,11,-317,A
Loran 2009.10.09,752,1,0,18,340,6,-334,B
sandiren 2009.10.09,1057,1,1,12,98,25,-73,A
sandiren 2009.10.09,1057,1,1,12,103,25,-78,B
stota 2009.10.09,996,1,0,22,96,50,-46,A
stota 2009.10.09,996,1,0,22,89,59,-30,B
stota 2009.10.09,996,1,0,22,97,50,-47,C
tramontane 2009.10.09,1003,1,1,22,106,36,-70,A
tramontane 2009.10.09,1003,1,1,22,109,27,-82,B
tramontane 2009.10.09,1003,1,1,22,106,32,-74,C
Hazardo 2009.10.20,975,1,1,5,188,20,-168,A
Hazardo 2009.10.20,975,1,1,5,176,20,-156,B
salona 2009.10.20,1023,1,0,7,331,0,-331,A
salona 2009.10.20,1023,1,0,7,308,0,-308,B
GMenBigBlue 2009.08.26,966,1,0,7,84,71,-13,A
GMenBigBlue 2009.08.26,966,1,0,7,93,57,-36,B
LaurentDelaon 2009.08.26,1062,2,1,23,264,26,-238,A
LaurentDelaon 2009.08.26,1062,2,1,23,265,22,-243,B
TheDancingQueen 2009.08.13,835,2,0,35,346,9,-337,A
TheDancingQueen 2009.08.13,835,2,0,35,324,11,-313,B
EvilQueen 2009.08.13,1024,2,2,41,269,22,-247,A
EvilQueen 2009.08.13,1024,2,2,41,268,32,-236,B
bialyhetman 2009.10.19,1221,1,1,9,319,11,-308,A
bialyhetman 2009.10.19,1221,1,1,9,333,11,-322,B
Loran 2009.10.19,744,1,0,9,382,11,-371,A
Loran 2009.10.19,744,1,0,9,410,11,-399,B
Bhunt 2009.08.24,1005,3,0.5,31,288,23,-265,A
Bhunt 2009.08.24,1005,3,0.5,31,254,23,-231,B
gobemouche 2009.08.25,921,1,1,14,212,21,-191,A
gobemouche 2009.08.25,921,1,1,14,192,21,-171,B
Hazardo 2009.08.25,972,1,0,14,244,29,-215,A
Hazardo 2009.08.25,972,1,0,14,247,29,-218,B
Hazardo 2009.08.20,935,1,0,16,283,19,-264,A
Hazardo 2009.08.20,935,1,0,16,280,19,-261,B
samoancharger 2009.08.20,1009,1,1,14,111,36,-75,A
samoancharger 2009.08.20,1009,1,1,14,97,50,-47,B
MasterBelch 2009.10.12,975,1,0,17,457,6,-451,A
MasterBelch 2009.10.12,975,1,0,17,323,0,-323,B
alonsofer 2009.08.26,945,1,1,11,233,9,-224,A
alonsofer 2009.08.26,945,1,1,11,232,9,-223,B
andrejas 2009.08.26,1014,1,0,11,299,27,-272,A
andrejas 2009.08.26,1014,1,0,11,303,27,-276,B
GaKK 2009.10.09,996,1,0,21,85,29,-56,A
GaKK 2009.10.09,996,1,0,21,60,38,-22,B
GaKK 2009.10.09,996,1,0,21,70,33,-37,C
yuyoyu 2009.10.09,1001,1,1,21,22,62,40,A
yuyoyu 2009.10.09,1001,1,1,21,17,52,35,B
yuyoyu 2009.10.09,1001,1,1,21,13,62,49,C
pinkbunny 2009.08.22,892,2,2,26,178,38,-140,A
pinkbunny 2009.08.22,892,2,2,26,189,31,-158,B
Tyranth 2009.08.22,1068,1,0,14,270,21,-249,A
Tyranth 2009.08.22,1068,1,0,14,277,21,-256,B
paderboots 2009.08.19,874,2,1.5,31,113,39,-74,A
paderboots 2009.08.19,874,2,1.5,31,113,39,-74,B
robbienorma 2009.08.19,1080,1,0.5,14,107,50,-57,A
robbienorma 2009.08.19,1080,1,0.5,14,108,57,-51,B
reframed 2009.08.13,899,2,1,44,199,39,-160,A
reframed 2009.08.13,899,2,1,44,211,36,-175,B
OSZCAR 2009.08.13,1017,1,1,20,105,45,-60,A
OSZCAR 2009.08.13,1017,1,1,20,125,35,-90,B
CHIMOL 2009.08.25,958,1,0,21,114,33,-81,A
CHIMOL 2009.08.25,958,1,0,21,108,33,-75,B
Bhunt 2009.08.25,983,1,1,22,192,27,-165,A
Bhunt 2009.08.25,983,1,1,22,189,23,-166,B
pinkbunny 2009.08.23,926,2,0,31,222,32,-190,A
pinkbunny 2009.08.23,926,2,0,31,209,36,-173,B
ktinfl 2009.08.23,904,1,1,18,166,22,-144,A
ktinfl 2009.08.23,904,1,1,18,162,22,-140,B
DaydreamXXI 2009.08.16,977,2,0,37,131,24,-107,A
DaydreamXXI 2009.08.16,977,2,0,37,123,24,-99,B
ElevatorJoe 2009.08.16,992,9,8,94,176,40,-136,A
ElevatorJoe 2009.08.16,992,9,8,94,171,43,-128,B
Loran 2009.10.07,769,1,0,7,289,14,-275,A
Loran 2009.10.07,769,1,0,7,292,14,-278,B
pinkbunny 2009.08.21,884,1,1,29,158,45,-113,A
pinkbunny 2009.08.21,884,1,1,29,161,45,-116,B
badstep 2009.08.21,1055,2,1,34,161,35,-126,A
badstep 2009.08.21,1055,2,1,34,162,35,-127,B
TheRedSkin 2009.10.07,964,1,0,13,366,38,-328,A
TheRedSkin 2009.10.07,964,1,0,13,349,38,-311,B
LaurentDelaon 2009.08.18,1059,2,1,24,257,25,-232,A
LaurentDelaon 2009.08.18,1059,2,1,24,243,33,-210,B
pinkbunny 2009.08.18,851,3,1,35,270,20,-250,A
pinkbunny 2009.08.18,851,3,1,35,244,26,-218,B
pinkbunny 2009.08.16,931,12,2,133,267,32,-235,A
pinkbunny 2009.08.16,931,12,2,133,267,31,-236,B
AlfredJ 2009.08.18,1032,1,1,11,108,46,-62,A
AlfredJ 2009.08.18,1032,1,1,11,110,46,-64,B
russkime 2009.08.18,962,1,0,12,237,25,-212,A
russkime 2009.08.18,962,1,0,12,228,17,-211,B
samoancharger 2009.08.16,982,4,4,53,182,36,-146,A
samoancharger 2009.08.16,982,4,4,53,194,36,-158,B
sospo 2009.08.21,1034,1,0,10,255,20,-235,A
sospo 2009.08.21,1034,1,0,10,240,20,-220,B
GMenBigBlue 2009.08.21,1015,2,1,16,106,25,-81,A
GMenBigBlue 2009.08.21,1015,2,1,16,118,31,-87,B
tdalex 2009.08.24,1146,1,1,12,93,33,-60,A
tdalex 2009.08.24,1146,1,1,12,80,50,-30,B
xSnakex 2009.08.24,843,1,0,12,142,33,-109,A
xSnakex 2009.08.24,843,1,0,12,150,25,-125,B
antharas 2009.10.07,955,1,0,33,278,21,-257,A
antharas 2009.10.07,955,1,0,33,286,21,-265,B
Xoppo 2009.08.17,1073,2,2,21,291,29,-262,A
Xoppo 2009.08.17,1073,2,2,21,280,29,-251,B
pinkbunny 2009.08.17,763,5,2,57,331,21,-310,A
pinkbunny 2009.08.17,763,5,2,57,333,21,-312,B
lowandbehold 2009.08.24,876,2,1.5,32,141,50,-91,A
lowandbehold 2009.08.24,876,2,1.5,32,150,44,-106,B
pinkbunny 2009.08.19,859,1,0,18,368,28,-340,A
pinkbunny 2009.08.19,859,1,0,18,351,22,-329,B
Bhunt 2009.08.19,1047,1,1,17,330,29,-301,A
Bhunt 2009.08.19,1047,1,1,17,322,24,-298,B
graystanley 2009.08.21,898,1,0,18,181,11,-170,A
graystanley 2009.08.21,898,1,0,18,174,17,-157,B
rylruler 2009.08.17,946,1,0,25,275,24,-251,A
rylruler 2009.08.17,946,1,0,25,280,20,-260,B
wildbeal 2009.08.17,989,1,1,21,123,48,-75,A
wildbeal 2009.08.17,989,1,1,21,128,48,-80,B
Hazardo 2009.08.24,964,1,1,14,160,29,-131,A
Hazardo 2009.08.24,964,1,1,14,148,21,-127,B
ANDYTASTIC 2009.08.17,1018,1,0,11,327,27,-300,A
ANDYTASTIC 2009.08.17,1018,1,0,11,320,27,-293,B
Booyens 2009.08.17,933,1,1,9,186,22,-164,A
Booyens 2009.08.17,933,1,1,9,151,22,-129,B
AlfredJ 2009.08.23,1051,1,1,9,76,67,-9,A
AlfredJ 2009.08.23,1051,1,1,9,57,44,-13,B
joulu 2009.08.24,916,1,0,23,331,13,-318,A
joulu 2009.08.24,916,1,0,23,329,13,-316,B
terminatordude 2009.08.17,1034,1,0,6,283,17,-266,A
terminatordude 2009.08.17,1034,1,0,6,255,17,-238,B
reframed 2009.08.19,1069,1,0,17,167,29,-138,A
reframed 2009.08.19,1069,1,0,17,163,29,-134,B
telepathetic 2009.08.13,1000,1,0,17,349,18,-331,A
telepathetic 2009.08.13,1000,1,0,17,366,12,-354,B
zqnzt 2009.06.28,1017,1,0,20,154,30,-124,A
zqnzt 2009.06.28,1017,1,0,20,161,30,-131,B
LeyZ 2009.06.28,864,1,1,19,106,47,-59,A
LeyZ 2009.06.28,864,1,1,19,101,53,-48,B
reframed 2009.08.20,1066,1,0.5,12,277,33,-244,A
reframed 2009.08.20,1066,1,0.5,12,265,42,-223,B
Hazardo 2009.08.19,953,3,0,45,266,24,-242,A
Hazardo 2009.08.19,953,3,0,45,246,22,-224,B
gobemouche 2009.08.19,961,1,1,11,98,27,-71,A
gobemouche 2009.08.19,961,1,1,11,77,18,-59,B
gobemouche 2009.08.18,993,1,0,21,250,19,-231,A
gobemouche 2009.08.18,993,1,0,21,208,19,-189,B
Hazardo 2009.08.18,944,1,1,17,102,47,-55,A
Hazardo 2009.08.18,944,1,1,17,152,47,-105,B
franzgabo 2009.08.24,918,1,0,29,152,31,-121,A
franzgabo 2009.08.24,918,1,0,29,149,38,-111,B
Hazardo 2009.08.21,929,1,1,7,157,57,-100,A
Hazardo 2009.08.21,929,1,1,7,148,57,-91,B
smalldreams 2009.08.16,1084,1,0,12,206,8,-198,A
smalldreams 2009.08.16,1084,1,0,12,190,8,-182,B
TheDancingQueen 2009.08.12,867,2,0,28,451,18,-433,A
TheDancingQueen 2009.08.12,867,2,0,28,433,14,-419,B
EvilQueen 2009.08.12,1006,2,2,21,334,19,-315,A
EvilQueen 2009.08.12,1006,2,2,21,348,10,-338,B
sigggih 2009.08.22,1065,1,0,9,311,11,-300,A
sigggih 2009.08.22,1065,1,0,9,291,11,-280,B
brickell 2009.08.21,946,1,1,8,176,0,-176,A
brickell 2009.08.21,946,1,1,8,159,0,-159,B
ANDYTASTIC 2009.08.19,1012,2,2,28,211,14,-197,A
ANDYTASTIC 2009.08.19,1012,2,2,28,184,18,-166,B
lousychess 2009.08.17,1131,1,1,10,194,10,-184,A
lousychess 2009.08.17,1131,1,1,10,173,10,-163,B
DeanMartin 2009.08.18,1125,1,1,9,185,67,-118,A
DeanMartin 2009.08.18,1125,1,1,9,172,44,-128,B
TheDancingQueen 2009.08.14,781,2,0,16,416,6,-410,A
TheDancingQueen 2009.08.14,781,2,0,16,370,6,-364,B
JHennessey 2009.08.14,1208,1,1,3,211,0,-211,A
JHennessey 2009.08.14,1208,1,1,3,272,0,-272,B
Admirn 2009.08.16,967,1,0,9,263,11,-252,A
Admirn 2009.08.16,967,1,0,9,290,11,-279,B
jewhouse 2009.08.16,1001,1,1,8,184,38,-146,A
jewhouse 2009.08.16,1001,1,1,8,187,38,-149,B
smalldreams 2009.08.17,1087,1,0,11,508,9,-499,A
smalldreams 2009.08.17,1087,1,0,11,505,9,-496,B
MrFrogees 2009.08.12,1108,1,1,12,184,33,-151,A
MrFrogees 2009.08.12,1108,1,1,12,210,17,-193,B
chrcoluk 2009.08.12,868,1,0,13,333,38,-295,A
chrcoluk 2009.08.12,868,1,0,13,340,38,-302,B
Bhunt 2009.08.14,1009,1,1,28,278,43,-235,A
Bhunt 2009.08.14,1009,1,1,28,216,46,-170,B
Hazardo 2009.08.14,983,1,0,32,298,38,-260,A
Hazardo 2009.08.14,983,1,0,32,290,31,-259,B
Kleppi 2009.08.13,1034,1,0,8,237,25,-212,A
Kleppi 2009.08.13,1034,1,0,8,248,25,-223,B
aixrad 2009.08.13,939,1,1,7,98,29,-69,A
aixrad 2009.08.13,939,1,1,7,102,29,-73,B
rylruler 2009.08.13,957,1,0,23,165,39,-126,A
rylruler 2009.08.13,957,1,0,23,190,30,-160,B
ElevatorJoe 2009.08.13,998,2,1,62,168,39,-129,A
ElevatorJoe 2009.08.13,998,2,1,62,163,35,-128,B
lucasdawn 2009.08.16,906,1,0,12,239,33,-206,A
lucasdawn 2009.08.16,906,1,0,12,230,33,-197,B
ANDYTASTIC 2009.08.16,1017,1,1,7,179,29,-150,A
ANDYTASTIC 2009.08.16,1017,1,1,7,162,43,-119,B
EvilQueen 2009.08.14,1020,1,1,8,150,25,-125,A
EvilQueen 2009.08.14,1020,1,1,8,121,25,-96,B
HareBrain 2009.08.13,846,1,1,36,198,39,-159,A
HareBrain 2009.08.13,846,1,1,36,188,39,-149,B
wilz 2009.01.11,886,1,1,6,116,50,-66,A
wilz 2009.01.11,886,1,1,6,108,50,-58,B
Deadache 2009.01.11,1081,1,0,6,224,33,-191,A
Deadache 2009.01.11,1081,1,0,6,251,33,-218,B
fjjvh 2009.03.27,700,18,0.5,260,266,19,-247,A
fjjvh 2009.03.27,700,18,0.5,260,265,17,-248,B
tigerblue 2009.03.27,1142,18,17.5,220,157,22,-135,A
tigerblue 2009.03.27,1142,18,17.5,220,151,22,-129,B
robertpmntr 2009.03.26,900,2,2,39,186,28,-158,A
robertpmntr 2009.03.26,900,2,2,39,185,31,-154,B
treezen 2009.03.26,1033,2,0,36,119,31,-88,A
treezen 2009.03.26,1033,2,0,36,124,31,-93,B
BMANMILES 2009.03.26,974,1,1,14,197,21,-176,A
BMANMILES 2009.03.26,974,1,1,14,187,14,-173,B
awen 2009.03.26,940,2,1,19,162,32,-130,A
awen 2009.03.26,940,2,1,19,169,26,-143,B
LDopa 2009.01.16,1074,1,0,22,183,36,-147,A
LDopa 2009.01.16,1074,1,0,22,191,32,-159,B
JEFFMHOW 2009.01.16,921,1,1,19,190,37,-153,A
JEFFMHOW 2009.01.16,921,1,1,19,188,42,-146,B
LDopa 2009.01.13,1022,1,1,5,277,20,-257,A
LDopa 2009.01.13,1022,1,1,5,261,40,-221,B
Crashinator 2009.01.13,814,1,0,9,706,0,-706,A
Crashinator 2009.01.13,814,1,0,9,710,0,-710,B
vetteboy 2009.01.03,920,1,1,18,240,22,-218,A
vetteboy 2009.01.03,920,1,1,18,237,28,-209,B
HogSlayer 2009.01.03,923,1,0,17,221,41,-180,A
HogSlayer 2009.01.03,923,1,0,17,211,47,-164,B
JEFFMHOW 2009.01.15,945,2,1,54,135,33,-102,A
JEFFMHOW 2009.01.15,945,2,1,54,135,31,-104,B
ashwinshivani 2009.01.15,940,2,1,52,160,23,-137,A
ashwinshivani 2009.01.15,940,2,1,52,161,21,-140,B
gilandrew 2009.03.27,898,1,0.5,21,194,24,-170,A
gilandrew 2009.03.27,898,1,0.5,21,193,29,-164,B
nicholasjanssen 2009.03.27,988,1,0.5,23,228,26,-202,A
nicholasjanssen 2009.03.27,988,1,0.5,23,230,26,-204,B
FMH 2009.01.11,1115,1,1,11,93,9,-84,A
FMH 2009.01.11,1115,1,1,11,88,18,-70,B
Crashinator 2009.01.11,799,2,1,37,179,22,-157,A
Crashinator 2009.01.11,799,2,1,37,183,19,-164,B
DarthDaviz 2009.03.26,1005,2,1,10,286,30,-256,A
DarthDaviz 2009.03.26,1005,2,1,10,264,40,-224,B
PLUGZ 2009.03.26,988,2,1,9,190,33,-157,A
PLUGZ 2009.03.26,988,2,1,9,161,33,-128,B
paire 2009.03.13,1216,3,2.5,49,262,16,-246,A
paire 2009.03.13,1216,3,2.5,49,250,18,-232,B
fjjvh 2009.03.13,690,3,0.5,55,398,16,-382,A
fjjvh 2009.03.13,690,3,0.5,55,413,16,-397,B
fjjvh 2009.03.10,708,6,0,86,327,19,-308,A
fjjvh 2009.03.10,708,6,0,86,315,17,-298,B
JamesJohnson 2009.03.10,1236,1,1,6,157,17,-140,A
JamesJohnson 2009.03.10,1236,1,1,6,103,17,-86,B
Psao 2009.03.11,954,1,1,7,103,14,-89,A
Psao 2009.03.11,954,1,1,7,100,14,-86,B
Benly 2009.03.11,865,4,1,47,169,32,-137,A
Benly 2009.03.11,865,4,1,47,152,32,-120,B
Uncrowned 2009.02.21,917,1,1,11,178,0,-178,A
Uncrowned 2009.02.21,917,1,1,11,175,9,-166,B
Crashinator 2009.02.21,929,1,0,11,298,18,-280,A
Crashinator 2009.02.21,929,1,0,11,285,9,-276,B
Limzaroth 2009.03.30,791,1,0,10,173,0,-173,A
Limzaroth 2009.03.30,791,1,0,10,145,20,-125,B
thebigmac 2009.03.30,999,1,1,10,108,40,-68,A
thebigmac 2009.03.30,999,1,1,10,93,40,-53,B
jatwfn 2009.03.28,1073,3,3,44,159,30,-129,A
jatwfn 2009.03.28,1073,3,3,44,137,27,-110,B
fjjvh 2009.03.28,680,4,0,88,461,5,-456,A
fjjvh 2009.03.28,680,4,0,88,448,7,-441,B
ktinfl 2009.01.14,921,1,0,13,261,8,-253,A
ktinfl 2009.01.14,921,1,0,13,272,8,-264,B
vetteboy 2009.01.14,956,1,1,13,216,31,-185,A
vetteboy 2009.01.14,956,1,1,13,212,31,-181,B
AureA 2009.03.30,1003,3,1.5,39,163,41,-122,A
AureA 2009.03.30,1003,3,1.5,39,163,41,-122,B
Soilwork 2009.03.30,900,1,0,12,309,8,-301,A
Soilwork 2009.03.30,900,1,0,12,396,8,-388,B
vetteboy 2009.01.13,942,1,1,12,162,42,-120,A
vetteboy 2009.01.13,942,1,1,12,146,50,-96,B
Devekut 2009.01.13,985,1,0,15,475,13,-462,A
Devekut 2009.01.13,985,1,0,15,374,20,-354,B
PABOY 2009.01.04,881,1,1,15,296,20,-276,A
PABOY 2009.01.04,881,1,1,15,280,20,-260,B
mudbog 2009.01.04,1115,1,0,15,379,20,-359,A
mudbog 2009.01.04,1115,1,0,15,374,27,-347,B
pendaggie 2009.01.05,868,1,0,51,204,29,-175,A
pendaggie 2009.01.05,868,1,0,51,201,29,-172,B
fishmasters 2009.01.05,1079,1,1,49,178,26,-152,A
fishmasters 2009.01.05,1079,1,1,49,173,31,-142,B
jkkcole 2009.01.10,974,2,1.5,16,180,25,-155,A
jkkcole 2009.01.10,974,2,1.5,16,175,38,-137,B
pmineiro 2009.01.10,888,1,0.5,8,187,0,-187,A
pmineiro 2009.01.10,888,1,0.5,8,194,12,-182,B
fishmasters 2009.01.10,1031,1,0,11,238,9,-229,A
fishmasters 2009.01.10,1031,1,0,11,247,9,-238,B
vetteboy 2009.01.10,925,2,1,18,302,0,-302,A
vetteboy 2009.01.10,925,2,1,18,280,6,-274,B
vetteboy 2009.01.04,939,1,0,16,237,13,-224,A
vetteboy 2009.01.04,939,1,0,16,227,12,-215,B
FFDunn 2009.01.04,1051,1,1,13,128,31,-97,A
FFDunn 2009.01.04,1051,1,1,13,124,31,-93,B
awen 2009.03.24,964,1,0,14,231,21,-210,A
awen 2009.03.24,964,1,0,14,248,21,-227,B
vetteboy 2009.03.24,990,1,1,14,314,14,-300,A
vetteboy 2009.03.24,990,1,1,14,275,7,-268,B
RiverStyx 2009.03.23,891,2,1,9,415,11,-404,A
RiverStyx 2009.03.23,891,2,1,9,397,22,-375,B
teihlard 2009.03.23,1041,1,1,5,136,40,-96,A
teihlard 2009.03.23,1041,1,1,5,129,40,-89,B
Vaudevillian 2009.01.05,1054,1,0,16,222,25,-197,A
Vaudevillian 2009.01.05,1054,1,0,16,201,25,-176,B
gforced 2009.01.05,926,1,1,14,122,14,-108,A
gforced 2009.01.05,926,1,1,14,109,21,-88,B
elnekave 2009.03.20,896,1,0,8,297,12,-285,A
elnekave 2009.03.20,896,1,0,8,283,25,-258,B
pmineiro 2009.03.20,904,1,1,7,78,43,-35,A
pmineiro 2009.03.20,904,1,1,7,72,43,-29,B
plumbo 2009.03.30,848,1,1,14,106,43,-63,A
plumbo 2009.03.30,848,1,1,14,74,50,-24,B
caga 2009.03.28,1305,1,1,9,385,22,-363,A
caga 2009.03.28,1305,1,1,9,383,22,-361,B
lamell 2009.01.15,814,2,0,10,111,10,-101,A
lamell 2009.01.15,814,2,0,10,117,10,-107,B
AmpedAl 2009.01.15,1058,2,2,11,86,36,-50,A
AmpedAl 2009.01.15,1058,2,2,11,84,36,-48,B
MagicCube 2009.03.23,949,2,1,18,196,33,-163,A
MagicCube 2009.03.23,949,2,1,18,130,22,-108,B
PABOY 2009.03.23,1004,1,1,13,99,31,-68,A
PABOY 2009.03.23,1004,1,1,13,96,31,-65,B
maraman 2009.03.28,998,1,0,7,229,14,-215,A
maraman 2009.03.28,998,1,0,7,246,14,-232,B
LUPULEAC 2009.03.28,984,1,1,6,45,67,22,A
LUPULEAC 2009.03.28,984,1,1,6,49,67,18,B
JohnWinthrop 2009.01.12,1172,1,1,12,75,33,-42,A
JohnWinthrop 2009.01.12,1172,1,1,12,67,42,-25,B
Crashinator 2009.01.12,817,1,0,19,304,37,-267,A
Crashinator 2009.01.12,817,1,0,19,268,26,-242,B
fishmasters 2009.01.03,873,1,1,13,134,31,-103,A
fishmasters 2009.01.03,873,1,1,13,159,23,-136,B
brainllama 2009.01.03,983,1,0,9,165,33,-132,A
brainllama 2009.01.03,983,1,0,9,170,22,-148,B
Akio 2009.03.30,954,1,0.5,15,185,27,-158,A
Akio 2009.03.30,954,1,0.5,15,162,47,-115,B
AureA 2009.03.29,986,1,0.5,13,116,38,-78,A
AureA 2009.03.29,986,1,0.5,13,101,38,-63,B
Nifteind 2009.03.29,979,1,0.5,13,104,31,-73,A
Nifteind 2009.03.29,979,1,0.5,13,120,31,-89,B
Crashinator 2009.01.15,822,1,0,8,178,12,-166,A
Crashinator 2009.01.15,822,1,0,8,200,0,-200,B
fishmasters 2009.01.15,1037,1,1,7,133,14,-119,A
fishmasters 2009.01.15,1037,1,1,7,124,29,-95,B
AureA 2009.03.28,1035,1,1,33,151,18,-133,A
AureA 2009.03.28,1035,1,1,33,142,18,-124,B
plumbo 2009.03.28,908,1,0,33,141,39,-102,A
plumbo 2009.03.28,908,1,0,33,136,39,-97,B
Thorolas 2009.01.13,924,1,1,32,187,31,-156,A
Thorolas 2009.01.13,924,1,1,32,185,31,-154,B
ashwinshivani 2009.01.13,976,1,0,29,225,17,-208,A
ashwinshivani 2009.01.13,976,1,0,29,190,21,-169,B
Crashinator 2009.01.07,815,1,0,19,274,16,-258,A
Crashinator 2009.01.07,815,1,0,19,213,21,-192,B
SmashBrosBrawl 2009.01.07,1112,1,1,17,110,24,-86,A
SmashBrosBrawl 2009.01.07,1112,1,1,17,92,29,-63,B
fjjvh 2009.03.21,686,5,2,116,202,27,-175,A
fjjvh 2009.03.21,686,5,2,116,193,28,-165,B
chmpf 2009.03.21,947,5,3,110,190,28,-162,A
chmpf 2009.03.21,947,5,3,110,195,28,-167,B
jarnaud 2009.01.12,1076,1,0,12,214,25,-189,A
jarnaud 2009.01.12,1076,1,0,12,228,25,-203,B
Admirn 2009.01.12,908,1,1,11,246,18,-228,A
Admirn 2009.01.12,908,1,1,11,229,18,-211,B
AureA 2009.03.27,1108,1,0,6,235,33,-202,A
AureA 2009.03.27,1108,1,0,6,238,33,-205,B
BeauDog 2009.03.27,881,1,1,6,196,33,-163,A
BeauDog 2009.03.27,881,1,1,6,195,33,-162,B
IOOOOOWelcomesWeb 2009.03.23,1016,1,0,18,393,11,-382,A
IOOOOOWelcomesWeb 2009.03.23,1016,1,0,18,401,11,-390,B
awen 2009.03.23,962,2,1,22,400,23,-377,A
awen 2009.03.23,962,2,1,22,402,23,-379,B
Deltaprism 2009.03.11,1059,3,2,40,88,60,-28,A
Deltaprism 2009.03.11,1059,3,2,40,88,57,-31,B
Deltaprism 2009.03.11,1059,3,2,40,89,60,-29,C
Deltaprism 2009.03.11,1059,3,2,40,89,57,-32,D
paire 2009.03.10,1242,3,3,46,215,17,-198,A
paire 2009.03.10,1242,3,3,46,209,20,-189,B
Crashinator 2009.02.15,884,1,0,13,184,15,-169,A
Crashinator 2009.02.15,884,1,0,13,195,8,-187,B
Sebbel 2009.02.15,1035,1,1,10,71,50,-21,A
Sebbel 2009.02.15,1035,1,1,10,49,60,11,B
volodymyrrudyj 2009.01.06,1067,1,0,8,331,37,-294,A
volodymyrrudyj 2009.01.06,1067,1,0,8,275,38,-237,B
Beerbong 2009.01.06,932,2,1,23,215,22,-193,A
Beerbong 2009.01.06,932,2,1,23,211,30,-181,B
Sebbel 2009.01.06,900,1,1,12,117,25,-92,A
Sebbel 2009.01.06,900,1,1,12,110,33,-77,B
Soilwork 2009.03.26,916,1,1,18,258,28,-230,A
Soilwork 2009.03.26,916,1,1,18,372,22,-350,B
chesseeka 2009.03.26,1008,1,0,13,208,46,-162,A
chesseeka 2009.03.26,1008,1,0,13,216,38,-178,B
Ezeled 2009.03.23,1027,1,0,4,381,0,-381,A
Ezeled 2009.03.23,1027,1,0,4,300,0,-300,B
Beerbong 2009.01.09,955,1,0,26,128,31,-97,A
Beerbong 2009.01.09,955,1,0,26,129,35,-94,B
SunRaphi 2009.01.09,995,1,1,25,76,44,-32,A
SunRaphi 2009.01.09,995,1,1,25,79,48,-31,B
chadsmith 2009.03.26,1067,1,0,9,337,0,-337,A
chadsmith 2009.03.26,1067,1,0,9,397,11,-386,B
fjjvh 2009.03.19,691,12,1.5,183,360,10,-350,A
fjjvh 2009.03.19,691,12,1.5,183,354,11,-343,B
jatwfn 2009.03.19,1067,11,9.5,130,280,18,-262,A
jatwfn 2009.03.19,1067,11,9.5,130,277,15,-262,B
ohaighain 2009.03.18,1021,1,1,11,69,36,-33,A
ohaighain 2009.03.18,1021,1,1,11,57,36,-21,B
biplobibeginner 2009.03.18,968,1,0,12,125,8,-117,A
biplobibeginner 2009.03.18,968,1,0,12,133,17,-116,B
Sebbel 2009.01.03,921,1,0,24,94,29,-65,A
Sebbel 2009.01.03,921,1,0,24,79,42,-37,B
acmauroe 2009.01.03,909,1,1,23,49,52,3,A
acmauroe 2009.01.03,909,1,1,23,51,39,-12,B
robertpmntr 2009.03.21,955,1,0,43,183,26,-157,A
robertpmntr 2009.03.21,955,1,0,43,191,26,-165,B
IWON 2009.03.21,1016,1,1,40,96,45,-51,A
IWON 2009.03.21,1016,1,1,40,112,48,-64,B
mclaro 2009.01.08,1047,1,0,14,248,0,-248,A
mclaro 2009.01.08,1047,1,0,14,326,0,-326,B
PABOY 2009.01.08,918,1,1,9,110,22,-88,A
PABOY 2009.01.08,918,1,1,9,130,22,-108,B
chmpf 2009.03.20,951,1,0,16,361,25,-336,A
chmpf 2009.03.20,951,1,0,16,363,25,-338,B
ccf 2009.03.20,1005,1,1,12,152,42,-110,A
ccf 2009.03.20,1005,1,1,12,156,42,-114,B
PABOY 2009.01.06,897,1,0.5,18,167,44,-123,A
PABOY 2009.01.06,897,1,0.5,18,167,50,-117,B
ktinfl 2009.01.06,981,1,0.5,10,180,30,-150,A
ktinfl 2009.01.06,981,1,0.5,10,154,50,-104,B
chmpf 2009.03.16,960,2,1.5,10,120,30,-90,A
chmpf 2009.03.16,960,2,1.5,10,115,30,-85,B
fjjvh 2009.03.16,693,3,1.5,25,406,20,-386,A
fjjvh 2009.03.16,693,3,1.5,25,409,16,-393,B
golmman 2008.12.27,1044,1,1,6,172,17,-155,A
golmman 2008.12.27,1044,1,1,6,155,33,-122,B
Crashinator 2008.12.27,790,1,0,7,204,29,-175,A
Crashinator 2008.12.27,790,1,0,7,207,29,-178,B
Melkzedech 2009.01.02,1119,1,1,19,183,32,-151,A
Melkzedech 2009.01.02,1119,1,1,19,178,42,-136,B
fishmasters 2009.01.02,819,1,0,21,299,24,-275,A
fishmasters 2009.01.02,819,1,0,21,300,19,-281,B
awen 2009.03.18,891,1,0,10,348,10,-338,A
awen 2009.03.18,891,1,0,10,350,10,-340,B
LzVandy 2009.03.18,1062,1,1,9,107,56,-51,A
LzVandy 2009.03.18,1062,1,1,9,156,56,-100,B
ktinfl 2009.01.03,998,1,1,13,103,23,-80,A
ktinfl 2009.01.03,998,1,1,13,94,31,-63,B
jkkcole 2009.01.03,986,1,0,15,151,27,-124,A
jkkcole 2009.01.03,986,1,0,15,150,27,-123,B
fjjvh 2009.03.20,686,2,0.5,23,371,22,-349,A
fjjvh 2009.03.20,686,2,0.5,23,378,22,-356,B
paire 2009.03.20,1208,1,1,11,296,27,-269,A
paire 2009.03.20,1208,1,1,11,320,27,-293,B
fjjvh 2009.03.12,689,5,0.5,122,293,22,-271,A
fjjvh 2009.03.12,689,5,0.5,122,299,20,-279,B
chmpf 2009.03.12,961,3,2.5,62,307,29,-278,A
chmpf 2009.03.12,961,3,2.5,62,268,31,-237,B
Avisharv 2009.03.21,1020,1,0,17,251,24,-227,A
Avisharv 2009.03.21,1020,1,0,17,244,24,-220,B
awen 2009.03.21,885,1,1,15,151,47,-104,A
awen 2009.03.21,885,1,1,15,153,40,-113,B
fjjvh 2009.03.17,710,7,0,102,364,9,-355,A
fjjvh 2009.03.17,710,7,0,102,348,8,-340,B
jatwfn 2009.03.17,1045,7,7,88,273,13,-260,A
jatwfn 2009.03.17,1045,7,7,88,269,11,-258,B
paire 2009.03.15,1226,3,2.5,33,358,33,-325,A
paire 2009.03.15,1226,3,2.5,33,327,30,-297,B
fjjvh 2009.03.15,689,3,0.5,29,373,28,-345,A
fjjvh 2009.03.15,689,3,0.5,29,264,31,-233,B
Akio 2009.03.12,967,1,0,17,148,29,-119,A
Akio 2009.03.12,967,1,0,17,173,24,-149,B
Benly 2009.03.12,999,1,1,18,304,22,-282,A
Benly 2009.03.12,999,1,1,18,296,33,-263,B
jatwfn 2009.03.20,1071,1,0.5,9,168,44,-124,A
jatwfn 2009.03.20,1071,1,0.5,9,182,33,-149,B
Vosman 2009.03.18,1146,1,0.5,3,21,33,12,A
Vosman 2009.03.18,1146,1,0.5,3,63,33,-30,B
fjjvh 2009.03.18,689,2,0.5,12,413,0,-413,A
fjjvh 2009.03.18,689,2,0.5,12,308,0,-308,B
fjjvh 2009.03.08,726,12,1,238,409,11,-398,A
fjjvh 2009.03.08,726,12,1,238,391,13,-378,B
jatwfn 2009.03.08,1026,11,10,214,377,15,-362,A
jatwfn 2009.03.08,1026,11,10,214,368,14,-354,B
DaveMiddled 2009.03.05,853,1,1,7,201,57,-144,A
DaveMiddled 2009.03.05,853,1,1,7,220,29,-191,B
brainllama 2009.03.05,1020,1,0,6,48,50,2,A
brainllama 2009.03.05,1020,1,0,6,54,33,-21,B
lepomis 2009.02.26,953,1,1,22,52,27,-25,A
lepomis 2009.02.26,953,1,1,22,54,23,-31,B
KoalieAwe 2009.02.26,1009,1,0,25,59,40,-19,A
KoalieAwe 2009.02.26,1009,1,0,25,65,36,-29,B
Melvill 2009.02.07,981,1,0,11,137,36,-101,A
Melvill 2009.02.07,981,1,0,11,130,36,-94,B
LisbonNightTrain 2009.02.07,967,1,1,11,130,18,-112,A
LisbonNightTrain 2009.02.07,967,1,1,11,130,18,-112,B
Fukiyama 2009.02.18,834,1,1,20,204,20,-184,A
Fukiyama 2009.02.18,834,1,1,20,195,15,-180,B
Melvill 2009.02.18,1022,1,0,19,163,21,-142,A
Melvill 2009.02.18,1022,1,0,19,156,21,-135,B
paire 2009.03.19,1209,1,1,12,94,42,-52,A
paire 2009.03.19,1209,1,1,12,108,33,-75,B
IrishRottie 2009.03.13,990,1,1,27,125,33,-92,A
IrishRottie 2009.03.13,990,1,1,27,124,33,-91,B
Akio 2009.03.13,908,1,0,26,126,23,-103,A
Akio 2009.03.13,908,1,0,26,128,27,-101,B
jatwfn 2009.03.18,1063,1,1,3,108,33,-75,A
jatwfn 2009.03.18,1063,1,1,3,50,0,-50,B
jatwfn 2009.03.11,1040,6,6,84,292,15,-277,A
jatwfn 2009.03.11,1040,6,6,84,294,17,-277,B
fjjvh 2009.03.11,699,8,0.5,175,362,23,-339,A
fjjvh 2009.03.11,699,8,0.5,175,359,22,-337,B
paire 2009.03.09,1277,3,3,33,271,27,-244,A
paire 2009.03.09,1277,3,3,33,255,21,-234,B
fjjvh 2009.03.09,713,3,0,47,529,19,-510,A
fjjvh 2009.03.09,713,3,0,47,513,15,-498,B
elnekave 2009.02.26,916,1,0,11,257,27,-230,A
elnekave 2009.02.26,916,1,0,11,278,27,-251,B
ginjaninja 2009.02.26,1083,1,1,9,270,33,-237,A
ginjaninja 2009.02.26,1083,1,1,9,248,33,-215,B
paire 2009.03.14,1231,1,1,6,284,33,-251,A
paire 2009.03.14,1231,1,1,6,273,33,-240,B
fjjvh 2009.03.14,694,1,0,6,390,17,-373,A
fjjvh 2009.03.14,694,1,0,6,314,33,-281,B
chmpf 2009.03.11,975,2,1.5,57,368,19,-349,A
chmpf 2009.03.11,975,2,1.5,57,383,19,-364,B
Vosman 2009.03.12,1197,1,1,8,88,25,-63,A
Vosman 2009.03.12,1197,1,1,8,110,12,-98,B
procussionaire 2009.03.13,1061,1,1,11,177,54,-123,A
procussionaire 2009.03.13,1061,1,1,11,181,54,-127,B
titusm 2009.03.13,770,1,0,16,300,38,-262,A
titusm 2009.03.13,770,1,0,16,299,31,-268,B
paire 2009.03.12,1246,1,1,40,275,22,-253,A
paire 2009.03.12,1246,1,1,40,285,25,-260,B
paire 2009.03.16,1219,1,0,17,328,18,-310,A
paire 2009.03.16,1219,1,0,17,310,12,-298,B
JackPacman 2009.03.13,885,1,0,13,320,31,-289,A
JackPacman 2009.03.13,885,1,0,13,156,38,-118,B
Deltaprism 2009.03.13,1007,1,1,12,103,58,-45,A
Deltaprism 2009.03.13,1007,1,1,12,71,58,-13,B
jatwfn 2009.03.10,1036,2,2,27,317,15,-302,A
jatwfn 2009.03.10,1036,2,2,27,298,11,-287,B
vetteboy 2009.02.25,980,1,1,15,112,40,-72,A
vetteboy 2009.02.25,980,1,1,15,108,40,-68,B
Crashinator 2009.02.25,956,1,0,15,202,27,-175,A
Crashinator 2009.02.25,956,1,0,15,178,33,-145,B
ifuwurarabitidnmu 2009.02.17,1054,1,1,15,246,20,-226,A
ifuwurarabitidnmu 2009.02.17,1054,1,1,15,178,13,-165,B
chokefetuschoke 2009.02.17,910,1,0,17,250,29,-221,A
chokefetuschoke 2009.02.17,910,1,0,17,239,35,-204,B
bluepen 2009.03.12,857,1,0,12,164,33,-131,A
bluepen 2009.03.12,857,1,0,12,144,25,-119,B
TonyHappyChess 2009.03.12,1107,1,1,10,104,40,-64,A
TonyHappyChess 2009.03.12,1107,1,1,10,93,30,-63,B
fjjvh 2009.03.05,736,2,0,31,432,16,-416,A
fjjvh 2009.03.05,736,2,0,31,447,13,-434,B
jatwfn 2009.03.05,1017,2,2,36,503,11,-492,A
jatwfn 2009.03.05,1017,2,2,36,525,11,-514,B
JedTed 2009.02.10,1099,2,2,34,217,18,-199,A
JedTed 2009.02.10,1099,2,2,34,206,15,-191,B
ManWhoKilledDeer 2009.02.10,854,2,0,36,254,22,-232,A
ManWhoKilledDeer 2009.02.10,854,2,0,36,244,25,-219,B
paire 2009.03.08,1228,1,1,21,437,14,-423,A
paire 2009.03.08,1228,1,1,21,417,14,-403,B
Admirn 2009.02.28,970,1,1,24,127,29,-98,A
Admirn 2009.02.28,970,1,1,24,136,25,-111,B
Sirenus 2009.02.28,955,1,0,23,160,22,-138,A
Sirenus 2009.02.28,955,1,0,23,172,22,-150,B
Crashinator 2009.02.18,867,1,0,11,399,36,-363,A
Crashinator 2009.02.18,867,1,0,11,401,36,-365,B
pmineiro 2009.02.18,902,1,1,10,277,20,-257,A
pmineiro 2009.02.18,902,1,1,10,263,20,-243,B
indbug 2009.02.05,956,2,0.5,36,164,44,-120,A
indbug 2009.02.05,956,2,0.5,36,163,36,-127,B
indbug 2009.02.05,956,2,0.5,36,170,39,-131,C
staljin 2009.02.05,971,2,1.5,33,83,67,-16,A
staljin 2009.02.05,971,2,1.5,33,86,61,-25,B
staljin 2009.02.05,971,2,1.5,33,88,58,-30,C
sekulla 2009.01.29,857,3,0,24,325,17,-308,A
sekulla 2009.01.29,857,3,0,24,340,21,-319,B
Killerhoernchen 2009.01.29,1147,1,1,4,214,25,-189,A
Killerhoernchen 2009.01.29,1147,1,1,4,232,25,-207,B
fjjvh 2009.03.07,725,6,1,132,425,14,-411,A
fjjvh 2009.03.07,725,6,1,132,404,14,-390,B
jatwfn 2009.03.07,1026,6,5,121,291,19,-272,A
jatwfn 2009.03.07,1026,6,5,121,283,18,-265,B
gforced 2009.03.08,984,1,0,53,94,47,-47,A
gforced 2009.03.08,984,1,0,53,100,47,-53,B
churrcuz 2009.03.08,1015,1,1,54,87,43,-44,A
churrcuz 2009.03.08,1015,1,1,54,90,41,-49,B
awen 2009.03.08,883,1,0,6,197,33,-164,A
awen 2009.03.08,883,1,0,6,185,33,-152,B
genekhayyam 2009.03.08,1023,1,1,6,76,50,-26,A
genekhayyam 2009.03.08,1023,1,1,6,68,50,-18,B
Deadache 2009.03.06,1200,1,1,9,191,33,-158,A
Deadache 2009.03.06,1200,1,1,9,160,33,-127,B
fjjvh 2009.03.06,733,2,0,38,267,21,-246,A
fjjvh 2009.03.06,733,2,0,38,264,16,-248,B
nicksun 2009.01.25,981,2,1,51,109,33,-76,A
nicksun 2009.01.25,981,2,1,51,102,29,-73,B
RangoBango 2009.01.25,1002,1,1,26,73,50,-23,A
RangoBango 2009.01.25,1002,1,1,26,88,31,-57,B
jarnaud 2009.01.29,1051,1,1,6,280,0,-280,A
jarnaud 2009.01.29,1051,1,1,6,270,0,-270,B
achieve 2009.03.07,1067,1,1,10,141,40,-101,A
achieve 2009.03.07,1067,1,1,10,150,30,-120,B
MishaG 2009.03.07,915,1,0,10,235,0,-235,A
MishaG 2009.03.07,915,1,0,10,238,0,-238,B
Fukiyama 2009.03.05,975,1,1,11,243,18,-225,A
Fukiyama 2009.03.05,975,1,1,11,236,18,-218,B
pmineiro 2009.03.05,933,1,0,13,299,15,-284,A
pmineiro 2009.03.05,933,1,0,13,287,15,-272,B
chmpf 2009.03.04,956,1,1,24,226,8,-218,A
chmpf 2009.03.04,956,1,1,24,217,12,-205,B
fjjvh 2009.03.04,729,1,0,36,348,22,-326,A
fjjvh 2009.03.04,729,1,0,36,330,22,-308,B
insanemew 2009.02.25,1011,1,1,8,196,25,-171,A
insanemew 2009.02.25,1011,1,1,8,203,38,-165,B
Fukiyama 2009.02.25,984,1,0,9,363,22,-341,A
Fukiyama 2009.02.25,984,1,0,9,374,22,-352,B
jatwfn 2009.03.06,1023,1,1,26,210,27,-183,A
jatwfn 2009.03.06,1023,1,1,26,211,27,-184,B
Traenexx 2009.03.04,915,1,0.5,54,104,35,-69,A
Traenexx 2009.03.04,915,1,0.5,54,104,39,-65,B
Fukiyama 2009.03.04,913,1,0.5,50,91,38,-53,A
Fukiyama 2009.03.04,913,1,0.5,50,87,40,-47,B
Fukiyama 2009.02.21,776,1,0.5,11,180,18,-162,A
Fukiyama 2009.02.21,776,1,0.5,11,177,18,-159,B
TacticalDiligence 2009.02.21,1053,1,0.5,20,267,25,-242,A
TacticalDiligence 2009.02.21,1053,1,0.5,20,301,20,-281,B
Limzaroth 2009.02.20,936,2,1,27,304,26,-278,A
Limzaroth 2009.02.20,936,2,1,27,292,15,-277,B
chokefetuschoke 2009.02.20,885,2,1,26,285,12,-273,A
chokefetuschoke 2009.02.20,885,2,1,26,290,15,-275,B
jabziii 2009.02.18,1087,1,1,15,124,33,-91,A
jabziii 2009.02.18,1087,1,1,15,134,40,-94,B
Xillion 2009.02.18,909,1,0,15,188,27,-161,A
Xillion 2009.02.18,909,1,0,15,186,27,-159,B
bigjturner 2009.02.04,997,1,0.5,33,216,24,-192,A
bigjturner 2009.02.04,997,1,0.5,33,174,30,-144,B
rafaelpadua 2009.02.04,985,1,0.5,31,123,39,-84,A
rafaelpadua 2009.02.04,985,1,0.5,31,94,39,-55,B
Sirenus 2009.02.24,885,1,1,17,206,24,-182,A
Sirenus 2009.02.24,885,1,1,17,222,18,-204,B
ChessterQKnightly 2009.02.24,1111,1,0,16,259,31,-228,A
ChessterQKnightly 2009.02.24,1111,1,0,16,244,38,-206,B
ifuwurarabitidnmu 2009.02.21,1037,1,0.5,8,252,25,-227,A
ifuwurarabitidnmu 2009.02.21,1037,1,0.5,8,222,25,-197,B
chokefetuschoke 2009.02.21,885,1,0.5,9,429,11,-418,A
chokefetuschoke 2009.02.21,885,1,0.5,9,397,22,-375,B
MikeTheMaverick 2009.02.10,1039,1,1,5,63,80,17,A
MikeTheMaverick 2009.02.10,1039,1,1,5,57,80,23,B
sekulla 2009.02.10,799,1,0,6,369,17,-352,A
sekulla 2009.02.10,799,1,0,6,355,17,-338,B
texasroots 2009.02.08,967,1,1,25,139,24,-115,A
texasroots 2009.02.08,967,1,1,25,114,32,-82,B
bluepen 2009.02.08,997,1,0,25,128,28,-100,A
bluepen 2009.02.08,997,1,0,25,128,28,-100,B
uberpao 2009.02.04,1050,1,1,19,212,21,-191,A
uberpao 2009.02.04,1050,1,1,19,196,26,-170,B
Killerhoernchen 2009.02.04,983,2,0,28,260,18,-242,A
Killerhoernchen 2009.02.04,983,2,0,28,258,18,-240,B
PatatZonder 2009.01.29,1132,1,1,12,237,17,-220,A
PatatZonder 2009.01.29,1132,1,1,12,236,33,-203,B
treezen 2009.03.03,998,1,0.5,52,136,31,-105,A
treezen 2009.03.03,998,1,0.5,52,133,35,-98,B
Fukiyama 2009.03.03,905,1,0.5,49,113,37,-76,A
Fukiyama 2009.03.03,905,1,0.5,49,121,41,-80,B
kebax 2009.02.20,1128,1,1,7,119,14,-105,A
kebax 2009.02.20,1128,1,1,7,102,14,-88,B
Fukiyama 2009.02.20,817,1,0,8,159,12,-147,A
Fukiyama 2009.02.20,817,1,0,8,226,12,-214,B
sitkaak 2009.02.09,892,1,1,3,188,0,-188,A
sitkaak 2009.02.09,892,1,1,3,188,0,-188,B
lancearmstrong 2009.02.09,988,2,0,15,359,20,-339,A
lancearmstrong 2009.02.09,988,2,0,15,351,20,-331,B
chmpf 2009.02.07,966,1,0,10,284,40,-244,A
chmpf 2009.02.07,966,1,0,10,304,40,-264,B
ccf 2009.02.07,1005,1,1,9,230,33,-197,A
ccf 2009.02.07,1005,1,1,9,236,33,-203,B
JaysonE 2009.01.24,1052,1,1,31,130,52,-78,A
JaysonE 2009.01.24,1052,1,1,31,125,52,-73,B
JaysonE 2009.01.24,1052,1,1,31,133,48,-85,C
ktinfl 2009.01.24,897,1,0,30,183,23,-160,A
ktinfl 2009.01.24,897,1,0,30,181,20,-161,B
ktinfl 2009.01.24,897,1,0,30,181,20,-161,C
cweatherbe 2009.02.19,1020,1,0,17,351,29,-322,A
cweatherbe 2009.02.19,1020,1,0,17,289,35,-254,B
Crashinator 2009.02.19,857,1,1,13,182,61,-121,A
Crashinator 2009.02.19,857,1,1,13,156,46,-110,B
bigjturner 2009.02.14,984,1,1,10,99,30,-69,A
bigjturner 2009.02.14,984,1,1,10,108,20,-88,B
vetteboy 2009.02.14,1014,1,0,12,194,25,-169,A
vetteboy 2009.02.14,1014,1,0,12,252,25,-227,B
jmoon 2009.02.07,907,1,0,10,128,40,-88,A
jmoon 2009.02.07,907,1,0,10,159,40,-119,B
yoyojim 2009.02.07,1043,1,1,9,25,56,31,A
yoyojim 2009.02.07,1043,1,1,9,28,56,28,B
msbillions 2009.01.25,923,1,0,28,225,25,-200,A
msbillions 2009.01.25,923,1,0,28,167,25,-142,B
vcrazy 2009.01.11,1189,1,0,26,222,27,-195,A
vcrazy 2009.01.11,1189,1,0,26,215,23,-192,B
Giulietta 2008.09.14,1017,1,0,20,255,15,-240,A
Giulietta 2008.09.14,1017,1,0,20,266,15,-251,B
vetteboy 2008.09.14,875,1,1,21,406,10,-396,A
vetteboy 2008.09.14,875,1,1,21,373,10,-363,B
noncsi 2008.11.27,920,1,1,8,163,12,-151,A
noncsi 2008.11.27,920,1,1,8,174,12,-162,B
agfa 2008.11.27,1049,1,0,9,245,33,-212,A
agfa 2008.11.27,1049,1,0,9,262,33,-229,B
deeprince 2009.01.22,872,2,0,35,265,26,-239,A
deeprince 2009.01.22,872,2,0,35,263,26,-237,B
jaydottaylor 2009.01.22,1114,1,1,27,285,18,-267,A
jaydottaylor 2009.01.22,1114,1,1,27,296,22,-274,B
PABOY 2009.02.16,966,1,1,7,190,29,-161,A
PABOY 2009.02.16,966,1,1,7,166,29,-137,B
zhouzhaowu 2009.02.16,933,1,0,8,535,0,-535,A
zhouzhaowu 2009.02.16,933,1,0,8,425,12,-413,B
noncsi 2008.12.27,1008,1,1,13,203,15,-188,A
noncsi 2008.12.27,1008,1,1,13,190,15,-175,B
fishmasters 2008.12.27,854,1,0,15,305,20,-285,A
fishmasters 2008.12.27,854,1,0,15,320,13,-307,B
Crashinator 2009.02.01,845,3,0,56,349,13,-336,A
Crashinator 2009.02.01,845,3,0,56,328,16,-312,B
Admirn 2009.02.01,929,1,1,9,50,56,6,A
Admirn 2009.02.01,929,1,1,9,61,56,-5,B
calexander 2008.12.26,979,1,1,5,215,20,-195,A
calexander 2008.12.26,979,1,1,5,223,20,-203,B
tkfmffmdml 2008.12.26,949,1,0,4,284,25,-259,A
tkfmffmdml 2008.12.26,949,1,0,4,280,25,-255,B
Fukiyama 2009.02.24,1031,1,1,13,153,15,-138,A
Fukiyama 2009.02.24,1031,1,1,13,129,23,-106,B
elnekave 2009.02.24,916,1,0,12,149,25,-124,A
elnekave 2009.02.24,916,1,0,12,132,25,-107,B
EgyVoltron 2009.01.30,1163,1,0,13,368,31,-337,A
EgyVoltron 2009.01.30,1163,1,0,13,388,31,-357,B
deeprince 2009.01.30,801,2,2,23,101,43,-58,A
deeprince 2009.01.30,801,2,2,23,81,48,-33,B
Sebbel 2008.08.05,839,1,1,16,77,38,-39,A
Sebbel 2008.08.05,839,1,1,16,48,38,-10,B
Sinickas 2008.08.05,973,1,0,16,120,25,-95,A
Sinickas 2008.08.05,973,1,0,16,122,19,-103,B
Crashinator 2009.02.20,903,1,1,20,228,25,-203,A
Crashinator 2009.02.20,903,1,1,20,240,25,-215,B
Admirn 2009.02.20,974,1,0,20,299,15,-284,A
Admirn 2009.02.20,974,1,0,20,301,15,-286,B
JackPacman 2009.01.30,964,1,0,16,212,31,-181,A
JackPacman 2009.01.30,964,1,0,16,237,25,-212,B
nicksun 2009.01.30,1030,1,1,13,303,15,-288,A
nicksun 2009.01.30,1030,1,1,13,222,8,-214,B
munon 2009.01.29,993,1,1,43,78,37,-41,A
munon 2009.01.29,993,1,1,43,84,33,-51,B
luoyun 2009.01.29,864,1,0,43,81,42,-39,A
luoyun 2009.01.29,864,1,0,43,131,33,-98,B
gforced 2009.02.09,947,1,1,9,88,56,-32,A
gforced 2009.02.09,947,1,1,9,78,44,-34,B
jaydottaylor 2009.01.24,961,1,1,44,163,32,-131,A
jaydottaylor 2009.01.24,961,1,1,44,154,30,-124,B
minhhuan 2009.01.24,1027,1,0,45,229,18,-211,A
minhhuan 2009.01.24,1027,1,0,45,223,18,-205,B
JooBoo 2009.02.04,916,1,1,8,36,62,26,A
JooBoo 2009.02.04,916,1,1,8,43,62,19,B
majesticmagix 2009.01.30,1101,1,0,19,256,26,-230,A
majesticmagix 2009.01.30,1101,1,0,19,256,26,-230,B
geodezu 2009.01.18,980,1,0.5,23,124,26,-98,A
geodezu 2009.01.18,980,1,0.5,23,115,30,-85,B
JohntheChristian 2009.01.18,1014,1,0.5,22,90,36,-54,A
JohntheChristian 2009.01.18,1014,1,0.5,22,85,27,-58,B
Awais 2009.02.01,992,2,2,40,205,32,-173,A
Awais 2009.02.01,992,2,2,40,209,38,-171,B
caskakacastro 2009.01.27,935,1,0,16,277,31,-246,A
caskakacastro 2009.01.27,935,1,0,16,220,31,-189,B
nicksun 2009.01.27,1024,1,1,15,232,40,-192,A
nicksun 2009.01.27,1024,1,1,15,212,40,-172,B
Sebbel 2008.10.20,970,1,1,21,60,48,-12,A
Sebbel 2008.10.20,970,1,1,21,57,48,-9,B
JabZ 2008.10.20,927,1,0,20,98,25,-73,A
JabZ 2008.10.20,927,1,0,20,100,25,-75,B
skiparooni 2009.02.02,1059,1,0,31,200,45,-155,A
skiparooni 2009.02.02,1059,1,0,31,205,39,-166,B
DREZIO 2009.02.02,876,1,1,29,138,38,-100,A
DREZIO 2009.02.02,876,1,1,29,152,34,-118,B
Miggidy 2009.01.27,1158,1,1,8,86,62,-24,A
Miggidy 2009.01.27,1158,1,1,8,97,62,-35,B
Traenexx 2009.01.27,833,2,0,40,328,20,-308,A
Traenexx 2009.01.27,833,2,0,40,302,23,-279,B
gorkietalkie 2009.01.27,1100,1,1,31,304,29,-275,A
gorkietalkie 2009.01.27,1100,1,1,31,276,26,-250,B
OBAMAnyofacebitch 2009.01.22,1131,1,1,6,41,50,9,A
OBAMAnyofacebitch 2009.01.22,1131,1,1,6,90,17,-73,B
geodezu 2009.01.24,942,1,1,22,127,50,-77,A
geodezu 2009.01.24,942,1,1,22,115,59,-56,B
geodezu 2009.01.24,942,1,1,22,124,54,-70,C
vawaverunner 2009.01.24,1018,1,0,22,225,27,-198,A
vawaverunner 2009.01.24,1018,1,0,22,154,32,-122,B
vawaverunner 2009.01.24,1018,1,0,22,209,27,-182,C
nicksun 2009.01.23,984,1,0,17,292,18,-274,A
nicksun 2009.01.23,984,1,0,17,281,18,-263,B
kiwa 2009.01.23,993,1,1,14,159,43,-116,A
kiwa 2009.01.23,993,1,1,14,137,43,-94,B
sekulla 2009.01.22,958,1,0,11,270,18,-252,A
sekulla 2009.01.22,958,1,0,11,267,18,-249,B
Awais 2009.01.22,989,1,1,13,288,31,-257,A
Awais 2009.01.22,989,1,1,13,294,23,-271,B
Malfunction 2009.04.17,1081,2,1,25,232,24,-208,A
Malfunction 2009.04.17,1081,2,1,25,269,20,-249,B
jdchopra 2009.04.17,835,7,4,98,193,33,-160,A
jdchopra 2009.04.17,835,7,4,98,200,32,-168,B
rsrdjan 2009.07.26,999,1,1,15,85,27,-58,A
rsrdjan 2009.07.26,999,1,1,15,73,40,-33,B
nathy 2009.07.26,746,1,0,15,158,40,-118,A
nathy 2009.07.26,746,1,0,15,154,33,-121,B
Booyens 2009.07.03,982,3,0,34,368,15,-353,A
Booyens 2009.07.03,982,3,0,34,358,15,-343,B
GoGoYubari 2009.07.03,968,3,3,28,223,21,-202,A
GoGoYubari 2009.07.03,968,3,3,28,210,21,-189,B
Dlegend 2009.06.24,901,3,1,46,248,30,-218,A
Dlegend 2009.06.24,901,3,1,46,246,35,-211,B
borovo 2009.06.24,1040,3,2,46,279,30,-249,A
borovo 2009.06.24,1040,3,2,46,275,30,-245,B
natenael 2009.04.17,835,1,0,18,379,0,-379,A
natenael 2009.04.17,835,1,0,18,315,0,-315,B
SassySasha 2009.04.06,1039,1,1,19,215,16,-199,A
SassySasha 2009.04.06,1039,1,1,19,190,16,-174,B
elnekave 2009.04.06,884,1,0,22,376,27,-349,A
elnekave 2009.04.06,884,1,0,22,373,27,-346,B
Hazardo 2009.07.14,958,2,0,26,327,38,-289,A
Hazardo 2009.07.14,958,2,0,26,305,35,-270,B
Dicemice 2009.07.14,1026,2,2,24,186,25,-161,A
Dicemice 2009.07.14,1026,2,2,24,188,21,-167,B
SimSima 2007.01.31,962,1,1,21,151,52,-99,A
SimSima 2007.01.31,962,1,1,21,128,57,-71,B
SimSima 2007.01.31,962,1,1,21,114,57,-57,C
Jia 2007.01.31,1001,1,0,26,178,23,-155,A
Jia 2007.01.31,1001,1,0,26,163,27,-136,B
Jia 2007.01.31,1001,1,0,26,198,27,-171,C
Lelouchshinji 2009.06.24,869,2,0,12,367,33,-334,A
Lelouchshinji 2009.06.24,869,2,0,12,353,42,-311,B
dhally 2009.06.24,1152,1,1,4,134,50,-84,A
dhally 2009.06.24,1152,1,1,4,125,50,-75,B
Naym 2009.04.03,863,2,1,69,117,30,-87,A
Naym 2009.04.03,863,2,1,69,119,36,-83,B
gaangster 2009.04.03,1111,1,0,19,233,26,-207,A
gaangster 2009.04.03,1111,1,0,19,240,16,-224,B
badstep 2009.04.17,996,1,0,9,367,0,-367,A
badstep 2009.04.17,996,1,0,9,422,0,-422,B
MartyMcFlyyy 2009.04.14,1072,1,0,8,69,50,-19,A
MartyMcFlyyy 2009.04.14,1072,1,0,8,172,50,-122,B
chokefetuschoke 2009.04.14,907,1,1,14,258,29,-229,A
chokefetuschoke 2009.04.14,907,1,1,14,268,21,-247,B
NomadicEntropy 2009.04.07,873,2,0,23,359,17,-342,A
NomadicEntropy 2009.04.07,873,2,0,23,370,13,-357,B
herbkleiman 2009.04.07,1075,2,2,20,220,40,-180,A
herbkleiman 2009.04.07,1075,2,2,20,237,35,-202,B
Booyens 2009.07.25,970,3,0.5,60,156,33,-123,A
Booyens 2009.07.25,970,3,0.5,60,150,28,-122,B
andrejas 2009.07.25,969,3,2.5,58,175,40,-135,A
andrejas 2009.07.25,969,3,2.5,58,172,38,-134,B
GodsWrath 2009.04.17,1006,1,1,12,62,58,-4,A
GodsWrath 2009.04.17,1006,1,1,12,69,58,-11,B
badstep 2009.04.12,988,1,0.5,8,230,25,-205,A
badstep 2009.04.12,988,1,0.5,8,242,38,-204,B
petitwinnie 2009.04.12,1064,2,0.5,21,369,14,-355,A
petitwinnie 2009.04.12,1064,2,0.5,21,390,19,-371,B
Avisharv 2009.04.18,944,1,0,40,340,15,-325,A
Avisharv 2009.04.18,944,1,0,40,350,20,-330,B
jdchopra 2009.04.18,1003,1,1,34,190,41,-149,A
jdchopra 2009.04.18,1003,1,1,34,194,41,-153,B
thefourthhorseman 2009.04.13,990,1,0,11,242,27,-215,A
thefourthhorseman 2009.04.13,990,1,0,11,259,27,-232,B
chessboyjazz 2009.04.13,995,1,1,9,179,67,-112,A
chessboyjazz 2009.04.13,995,1,1,9,175,56,-119,B
jdchopra 2009.04.19,1072,1,1,20,145,25,-120,A
jdchopra 2009.04.19,1072,1,1,20,137,25,-112,B
Astronomas 2009.04.19,917,1,0,19,179,16,-163,A
Astronomas 2009.04.19,917,1,0,19,169,16,-153,B
Hazardo 2009.07.31,906,1,0,13,254,38,-216,A
Hazardo 2009.07.31,906,1,0,13,224,23,-201,B
badstep 2009.07.31,1027,1,1,15,367,13,-354,A
badstep 2009.07.31,1027,1,1,15,320,7,-313,B
stota 2009.07.29,927,1,0,35,199,23,-176,A
stota 2009.07.29,927,1,0,35,190,20,-170,B
SimonDedalus 2009.07.29,1061,1,1,34,204,15,-189,A
SimonDedalus 2009.07.29,1061,1,1,34,194,12,-182,B
SecondQueen 2009.07.28,1197,2,2,9,78,33,-45,A
SecondQueen 2009.07.28,1197,2,2,9,74,33,-41,B
Loran 2009.07.28,791,2,0,11,178,18,-160,A
Loran 2009.07.28,791,2,0,11,197,9,-188,B
nathy 2009.07.25,756,3,0,48,154,31,-123,A
nathy 2009.07.25,756,3,0,48,144,31,-113,B
maramures 2009.07.25,1010,3,3,42,127,31,-96,A
maramures 2009.07.25,1010,3,3,42,119,29,-90,B
Loran 2009.07.24,782,1,0.5,21,184,43,-141,A
Loran 2009.07.24,782,1,0.5,21,199,43,-156,B
Cgrittz 2009.07.24,1161,1,0.5,20,157,30,-127,A
Cgrittz 2009.07.24,1161,1,0.5,20,150,30,-120,B
nathy 2009.07.20,835,4,0,33,333,15,-318,A
nathy 2009.07.20,835,4,0,33,352,15,-337,B
chessboyjazz 2009.07.20,1050,1,1,6,58,50,-8,A
chessboyjazz 2009.07.20,1050,1,1,6,42,50,8,B
dubaddict 2009.04.17,893,2,0,31,212,23,-189,A
dubaddict 2009.04.17,893,2,0,31,214,16,-198,B
Hazardo 2009.04.17,934,1,1,9,107,33,-74,A
Hazardo 2009.04.17,934,1,1,9,105,33,-72,B
Traenexx 2009.04.11,880,1,1,23,318,22,-296,A
Traenexx 2009.04.11,880,1,1,23,305,22,-283,B
chesseeka 2009.04.11,1017,1,0,20,210,20,-190,A
chesseeka 2009.04.11,1017,1,0,20,188,20,-168,B
JHLD 2009.07.29,1057,2,2,33,99,45,-54,A
JHLD 2009.07.29,1057,2,2,33,93,46,-47,B
Loran 2009.07.29,782,2,0,42,197,24,-173,A
Loran 2009.07.29,782,2,0,42,195,12,-183,B
LavAzza 2009.07.29,760,2,1,28,186,29,-157,A
LavAzza 2009.07.29,760,2,1,28,201,25,-176,B
GoGoYubari 2009.07.29,1070,2,1,28,208,29,-179,A
GoGoYubari 2009.07.29,1070,2,1,28,209,29,-180,B
robocoop 2009.04.16,1048,1,1,6,110,17,-93,A
robocoop 2009.04.16,1048,1,1,6,72,33,-39,B
jdchopra 2009.04.16,875,1,0,8,348,25,-323,A
jdchopra 2009.04.16,875,1,0,8,339,25,-314,B
LisbonNightTrain 2009.04.13,983,1,1,34,69,38,-31,A
LisbonNightTrain 2009.04.13,983,1,1,34,69,35,-34,B
gilandrew 2009.04.13,912,1,0,36,133,25,-108,A
gilandrew 2009.04.13,912,1,0,36,140,25,-115,B
Flupkes 2009.04.17,1101,1,1,12,165,42,-123,A
Flupkes 2009.04.17,1101,1,1,12,166,33,-133,B
Hazardo 2009.04.16,913,1,1,5,54,60,6,A
Hazardo 2009.04.16,913,1,1,5,32,60,28,B
ukpfc 2009.04.16,866,1,0,5,337,20,-317,A
ukpfc 2009.04.16,866,1,0,5,314,20,-294,B
gameplan 2009.04.12,1143,1,1,9,116,44,-72,A
gameplan 2009.04.12,1143,1,1,9,112,44,-68,B
Drewan 2009.04.12,810,2,1,16,100,44,-56,A
Drewan 2009.04.12,810,2,1,16,114,38,-76,B
Fnorgmuffin 2009.04.08,772,1,0,10,263,10,-253,A
Fnorgmuffin 2009.04.08,772,1,0,10,240,20,-220,B
Jia 2009.04.08,1142,1,1,9,158,22,-136,A
Jia 2009.04.08,1142,1,1,9,147,22,-125,B
nathy 2009.07.28,734,1,0,22,337,18,-319,A
nathy 2009.07.28,734,1,0,22,333,18,-315,B
andrejas 2009.07.28,964,1,1,15,297,47,-250,A
andrejas 2009.07.28,964,1,1,15,296,33,-263,B
DaveMiddled 2009.04.13,900,1,1,12,59,33,-26,A
DaveMiddled 2009.04.13,900,1,1,12,61,33,-28,B
Crashinator 2009.04.13,1006,1,0,12,147,42,-105,A
Crashinator 2009.04.13,1006,1,0,12,180,25,-155,B
sterum 2009.04.12,1124,1,1,48,107,40,-67,A
sterum 2009.04.12,1124,1,1,48,100,38,-62,B
Fnorgmuffin 2009.04.12,734,1,0,53,171,40,-131,A
Fnorgmuffin 2009.04.12,734,1,0,53,183,42,-141,B
Crashinator 2009.04.08,980,1,1,6,178,17,-161,A
Crashinator 2009.04.08,980,1,1,6,151,17,-134,B
chessboyjazz 2009.04.08,991,1,0,7,363,29,-334,A
chessboyjazz 2009.04.08,991,1,0,7,347,14,-333,B
markhodges 2009.04.09,1137,1,1,21,172,33,-139,A
markhodges 2009.04.09,1137,1,1,21,137,33,-104,B
Fnorgmuffin 2009.04.09,757,1,0,21,196,29,-167,A
Fnorgmuffin 2009.04.09,757,1,0,21,151,29,-122,B
robertpmntr 2009.04.07,1031,1,0,25,152,20,-132,A
robertpmntr 2009.04.07,1031,1,0,25,142,28,-114,B
Akio 2009.04.07,925,1,1,21,75,48,-27,A
Akio 2009.04.07,925,1,1,21,65,43,-22,B
Waggaristo 2009.04.13,1070,1,0,30,153,30,-123,A
Waggaristo 2009.04.13,1070,1,0,30,153,37,-116,B
insanemew 2009.04.13,918,1,1,28,91,32,-59,A
insanemew 2009.04.13,918,1,1,28,94,36,-58,B
tigerblue 2009.04.05,1154,1,1,7,70,43,-27,A
tigerblue 2009.04.05,1154,1,1,7,79,29,-50,B
fjjvh 2009.04.05,660,1,0,7,261,0,-261,A
fjjvh 2009.04.05,660,1,0,7,285,0,-285,B
cjmaeder 2009.04.04,754,1,1,22,212,27,-185,A
cjmaeder 2009.04.04,754,1,1,22,235,27,-208,B
Mrachni 2009.04.04,1040,1,0,22,277,18,-259,A
Mrachni 2009.04.04,1040,1,0,22,282,18,-264,B
ktinfl 2009.07.27,863,1,1,13,118,15,-103,A
ktinfl 2009.07.27,863,1,1,13,116,31,-85,B
Bmoresoldier 2009.07.27,967,1,0,16,294,19,-275,A
Bmoresoldier 2009.07.27,967,1,0,16,354,12,-342,B
fjjvh 2009.04.02,669,2,0.5,25,437,4,-433,A
fjjvh 2009.04.02,669,2,0.5,25,426,4,-422,B
tigerblue 2009.04.02,1152,1,1,6,300,17,-283,A
tigerblue 2009.04.02,1152,1,1,6,329,17,-312,B
catfu 2009.07.31,1024,1,1,21,191,38,-153,A
catfu 2009.07.31,1024,1,1,21,205,33,-172,B
ANDYTASTIC 2009.07.31,969,1,0,17,189,41,-148,A
ANDYTASTIC 2009.07.31,969,1,0,17,120,35,-85,B
stota 2009.07.30,915,1,0,32,140,31,-109,A
stota 2009.07.30,915,1,0,32,140,31,-109,B
gasparegg 2009.07.30,1052,1,1,31,100,39,-61,A
gasparegg 2009.07.30,1052,1,1,31,97,39,-58,B
chmpf 2009.04.02,939,1,0.5,7,143,43,-100,A
chmpf 2009.04.02,939,1,0.5,7,153,43,-110,B
Hazardo 2009.07.30,905,1,0,12,171,25,-146,A
Hazardo 2009.07.30,905,1,0,12,154,25,-129,B
smalldreams 2009.07.30,1028,2,2,17,157,35,-122,A
smalldreams 2009.07.30,1028,2,2,17,155,41,-114,B
nathy 2009.07.29,741,1,0,5,309,20,-289,A
nathy 2009.07.29,741,1,0,5,306,20,-286,B
paderboots 2009.07.29,879,1,1,4,84,50,-34,A
paderboots 2009.07.29,879,1,1,4,118,25,-93,B
krishnak 2009.04.03,1128,1,1,50,111,34,-77,A
krishnak 2009.04.03,1128,1,1,50,106,36,-70,B
Bhunt 2009.07.20,1091,1,1,7,343,29,-314,A
Bhunt 2009.07.20,1091,1,1,7,231,29,-202,B
stota 2009.07.16,973,1,0,9,264,33,-231,A
stota 2009.07.16,973,1,0,9,284,22,-262,B
BadfishToo 2009.07.16,1022,1,1,6,50,33,-17,A
BadfishToo 2009.07.16,1022,1,1,6,61,50,-11,B
nathy 2009.07.21,802,7,0,80,289,16,-273,A
nathy 2009.07.21,802,7,0,80,266,21,-245,B
LaurentDelaon 2009.07.21,1051,1,1,6,293,33,-260,A
LaurentDelaon 2009.07.21,1051,1,1,6,260,33,-227,B
Drvanger 2009.07.20,1064,1,0,31,142,29,-113,A
Drvanger 2009.07.20,1064,1,0,31,130,29,-101,B
SoloBaric 2009.07.20,931,1,1,39,280,28,-252,A
SoloBaric 2009.07.20,931,1,1,39,290,28,-262,B
nathy 2009.07.17,976,4,0,59,263,29,-234,A
nathy 2009.07.17,976,4,0,59,266,24,-242,B
wbartlett 2009.07.17,1059,1,1,4,48,75,27,A
wbartlett 2009.07.17,1059,1,1,4,76,75,-1,B
ANDYTASTIC 2009.07.30,990,2,1,49,244,24,-220,A
ANDYTASTIC 2009.07.30,990,2,1,49,235,20,-215,B
scoroyale 2009.07.30,851,1,1,24,133,37,-96,A
scoroyale 2009.07.30,851,1,1,24,120,29,-91,B
nathy 2009.07.19,879,6,0,85,265,19,-246,A
nathy 2009.07.19,879,6,0,85,261,21,-240,B
Sirenus 2009.07.19,1082,1,1,5,84,60,-24,A
Sirenus 2009.07.19,1082,1,1,5,84,60,-24,B
LavAzza 2009.07.11,874,1,0,15,515,7,-508,A
LavAzza 2009.07.11,874,1,0,15,503,20,-483,B
GoGoYubari 2009.07.11,1025,2,1,19,369,32,-337,A
GoGoYubari 2009.07.11,1025,2,1,19,348,32,-316,B
projectlife 2009.06.23,973,1,0,17,276,18,-258,A
projectlife 2009.06.23,973,1,0,17,283,24,-259,B
vincentkellner 2009.06.23,940,1,1,15,189,33,-156,A
vincentkellner 2009.06.23,940,1,1,15,193,33,-160,B
nathy 2009.07.30,750,1,0,7,405,0,-405,A
nathy 2009.07.30,750,1,0,7,390,0,-390,B
stota 2009.07.28,929,1,0,8,131,25,-106,A
stota 2009.07.28,929,1,0,8,145,25,-120,B
Bhunt 2009.07.28,1051,1,1,9,239,22,-217,A
Bhunt 2009.07.28,1051,1,1,9,246,22,-224,B
Traenexx 2009.04.05,884,1,0,13,116,38,-78,A
Traenexx 2009.04.05,884,1,0,13,132,31,-101,B
richsilver 2009.04.05,1105,1,1,12,148,50,-98,A
richsilver 2009.04.05,1105,1,1,12,144,50,-94,B
Gleelee 2009.07.24,1208,1,1,42,136,31,-105,A
Gleelee 2009.07.24,1208,1,1,42,140,31,-109,B
xDieInAFirex 2009.07.24,693,3,0,67,224,25,-199,A
xDieInAFirex 2009.07.24,693,3,0,67,217,27,-190,B
lhoward 2009.07.19,1075,2,2,24,49,42,-7,A
lhoward 2009.07.19,1075,2,2,24,56,33,-23,B
Loran 2009.07.15,795,4,0,50,242,16,-226,A
Loran 2009.07.15,795,4,0,50,230,18,-212,B
catfu 2009.07.15,1086,2,2,28,109,43,-66,A
catfu 2009.07.15,1086,2,2,28,114,46,-68,B
Mels 2009.06.11,1053,1,0,10,319,10,-309,A
Mels 2009.06.11,1053,1,0,10,317,10,-307,B
HeliosMax 2009.06.11,907,3,2,43,221,23,-198,A
HeliosMax 2009.06.11,907,3,2,43,215,26,-189,B
Fukiyama 2009.06.09,1037,1,1,11,235,9,-226,A
Fukiyama 2009.06.09,1037,1,1,11,226,9,-217,B
Kundeohmar 2009.06.09,939,1,0,11,301,18,-283,A
Kundeohmar 2009.06.09,939,1,0,11,282,27,-255,B
Rastaluke 2009.06.02,729,2,0,61,210,31,-179,A
Rastaluke 2009.06.02,729,2,0,61,222,23,-199,B
JAYDENBLANE 2009.06.02,1137,2,2,59,158,25,-133,A
JAYDENBLANE 2009.06.02,1137,2,2,59,157,29,-128,B
stota 2009.07.31,907,1,1,16,113,56,-57,A
stota 2009.07.31,907,1,1,16,86,50,-36,B
scoroyale 2009.07.31,1002,1,0,18,261,22,-239,A
scoroyale 2009.07.31,1002,1,0,18,262,28,-234,B
smalldreams 2009.07.31,1048,1,1,7,91,57,-34,A
smalldreams 2009.07.31,1048,1,1,7,71,57,-14,B
nathy 2009.07.31,757,1,0,12,297,0,-297,A
nathy 2009.07.31,757,1,0,12,283,0,-283,B
smalldreams 2009.07.27,1029,3,2,48,126,46,-80,A
smalldreams 2009.07.27,1029,3,2,48,137,42,-95,B
Hazardo 2009.07.27,913,2,0,20,298,10,-288,A
Hazardo 2009.07.27,913,2,0,20,305,10,-295,B
stota 2009.07.26,916,3,1,41,209,27,-182,A
stota 2009.07.26,916,3,1,41,190,34,-156,B
woodpuscher 2009.07.26,1064,2,2,12,54,42,-12,A
woodpuscher 2009.07.26,1064,2,2,12,62,42,-20,B
chokefetuschoke 2009.07.22,911,1,0,34,267,21,-246,A
chokefetuschoke 2009.07.22,911,1,0,34,272,18,-254,B
ifuwurarabitidnmu 2009.07.22,936,1,1,35,296,20,-276,A
ifuwurarabitidnmu 2009.07.22,936,1,1,35,299,14,-285,B
nathy 2009.07.22,774,4,0,50,394,20,-374,A
nathy 2009.07.22,774,4,0,50,358,14,-344,B
RyanBall 2009.07.22,1030,1,1,12,371,8,-363,A
RyanBall 2009.07.22,1030,1,1,12,451,8,-443,B
LavAzza 2009.07.13,802,1,0,18,313,22,-291,A
LavAzza 2009.07.13,802,1,0,18,285,28,-257,B
GoGoYubari 2009.07.13,1033,1,1,17,139,47,-92,A
GoGoYubari 2009.07.13,1033,1,1,17,154,47,-107,B
franzgabo 2009.06.14,923,1,0,8,88,50,-38,A
franzgabo 2009.06.14,923,1,0,8,86,50,-36,B
yaroshan 2009.06.14,1074,1,1,7,27,43,16,A
yaroshan 2009.06.14,1074,1,1,7,31,29,-2,B
mcco 2009.07.30,1003,1,0,21,192,33,-159,A
mcco 2009.07.30,1003,1,0,21,199,33,-166,B
stota 2009.07.24,929,1,0,11,231,27,-204,A
stota 2009.07.24,929,1,0,11,210,36,-174,B
openmyeyes 2009.07.24,1041,1,1,10,264,10,-254,A
openmyeyes 2009.07.24,1041,1,1,10,247,10,-237,B
stota 2009.07.27,919,1,1,28,128,54,-74,A
stota 2009.07.27,919,1,1,28,127,54,-73,B
stota 2009.07.27,919,1,1,28,116,57,-59,C
badstep 2009.07.26,1077,1,0,29,247,34,-213,A
badstep 2009.07.26,1077,1,0,29,221,34,-187,B
RichardJohnson 2009.07.24,1261,2,2,26,232,27,-205,A
RichardJohnson 2009.07.24,1261,2,2,26,223,23,-200,B
sigggih 2009.07.22,1024,1,1,8,66,50,-16,A
sigggih 2009.07.22,1024,1,1,8,48,50,2,B
dafics 2009.07.21,1099,1,1,9,87,33,-54,A
dafics 2009.07.21,1099,1,1,9,87,33,-54,B
jpirie 2009.07.20,1059,1,1,4,192,25,-167,A
jpirie 2009.07.20,1059,1,1,4,121,25,-96,B
Booyens 2009.07.26,951,2,0,18,298,22,-276,A
Booyens 2009.07.26,951,2,0,18,286,17,-269,B
andrejas 2009.07.26,979,2,2,14,163,36,-127,A
andrejas 2009.07.26,979,2,2,14,167,36,-131,B
OrionsDog 2009.07.22,927,1,1,10,108,10,-98,A
OrionsDog 2009.07.22,927,1,1,10,75,40,-35,B
Demolishor 2009.07.22,1056,1,0,11,247,27,-220,A
Demolishor 2009.07.22,1056,1,0,11,243,27,-216,B
Drvanger 2009.07.19,1024,1,1,18,217,28,-189,A
Drvanger 2009.07.19,1024,1,1,18,213,28,-185,B
Hazardo 2009.07.16,940,1,0.5,4,62,50,-12,A
Hazardo 2009.07.16,940,1,0.5,4,92,25,-67,B
nathy 2009.07.16,954,1,0.5,4,307,50,-257,A
nathy 2009.07.16,954,1,0.5,4,312,50,-262,B
btbkorg 2009.07.11,869,1,0,4,215,50,-165,A
btbkorg 2009.07.11,869,1,0,4,228,50,-178,B
kylekyle 2009.07.11,1033,1,1,4,53,75,22,A
kylekyle 2009.07.11,1033,1,1,4,73,75,2,B
ziglag 2009.07.04,1184,1,1,6,52,33,-19,A
ziglag 2009.07.04,1184,1,1,6,52,33,-19,B
Loran 2009.07.04,803,1,0,6,156,0,-156,A
Loran 2009.07.04,803,1,0,6,138,17,-121,B
petsocietyrocks 2009.06.24,1249,4,2.5,125,171,31,-140,A
petsocietyrocks 2009.06.24,1249,4,2.5,125,177,30,-147,B
dahuigou 2009.06.24,706,4,1.5,130,225,30,-195,A
dahuigou 2009.06.24,706,4,1.5,130,223,25,-198,B
GoGoYubari 2009.06.05,974,1,0,13,202,46,-156,A
GoGoYubari 2009.06.05,974,1,0,13,186,62,-124,B
Avisharv 2009.06.05,964,1,1,8,263,37,-226,A
Avisharv 2009.06.05,964,1,1,8,242,38,-204,B
PieceMover 2009.07.21,1117,2,2,14,68,43,-25,A
PieceMover 2009.07.21,1117,2,2,14,81,36,-45,B
Dicemice 2009.07.21,1055,1,1,9,187,22,-165,A
Dicemice 2009.07.21,1055,1,1,9,221,22,-199,B
GoGoYubari 2009.07.17,1103,1,1,10,190,30,-160,A
GoGoYubari 2009.07.17,1103,1,1,10,173,30,-143,B
MikEms 2009.07.12,957,1,1,7,121,14,-107,A
MikEms 2009.07.12,957,1,1,7,99,29,-70,B
GoGoYubari 2009.07.12,1018,1,0,7,288,29,-259,A
GoGoYubari 2009.07.12,1018,1,0,7,282,29,-253,B
Jia 2009.06.28,951,1,1,5,148,60,-88,A
Jia 2009.06.28,951,1,1,5,151,60,-91,B
antharas 2009.06.28,982,1,0,5,483,0,-483,A
antharas 2009.06.28,982,1,0,5,464,0,-464,B
Loran 2009.06.26,870,5,0,51,354,12,-342,A
Loran 2009.06.26,870,5,0,51,377,12,-365,B
jcizzle 2009.06.26,1096,1,1,9,153,33,-120,A
jcizzle 2009.06.26,1096,1,1,9,157,33,-124,B
jpirie 2009.07.22,1147,1,1,10,162,30,-132,A
jpirie 2009.07.22,1147,1,1,10,206,10,-196,B
Alphacentury 2009.07.15,1155,2,2,17,130,41,-89,A
Alphacentury 2009.07.15,1155,2,2,17,112,41,-71,B
Bhunt 2009.07.21,1073,1,1,16,70,38,-32,A
Bhunt 2009.07.21,1073,1,1,16,65,50,-15,B
raysfan 2009.07.22,1069,1,1,13,193,31,-162,A
raysfan 2009.07.22,1069,1,1,13,204,23,-181,B
lousychess 2009.07.20,1094,1,1,8,296,37,-259,A
lousychess 2009.07.20,1094,1,1,8,196,38,-158,B
Operatics 2009.07.17,1071,1,1,18,149,39,-110,A
Operatics 2009.07.17,1071,1,1,18,151,39,-112,B
smalldreams 2009.07.19,1013,2,2,28,276,18,-258,A
smalldreams 2009.07.19,1013,2,2,28,279,18,-261,B
ktinfl 2009.07.23,846,1,1,18,168,33,-135,A
ktinfl 2009.07.23,846,1,1,18,172,28,-144,B
ZfromDtownCO 2009.07.23,1110,1,0,19,242,21,-221,A
ZfromDtownCO 2009.07.23,1110,1,0,19,225,26,-199,B
IOOOOOWelcomesWeb 2009.07.21,1041,1,1,15,124,47,-77,A
IOOOOOWelcomesWeb 2009.07.21,1041,1,1,15,122,47,-75,B
vincentkellner 2009.06.24,1130,1,1,7,282,29,-253,A
vincentkellner 2009.06.24,1130,1,1,7,271,43,-228,B
Fukiyama 2009.06.29,1014,1,0,14,201,43,-158,A
Fukiyama 2009.06.29,1014,1,0,14,192,36,-156,B
antharas 2009.06.29,976,1,1,12,105,58,-47,A
antharas 2009.06.29,976,1,1,12,89,58,-31,B
sarabande 2009.07.01,1131,1,1,5,190,40,-150,A
sarabande 2009.07.01,1131,1,1,5,144,40,-104,B
Loran 2009.07.01,811,1,0,5,270,20,-250,A
Loran 2009.07.01,811,1,0,5,221,0,-221,B
Booyens 2009.07.09,946,1,1,5,467,20,-447,A
Booyens 2009.07.09,946,1,1,5,483,40,-443,B
loyadrummer 2009.07.09,968,1,0,5,704,0,-704,A
loyadrummer 2009.07.09,968,1,0,5,731,0,-731,B
SassySasha 2009.06.26,1093,3,3,14,48,43,-5,A
SassySasha 2009.06.26,1093,3,3,14,35,50,15,B
PieceMover 2009.06.25,1059,1,1,13,262,31,-231,A
PieceMover 2009.06.25,1059,1,1,13,246,38,-208,B
SviSe 2009.06.25,831,1,0,16,517,13,-504,A
SviSe 2009.06.25,831,1,0,16,461,12,-449,B
Rhizy 2009.07.09,874,1,1,22,126,36,-90,A
Rhizy 2009.07.09,874,1,1,22,125,36,-89,B
sigggih 2009.07.09,1123,1,0,23,204,39,-165,A
sigggih 2009.07.09,1123,1,0,23,207,35,-172,B
Fukiyama 2009.06.26,1021,1,1,15,291,27,-264,A
Fukiyama 2009.06.26,1021,1,1,15,312,27,-285,B
robertpmntr 2009.06.14,1093,1,1,24,180,42,-138,A
robertpmntr 2009.06.14,1093,1,1,24,176,42,-134,B
robertpmntr 2009.06.14,1093,1,1,24,196,38,-158,C
paderboots 2009.06.14,887,1,0,23,172,48,-124,A
paderboots 2009.06.14,887,1,0,23,178,56,-122,B
paderboots 2009.06.14,887,1,0,23,191,56,-135,C
Rhizy 2009.07.17,968,1,1,13,98,46,-52,A
Rhizy 2009.07.17,968,1,1,13,92,38,-54,B
Bmoresoldier 2009.06.22,934,1,0,36,411,19,-392,A
Bmoresoldier 2009.06.22,934,1,0,36,412,17,-395,B
zqnzt 2009.06.22,1032,1,1,30,368,23,-345,A
zqnzt 2009.06.22,1032,1,1,30,337,20,-317,B
Buildingwings 2009.07.04,1064,1,1,13,133,31,-102,A
Buildingwings 2009.07.04,1064,1,1,13,134,31,-103,B
masif 2009.07.04,822,1,0,14,240,14,-226,A
masif 2009.07.04,822,1,0,14,239,7,-232,B
chmpf 2009.07.03,984,1,0,7,138,14,-124,A
chmpf 2009.07.03,984,1,0,7,142,14,-128,B
Xoppo 2009.07.03,941,1,1,7,3,86,83,A
Xoppo 2009.07.03,941,1,1,7,10,86,76,B
elpascoe 2009.06.22,992,1,1,14,147,36,-111,A
elpascoe 2009.06.22,992,1,1,14,178,29,-149,B
PieceMover 2009.06.22,973,2,1,18,191,39,-152,A
PieceMover 2009.06.22,973,2,1,18,195,33,-162,B
HeliosMax 2009.06.14,893,1,0,20,146,30,-116,A
HeliosMax 2009.06.14,893,1,0,20,160,35,-125,B
ToomuchforUtoo 2009.06.14,1101,1,1,19,127,16,-111,A
ToomuchforUtoo 2009.06.14,1101,1,1,19,105,21,-84,B
MikEms 2009.07.11,805,1,1,9,345,22,-323,A
MikEms 2009.07.11,805,1,1,9,301,44,-257,B
robertpmntr 2009.07.04,1118,1,1,10,123,30,-93,A
robertpmntr 2009.07.04,1118,1,1,10,144,30,-114,B
ktinfl 2009.07.04,866,1,0,12,296,17,-279,A
ktinfl 2009.07.04,866,1,0,12,325,17,-308,B
HeliosMax 2009.06.30,866,1,1,44,97,48,-49,A
HeliosMax 2009.06.30,866,1,1,44,103,43,-60,B
robertpmntr 2009.06.30,1106,1,0,45,142,33,-109,A
robertpmntr 2009.06.30,1106,1,0,45,149,22,-127,B
GoGoYubari 2009.07.10,1009,1,1,17,309,29,-280,A
GoGoYubari 2009.07.10,1009,1,1,17,319,29,-290,B
MikEms 2009.07.10,885,1,0,18,238,56,-182,A
MikEms 2009.07.10,885,1,0,18,260,44,-216,B
vpma 2009.07.15,1037,1,0,11,257,9,-248,A
vpma 2009.07.15,1037,1,0,11,230,9,-221,B
BadfishToo 2009.07.15,874,1,1,7,99,57,-42,A
BadfishToo 2009.07.15,874,1,1,7,94,57,-37,B
ToomuchforUtoo 2009.06.21,1111,1,1,5,266,40,-226,A
ToomuchforUtoo 2009.06.21,1111,1,1,5,302,40,-262,B
ktinfl 2009.06.21,867,1,0,5,261,40,-221,A
ktinfl 2009.06.21,867,1,0,5,270,40,-230,B
Kundeohmar 2009.07.01,977,1,0,31,336,26,-310,A
Kundeohmar 2009.07.01,977,1,0,31,354,29,-325,B
Booyens 2009.07.01,987,1,1,25,215,36,-179,A
Booyens 2009.07.01,987,1,1,25,207,36,-171,B
TooFar 2009.05.23,1224,1,1,9,333,11,-322,A
TooFar 2009.05.23,1224,1,1,9,338,11,-327,B
xDieInAFirex 2009.05.23,655,1,0,8,317,12,-305,A
xDieInAFirex 2009.05.23,655,1,0,8,324,12,-312,B
pajac 2009.05.21,952,1,1,13,160,8,-152,A
pajac 2009.05.21,952,1,1,13,101,31,-70,B
twobacca 2009.05.21,1003,1,0,13,207,15,-192,A
twobacca 2009.05.21,1003,1,0,13,186,23,-163,B
BillMac 2009.04.29,997,1,1,9,271,33,-238,A
BillMac 2009.04.29,997,1,1,9,246,44,-202,B
RickHfstz 2009.04.29,991,1,0,7,20,86,66,A
RickHfstz 2009.04.29,991,1,0,7,13,86,73,B
stota 2009.06.24,983,1,1,7,259,29,-230,A
stota 2009.06.24,983,1,1,7,203,29,-174,B
LeyZ 2009.06.24,1013,1,0,10,235,20,-215,A
LeyZ 2009.06.24,1013,1,0,10,240,20,-220,B
ktinfl 2009.06.14,898,1,1,8,226,25,-201,A
ktinfl 2009.06.14,898,1,1,8,252,25,-227,B
Jia 2009.06.14,1094,1,0,8,393,12,-381,A
Jia 2009.06.14,1094,1,0,8,430,12,-418,B
Dlegend 2009.06.11,825,2,1,46,185,39,-146,A
Dlegend 2009.06.11,825,2,1,46,191,37,-154,B
borovo 2009.06.11,1073,3,1,64,169,36,-133,A
borovo 2009.06.11,1073,3,1,64,169,39,-130,B
GeorgiaCohen 2009.06.09,803,1,0.5,29,254,21,-233,A
GeorgiaCohen 2009.06.09,803,1,0.5,29,266,24,-242,B
Booyens 2009.06.09,1018,1,0.5,25,141,24,-117,A
Booyens 2009.06.09,1018,1,0.5,25,146,24,-122,B
Kundeohmar 2009.05.20,989,1,1,4,33,75,42,A
Kundeohmar 2009.05.20,989,1,1,4,62,50,-12,B
paderboots 2009.05.20,923,2,1,11,283,18,-265,A
paderboots 2009.05.20,923,2,1,11,295,18,-277,B
Kotimatka 2009.05.10,943,2,2,20,114,40,-74,A
Kotimatka 2009.05.10,943,2,2,20,90,35,-55,B
Hazardo 2009.05.10,956,2,0,23,190,22,-168,A
Hazardo 2009.05.10,956,2,0,23,169,26,-143,B
Hazardo 2009.04.21,964,2,1,18,366,17,-349,A
Hazardo 2009.04.21,964,2,1,18,363,22,-341,B
scosta 2009.04.21,936,2,1,18,370,11,-359,A
scosta 2009.04.21,936,2,1,18,366,11,-355,B
Loran 2009.06.18,884,1,1,15,308,33,-275,A
Loran 2009.06.18,884,1,1,15,273,33,-240,B
Yanulya 2009.06.18,1001,1,0,13,263,23,-240,A
Yanulya 2009.06.18,1001,1,0,13,197,23,-174,B
Rastaluke 2009.05.25,803,2,0,29,256,24,-232,A
Rastaluke 2009.05.25,803,2,0,29,263,24,-239,B
JAYDENBLANE 2009.05.25,1151,2,2,25,168,36,-132,A
JAYDENBLANE 2009.05.25,1151,2,2,25,178,28,-150,B
Kundeohmar 2009.05.24,977,2,0.5,12,227,17,-210,A
Kundeohmar 2009.05.24,977,2,0.5,12,222,0,-222,B
Hazardo 2009.05.24,946,1,0.5,9,364,0,-364,A
Hazardo 2009.05.24,946,1,0.5,9,345,0,-345,B
Nebri 2009.05.13,919,1,1,9,149,44,-105,A
Nebri 2009.05.13,919,1,1,9,133,44,-89,B
paperchasdvincent 2009.05.13,1043,1,0,10,273,40,-233,A
paperchasdvincent 2009.05.13,1043,1,0,10,236,40,-196,B
sangkyu 2009.05.08,928,1,0,12,187,42,-145,A
sangkyu 2009.05.08,928,1,0,12,206,25,-181,B
chmpf 2009.05.08,966,1,1,11,42,54,12,A
chmpf 2009.05.08,966,1,1,11,40,54,14,B
Xoppo 2009.06.24,969,1,0,30,136,33,-103,A
Xoppo 2009.06.24,969,1,0,30,155,27,-128,B
francod 2009.06.24,997,1,1,33,163,42,-121,A
francod 2009.06.24,997,1,1,33,167,42,-125,B
Ickis 2009.05.15,1007,1,1,23,92,44,-48,A
Ickis 2009.05.15,1007,1,1,23,93,44,-49,B
dadikuki 2009.05.15,930,1,0,23,168,17,-151,A
dadikuki 2009.05.15,930,1,0,23,154,22,-132,B
Mels 2009.05.10,848,1,0,5,121,40,-81,A
Mels 2009.05.10,848,1,0,5,146,40,-106,B
Astronomas 2009.05.10,889,1,1,5,71,40,-31,A
Astronomas 2009.05.10,889,1,1,5,53,60,7,B
Loran 2009.06.20,851,1,0,45,233,33,-200,A
Loran 2009.06.20,851,1,0,45,244,29,-215,B
RyanBall 2009.06.20,1071,1,1,48,275,25,-250,A
RyanBall 2009.06.20,1071,1,1,48,287,21,-266,B
checkmatenik 2009.05.26,1001,1,0.5,8,174,12,-162,A
checkmatenik 2009.05.26,1001,1,0.5,8,128,25,-103,B
WhateverAndStuf 2009.05.26,991,1,0.5,9,446,22,-424,A
WhateverAndStuf 2009.05.26,991,1,0.5,9,440,22,-418,B
borovo 2009.06.07,1026,1,0.5,18,174,17,-157,A
borovo 2009.06.07,1026,1,0.5,18,187,17,-170,B
HeliosMax 2009.06.07,955,1,0.5,21,228,33,-195,A
HeliosMax 2009.06.07,955,1,0.5,21,253,33,-220,B
Dlegend 2009.06.17,873,2,1,67,119,36,-83,A
Dlegend 2009.06.17,873,2,1,67,155,33,-122,B
borovo 2009.06.17,1038,2,1,70,175,29,-146,A
borovo 2009.06.17,1038,2,1,70,186,30,-156,B
dubaddict 2009.05.06,823,1,0,20,186,30,-156,A
dubaddict 2009.05.06,823,1,0,20,193,30,-163,B
Koerdis 2009.05.06,1095,1,1,19,123,37,-86,A
Koerdis 2009.05.06,1095,1,1,19,117,42,-75,B
markhodges 2009.05.01,1073,2,1,55,324,20,-304,A
markhodges 2009.05.01,1073,2,1,55,320,22,-298,B
checkraiseallin 2009.05.01,896,4,1,64,252,27,-225,A
checkraiseallin 2009.05.01,896,4,1,64,237,25,-212,B
ktinfl 2009.06.19,865,1,1,26,238,12,-226,A
ktinfl 2009.06.19,865,1,1,26,247,15,-232,B
IrishRottie 2009.06.19,1070,1,0,27,305,11,-294,A
IrishRottie 2009.06.19,1070,1,0,27,316,11,-305,B
JAYDENBLANE 2009.05.17,1119,1,1,17,47,53,6,A
JAYDENBLANE 2009.05.17,1119,1,1,17,45,47,2,B
Rastaluke 2009.05.17,868,1,0,17,111,53,-58,A
Rastaluke 2009.05.17,868,1,0,17,108,53,-55,B
Mels 2009.05.11,848,1,0,6,379,17,-362,A
Mels 2009.05.11,848,1,0,6,376,17,-359,B
stephenbyers 2009.05.11,1051,1,1,4,94,25,-69,A
stephenbyers 2009.05.11,1051,1,1,4,85,25,-60,B
PABOY 2008.11.25,825,1,1,14,242,21,-221,A
PABOY 2008.11.25,825,1,1,14,234,21,-213,B
nicksun 2008.11.25,881,1,0,13,278,23,-255,A
nicksun 2008.11.25,881,1,0,13,268,23,-245,B
Fukiyama 2009.06.04,1008,1,1,23,355,26,-329,A
Fukiyama 2009.06.04,1008,1,1,23,343,26,-317,B
Hazardo 2009.06.04,986,1,0,17,142,53,-89,A
Hazardo 2009.06.04,986,1,0,17,142,53,-89,B
GoGoYubari 2009.06.04,976,1,0,19,188,47,-141,A
GoGoYubari 2009.06.04,976,1,0,19,199,37,-162,B
borovo 2009.06.04,997,1,1,18,200,22,-178,A
borovo 2009.06.04,997,1,1,18,168,22,-146,B
zuugor 2009.06.11,1062,1,1,10,102,30,-72,A
zuugor 2009.06.11,1062,1,1,10,92,30,-62,B
HeliosMax 2009.06.15,855,1,0,22,349,23,-326,A
HeliosMax 2009.06.15,855,1,0,22,363,18,-345,B
jubilado 2009.06.15,874,1,1,13,129,38,-91,A
jubilado 2009.06.15,874,1,1,13,118,46,-72,B
francod 2009.06.07,968,1,1,4,46,25,-21,A
francod 2009.06.07,968,1,1,4,62,50,-12,B
Hazardo 2009.06.07,978,1,0,4,335,25,-310,A
Hazardo 2009.06.07,978,1,0,4,344,25,-319,B
Loran 2009.06.19,912,1,0,7,291,29,-262,A
Loran 2009.06.19,912,1,0,7,292,29,-263,B
RationalSkeptik 2009.06.19,991,1,1,5,117,40,-77,A
RationalSkeptik 2009.06.19,991,1,1,5,90,60,-30,B
robertpmntr 2009.06.22,1087,1,0,4,180,25,-155,A
robertpmntr 2009.06.22,1087,1,0,4,195,25,-170,B
RichardJohnson 2009.05.27,1254,2,1.5,18,56,44,-12,A
RichardJohnson 2009.05.27,1254,2,1.5,18,47,44,-3,B
xDieInAFirex 2009.05.27,651,2,0.5,22,184,27,-157,A
xDieInAFirex 2009.05.27,651,2,0.5,22,157,32,-125,B
RichardJohnson 2009.05.14,1054,3,3,37,134,19,-115,A
RichardJohnson 2009.05.14,1054,3,3,37,124,19,-105,B
xDieInAFirex 2009.05.14,830,3,0,43,241,21,-220,A
xDieInAFirex 2009.05.14,830,3,0,43,221,16,-205,B
Borgohain 2009.06.19,1112,1,0,11,80,36,-44,A
Borgohain 2009.06.19,1112,1,0,11,140,18,-122,B
HeliosMax 2009.06.19,830,1,1,10,64,10,-54,A
HeliosMax 2009.06.19,830,1,1,10,120,30,-90,B
borovo 2009.06.12,1049,1,1,28,110,54,-56,A
borovo 2009.06.12,1049,1,1,28,114,54,-60,B
borovo 2009.06.12,1049,1,1,28,109,50,-59,C
Kundeohmar 2009.06.12,898,1,0,27,184,37,-147,A
Kundeohmar 2009.06.12,898,1,0,27,192,41,-151,B
Kundeohmar 2009.06.12,898,1,0,27,190,41,-149,C
RichardJohnson 2009.05.21,1221,2,2,13,172,46,-126,A
RichardJohnson 2009.05.21,1221,2,2,13,171,46,-125,B
xDieInAFirex 2009.05.21,676,3,0,38,373,18,-355,A
xDieInAFirex 2009.05.21,676,3,0,38,375,13,-362,B
Mels 2009.05.06,904,1,0,7,256,43,-213,A
Mels 2009.05.06,904,1,0,7,241,43,-198,B
badstep 2009.05.06,1049,1,1,7,305,29,-276,A
badstep 2009.05.06,1049,1,1,7,292,29,-263,B
spiderz 2009.06.01,1037,1,0,38,210,32,-178,A
spiderz 2009.06.01,1037,1,0,38,206,34,-172,B
borovo 2009.06.01,1027,2,1,50,151,30,-121,A
borovo 2009.06.01,1027,2,1,50,139,26,-113,B
francod 2009.06.03,968,1,0,14,266,29,-237,A
francod 2009.06.03,968,1,0,14,283,29,-254,B
GoGoYubari 2009.06.03,998,1,1,13,182,31,-151,A
GoGoYubari 2009.06.03,998,1,1,13,213,23,-190,B
Kundeohmar 2009.05.28,963,1,0,7,75,43,-32,A
Kundeohmar 2009.05.28,963,1,0,7,35,43,8,B
Hazardo 2009.05.28,967,1,1,7,151,14,-137,A
Hazardo 2009.05.28,967,1,1,7,92,14,-78,B
ZnBangash 2009.05.21,1143,1,1,19,198,16,-182,A
ZnBangash 2009.05.21,1143,1,1,19,188,21,-167,B
Caledonian 2009.05.17,817,1,0,16,140,31,-109,A
Caledonian 2009.05.17,817,1,0,16,138,38,-100,B
zqnzt 2009.05.17,1051,1,1,15,33,67,34,A
zqnzt 2009.05.17,1051,1,1,15,40,60,20,B
auglaize 2009.04.24,967,1,1,5,109,0,-109,A
auglaize 2009.04.24,967,1,1,5,127,20,-107,B
badstep 2009.04.24,1010,1,0,9,347,22,-325,A
badstep 2009.04.24,1010,1,0,9,367,11,-356,B
Hazardo 2009.06.08,970,1,1,7,88,43,-45,A
Hazardo 2009.06.08,970,1,1,7,78,29,-49,B
elpascoe 2009.06.08,1024,1,0,8,236,25,-211,A
elpascoe 2009.06.08,1024,1,0,8,243,12,-231,B
insanemew 2009.04.22,943,1,0,9,427,0,-427,A
insanemew 2009.04.22,943,1,0,9,427,0,-427,B
pmineiro 2009.04.22,996,1,1,9,344,22,-322,A
pmineiro 2009.04.22,996,1,1,9,363,22,-341,B
sexyricanlady 2009.05.09,1012,1,1,16,167,19,-148,A
sexyricanlady 2009.05.09,1012,1,1,16,168,19,-149,B
zqnzt 2009.05.09,849,1,0,16,266,25,-241,A
zqnzt 2009.05.09,849,1,0,16,229,25,-204,B
OttoTheDog 2009.04.21,1019,1,1,16,234,19,-215,A
OttoTheDog 2009.04.21,1019,1,1,16,218,25,-193,B
Crashinator 2009.04.21,973,1,0,16,260,25,-235,A
Crashinator 2009.04.21,973,1,0,16,242,25,-217,B
WillSmith 2009.06.03,928,1,0,8,232,25,-207,A
WillSmith 2009.06.03,928,1,0,8,228,12,-216,B
borovo 2009.06.03,982,1,1,5,252,20,-232,A
borovo 2009.06.03,982,1,1,5,225,0,-225,B
antharas 2009.06.01,1082,1,1,15,98,27,-71,A
antharas 2009.06.01,1082,1,1,15,86,40,-46,B
obamaworld 2009.05.16,1023,1,0,8,161,38,-123,A
obamaworld 2009.05.16,1023,1,0,8,188,38,-150,B
beijingchina 2009.05.16,969,1,1,9,226,33,-193,A
beijingchina 2009.05.16,969,1,1,9,248,44,-204,B
finestcuts 2009.05.30,950,1,0,19,131,26,-105,A
finestcuts 2009.05.30,950,1,0,19,130,26,-104,B
Xbozo 2009.05.30,1033,1,1,19,117,47,-70,A
Xbozo 2009.05.30,1033,1,1,19,124,58,-66,B
Hazardo 2009.05.26,951,1,1,14,230,36,-194,A
Hazardo 2009.05.26,951,1,1,14,228,43,-185,B
ToomuchforUtoo 2009.05.26,1009,1,0,12,277,25,-252,A
ToomuchforUtoo 2009.05.26,1009,1,0,12,336,0,-336,B
paderboots 2009.05.21,914,1,0,17,159,47,-112,A
paderboots 2009.05.21,914,1,0,17,166,41,-125,B
SecondQueen 2009.05.21,1060,1,1,18,261,17,-244,A
SecondQueen 2009.05.21,1060,1,1,18,252,22,-230,B
Kundeohmar 2009.05.25,963,2,1,41,157,29,-128,A
Kundeohmar 2009.05.25,963,2,1,41,158,29,-129,B
Hazardo 2009.05.25,959,2,1,42,189,26,-163,A
Hazardo 2009.05.25,959,2,1,42,188,24,-164,B
sterum 2009.05.23,1168,1,1,4,217,25,-192,A
sterum 2009.05.23,1168,1,1,4,162,25,-137,B
deeprince 2009.05.23,791,1,0,6,584,17,-567,A
deeprince 2009.05.23,791,1,0,6,540,17,-523,B
sexyricanlady 2009.05.24,937,1,1,5,246,40,-206,A
sexyricanlady 2009.05.24,937,1,1,5,253,40,-213,B
pokerfish 2009.05.23,1018,1,0,19,296,16,-280,A
pokerfish 2009.05.23,1018,1,0,19,249,10,-239,B
cesacsr 2009.05.23,921,1,1,19,171,42,-129,A
cesacsr 2009.05.23,921,1,1,19,156,42,-114,B
Traenexx 2009.04.23,876,1,1,15,212,33,-179,A
Traenexx 2009.04.23,876,1,1,15,214,33,-181,B
richsilver 2009.04.23,1081,1,0,14,168,36,-132,A
richsilver 2009.04.23,1081,1,0,14,171,36,-135,B
PLUGZ 2009.05.20,1068,2,0,29,184,31,-153,A
PLUGZ 2009.05.20,1068,2,0,29,178,31,-147,B
mupdegrove 2009.05.01,1093,2,2,16,131,31,-100,A
mupdegrove 2009.05.01,1093,2,2,16,114,31,-83,B
LaurentDelaon 2009.05.03,1109,1,1,12,239,33,-206,A
LaurentDelaon 2009.05.03,1109,1,1,12,254,33,-221,B
dubaddict 2009.05.03,850,1,0,12,265,33,-232,A
dubaddict 2009.05.03,850,1,0,12,278,33,-245,B
Mels 2009.05.19,835,1,1,13,138,54,-84,A
Mels 2009.05.19,835,1,1,13,139,54,-85,B
kukuykuyk 2009.05.19,1061,1,0,9,244,44,-200,A
kukuykuyk 2009.05.19,1061,1,0,9,248,33,-215,B
Fnorgmuffin 2009.04.23,709,1,0,17,197,24,-173,A
Fnorgmuffin 2009.04.23,709,1,0,17,182,24,-158,B
bialyhetman 2009.04.23,1184,1,1,15,98,40,-58,A
bialyhetman 2009.04.23,1184,1,1,15,105,33,-72,B
RichardJohnson 2009.05.06,1058,1,1,9,210,11,-199,A
RichardJohnson 2009.05.06,1058,1,1,9,188,11,-177,B
xDieInAFirex 2009.05.06,901,1,0,9,332,11,-321,A
xDieInAFirex 2009.05.06,901,1,0,9,317,11,-306,B
jajajajames 2009.05.05,965,1,1,7,462,14,-448,A
jajajajames 2009.05.05,965,1,1,7,471,14,-457,B
Hazardo 2009.05.05,995,1,0,5,284,40,-244,A
Hazardo 2009.05.05,995,1,0,5,248,40,-208,B
Hazardo 2009.04.25,1016,1,1,19,207,42,-165,A
Hazardo 2009.04.25,1016,1,1,19,215,42,-173,B
ukpfc 2009.04.25,790,1,0,19,238,21,-217,A
ukpfc 2009.04.25,790,1,0,19,237,21,-216,B
TylerTheWimp 2009.05.20,910,1,1,19,86,42,-44,A
TylerTheWimp 2009.05.20,910,1,1,19,83,42,-41,B
dubaddict 2009.04.29,818,1,0,5,280,20,-260,A
dubaddict 2009.04.29,818,1,0,5,232,20,-212,B
LaurentDelaon 2009.04.29,1100,1,1,4,89,50,-39,A
LaurentDelaon 2009.04.29,1100,1,1,4,38,50,12,B
Kundeohmar 2009.05.04,1008,1,0,24,162,38,-124,A
Kundeohmar 2009.05.04,1008,1,0,24,160,46,-114,B
Avisharv 2009.05.04,937,1,1,25,188,24,-164,A
Avisharv 2009.05.04,937,1,1,25,191,24,-167,B
cristidumitru 2009.04.24,1240,1,1,5,259,20,-239,A
cristidumitru 2009.04.24,1240,1,1,5,205,20,-185,B
Fnorgmuffin 2009.04.24,701,1,0,4,113,25,-88,A
Fnorgmuffin 2009.04.24,701,1,0,4,96,50,-46,B
Mels 2009.05.07,896,1,0,10,316,30,-286,A
Mels 2009.05.07,896,1,0,10,245,30,-215,B
DikkenPierre 2009.05.07,1039,1,1,9,109,44,-65,A
DikkenPierre 2009.05.07,1039,1,1,9,119,33,-86,B
badstep 2009.05.05,1040,1,1,6,175,0,-175,A
badstep 2009.05.05,1040,1,1,6,107,17,-90,B
dubaddict 2009.05.05,835,1,0,7,423,0,-423,A
dubaddict 2009.05.05,835,1,0,7,368,0,-368,B
Cofiez 2009.04.24,1061,1,1,15,97,47,-50,A
Cofiez 2009.04.24,1061,1,1,15,101,47,-54,B
Traenexx 2009.04.24,887,1,0,15,163,33,-130,A
Traenexx 2009.04.24,887,1,0,15,166,33,-133,B
vpma 2009.04.21,845,1,1,12,73,58,-15,A
vpma 2009.04.21,845,1,1,12,81,67,-14,B
chmpf 2009.04.21,963,1,0,13,239,23,-216,A
chmpf 2009.04.21,963,1,0,13,206,38,-168,B
vpma 2009.04.24,928,1,1,21,162,38,-124,A
vpma 2009.04.24,928,1,1,21,167,29,-138,B
Amarande 2009.04.24,1033,1,0,26,310,23,-287,A
Amarande 2009.04.24,1033,1,0,26,333,23,-310,B
Agenbite 1999.11.16,679,1,0,8,204,25,-179,A
Agenbite 1999.11.16,679,1,0,8,198,12,-186,B
CaptainAhab 1999.11.16,826,1,1,7,129,57,-72,A
CaptainAhab 1999.11.16,826,1,1,7,126,57,-69,B
DumbRedNeck 2009.07.30,731,3,1,33,342,18,-324,A
DumbRedNeck 2009.07.30,731,3,1,33,379,18,-361,B
Loran 2009.07.30,767,3,2,24,224,33,-191,A
Loran 2009.07.30,767,3,2,24,225,33,-192,B
LeyZ 2009.08.04,826,1,1,16,234,19,-215,A
LeyZ 2009.08.04,826,1,1,16,211,31,-180,B
nathy 2009.08.04,752,1,0,18,360,22,-338,A
nathy 2009.08.04,752,1,0,18,355,22,-333,B
dahuigou 2008.11.21,685,2,1.5,50,273,34,-239,A
dahuigou 2008.11.21,685,2,1.5,50,270,36,-234,B
Crashinator 2008.11.21,843,2,0.5,57,372,40,-332,A
Crashinator 2008.11.21,843,2,0.5,57,371,39,-332,B
zhouzhaowu 2009.04.05,871,1,1,7,320,14,-306,A
zhouzhaowu 2009.04.05,871,1,1,7,287,14,-273,B
fjjvh 2009.04.05,665,1,0,8,357,12,-345,A
fjjvh 2009.04.05,665,1,0,8,340,12,-328,B
DINOCO 2007.10.23,781,1,1,19,256,5,-251,A
DINOCO 2007.10.23,781,1,1,19,260,0,-260,B
louiswei 2007.10.23,800,1,0,21,300,10,-290,A
louiswei 2007.10.23,800,1,0,21,303,10,-293,B
HogODeath 2007.04.23,1047,1,1,19,353,21,-332,A
HogODeath 2007.04.23,1047,1,1,19,363,16,-347,B
greenqueenbrasil 2007.04.23,816,1,0,21,450,5,-445,A
greenqueenbrasil 2007.04.23,816,1,0,21,399,5,-394,B
nathy 2009.08.06,733,1,0,11,312,18,-294,A
nathy 2009.08.06,733,1,0,11,319,9,-310,B
ktinfl 2009.08.06,866,1,1,10,165,20,-145,A
ktinfl 2009.08.06,866,1,1,10,148,20,-128,B
fjjvh 2009.04.04,666,1,0,20,348,10,-338,A
fjjvh 2009.04.04,666,1,0,20,310,10,-300,B
zhouzhaowu 2009.04.04,821,1,1,17,218,0,-218,A
zhouzhaowu 2009.04.04,821,1,1,17,169,12,-157,B
chmpf 2009.04.02,925,1,1,5,19,80,61,A
chmpf 2009.04.02,925,1,1,5,35,60,25,B
fjjvh 2009.04.02,667,1,0,7,453,29,-424,A
fjjvh 2009.04.02,667,1,0,7,330,29,-301,B
Birgie 2008.12.27,822,1,1,10,103,30,-73,A
Birgie 2008.12.27,822,1,1,10,118,30,-88,B
Shagmaster 2008.12.27,712,1,0,11,192,46,-146,A
Shagmaster 2008.12.27,712,1,0,11,195,46,-149,B
fjjvh 2009.03.29,672,1,0,34,262,24,-238,A
fjjvh 2009.03.29,672,1,0,34,262,18,-244,B
chmpf 2009.03.29,926,1,1,33,256,24,-232,A
chmpf 2009.03.29,926,1,1,33,258,24,-234,B
Crashinator 2008.11.28,789,3,1.5,44,276,23,-253,A
Crashinator 2008.11.28,789,3,1.5,44,280,23,-257,B
dahuigou 2008.11.28,794,3,1.5,43,316,26,-290,A
dahuigou 2008.11.28,794,3,1.5,43,327,23,-304,B
Knighter 2000.01.15,899,2,1,71,247,15,-232,A
Knighter 2000.01.15,899,2,1,71,263,14,-249,B
mrfriday 2000.01.15,672,1,0,24,182,25,-157,A
mrfriday 2000.01.15,672,1,0,24,182,25,-157,B
Crashinator 2008.12.05,808,1,1,10,114,20,-94,A
Crashinator 2008.12.05,808,1,1,10,81,20,-61,B
dahuigou 2008.12.05,706,1,0,14,234,21,-213,A
dahuigou 2008.12.05,706,1,0,14,222,21,-201,B
gsuses 2006.12.25,961,1,0,7,649,14,-635,A
gsuses 2006.12.25,961,1,0,7,658,14,-644,B
jshumaker 2006.12.25,883,1,1,3,334,33,-301,A
jshumaker 2006.12.25,883,1,1,3,288,33,-255,B
bigouden 2006.12.07,1022,1,0,14,239,21,-218,A
bigouden 2006.12.07,1022,1,0,14,220,43,-177,B
SamuelJunior 2006.12.07,946,1,1,13,164,23,-141,A
SamuelJunior 2006.12.07,946,1,1,13,167,8,-159,B
Andreadoria 2006.12.23,862,1,1,5,264,20,-244,A
Andreadoria 2006.12.23,862,1,1,5,227,40,-187,B
gsuses 2006.12.23,1000,1,0,6,522,17,-505,A
gsuses 2006.12.23,1000,1,0,6,520,17,-503,B
hotwheela 2006.12.22,810,1,0,38,334,18,-316,A
hotwheela 2006.12.22,810,1,0,38,352,16,-336,B
jpiscool 2006.12.22,1141,1,1,38,307,24,-283,A
jpiscool 2006.12.22,1141,1,1,38,318,24,-294,B
jshumaker 2006.12.30,845,1,1,21,213,33,-180,A
jshumaker 2006.12.30,845,1,1,21,194,29,-165,B
Superdonut 2006.12.30,1065,1,0,31,324,23,-301,A
Superdonut 2006.12.30,1065,1,0,31,332,32,-300,B
Sevenkings 2006.12.28,1012,1,0,21,221,29,-192,A
Sevenkings 2006.12.28,1012,1,0,21,196,24,-172,B
ItIsLife 2006.12.28,943,1,1,20,131,20,-111,A
ItIsLife 2006.12.28,943,1,1,20,107,30,-77,B
faldur 2004.03.13,1102,1,1,23,110,39,-71,A
faldur 2004.03.13,1102,1,1,23,102,44,-58,B
GolfBob 2004.03.13,847,1,0,25,154,24,-130,A
GolfBob 2004.03.13,847,1,0,25,153,28,-125,B
zephrys 2006.11.12,932,1,1,9,232,56,-176,A
zephrys 2006.11.12,932,1,1,9,343,44,-299,B
feelm 2006.11.12,998,2,0,26,384,35,-349,A
feelm 2006.11.12,998,2,0,26,391,31,-360,B
Malca 2006.10.26,976,1,1,41,166,32,-134,A
Malca 2006.10.26,976,1,1,41,163,32,-131,B
SamuelJunior 2006.10.26,982,1,0,40,199,15,-184,A
SamuelJunior 2006.10.26,982,1,0,40,198,18,-180,B
Funditor 2006.09.27,947,1,1,22,48,45,-3,A
Funditor 2006.09.27,947,1,1,22,49,46,-3,B
Malca 2006.09.27,1046,1,0,23,68,30,-38,A
Malca 2006.09.27,1046,1,0,23,77,30,-47,B
Halfman 2005.12.21,939,1,0,32,175,28,-147,A
Halfman 2005.12.21,939,1,0,32,194,31,-163,B
ChessRio 2005.12.21,949,1,1,32,195,25,-170,A
ChessRio 2005.12.21,949,1,1,32,205,22,-183,B
dopeyone 2004.03.15,827,1,0,21,259,19,-240,A
dopeyone 2004.03.15,827,1,0,21,290,14,-276,B
fuss 2004.03.15,992,1,1,18,114,28,-86,A
fuss 2004.03.15,992,1,1,18,143,33,-110,B
JohnstonDJ 2006.12.08,942,1,0,24,217,25,-192,A
JohnstonDJ 2006.12.08,942,1,0,24,219,29,-190,B
oubobcat 2006.12.08,841,3,2,59,139,31,-108,A
oubobcat 2006.12.08,841,3,2,59,128,29,-99,B
racinebaby 2006.11.29,1125,1,1,12,94,25,-69,A
racinebaby 2006.11.29,1125,1,1,12,91,33,-58,B
harrypotar 2006.11.29,820,1,0,12,162,33,-129,A
harrypotar 2006.11.29,820,1,0,12,169,33,-136,B
dockson 2004.01.15,869,1,1,21,98,52,-46,A
dockson 2004.01.15,869,1,1,21,94,52,-42,B
dockson 2004.01.15,869,1,1,21,91,57,-34,C
PravinMamania 2004.01.15,1041,1,0,21,173,19,-154,A
PravinMamania 2004.01.15,1041,1,0,21,172,19,-153,B
PravinMamania 2004.01.15,1041,1,0,21,153,19,-134,C
shechem 2004.03.03,1020,1,1,26,141,31,-110,A
shechem 2004.03.03,1020,1,1,26,127,31,-96,B
GolfBob 2004.03.03,966,1,0,28,201,21,-180,A
GolfBob 2004.03.03,966,1,0,28,194,21,-173,B
dockson 2004.02.04,903,1,0,5,553,0,-553,A
dockson 2004.02.04,903,1,0,5,581,0,-581,B
furexplity 2004.02.04,1023,1,1,3,241,33,-208,A
furexplity 2004.02.04,1023,1,1,3,208,33,-175,B
GlennaSarous 2003.10.29,933,1,1,18,208,28,-180,A
GlennaSarous 2003.10.29,933,1,1,18,229,33,-196,B
SavoySlim 2003.10.29,1049,1,0,18,310,11,-299,A
SavoySlim 2003.10.29,1049,1,0,18,348,6,-342,B
Rdick 2003.07.06,1010,1,1,3,197,33,-164,A
Rdick 2003.07.06,1010,1,1,3,159,33,-126,B
dumpyshubby 2003.07.06,906,1,0,5,513,40,-473,A
dumpyshubby 2003.07.06,906,1,0,5,515,40,-475,B
ASABOTO 2004.03.12,1092,1,1,28,119,46,-73,A
ASABOTO 2004.03.12,1092,1,1,28,114,46,-68,B
GolfBob 2004.03.12,865,1,0,31,201,23,-178,A
GolfBob 2004.03.12,865,1,0,31,219,23,-196,B
RandyRoo 2006.12.09,753,3,0,23,255,35,-220,A
RandyRoo 2006.12.09,753,3,0,23,257,26,-231,B
lksharma 2006.12.09,1256,2,2,18,77,17,-60,A
lksharma 2006.12.09,1256,2,2,18,110,17,-93,B
HGBoone 2006.11.14,1124,1,1,12,76,50,-26,A
HGBoone 2006.11.14,1124,1,1,12,62,58,-4,B
sneakypawn 2006.11.14,865,1,0,14,211,14,-197,A
sneakypawn 2006.11.14,865,1,0,14,209,14,-195,B
sneakypawn 2006.10.27,867,1,0,12,286,8,-278,A
sneakypawn 2006.10.27,867,1,0,12,224,17,-207,B
walnutwally 2006.10.27,1112,1,1,10,56,50,-6,A
walnutwally 2006.10.27,1112,1,1,10,54,40,-14,B
stickyfinger 2003.12.01,1022,1,0,9,482,33,-449,A
stickyfinger 2003.12.01,1022,1,0,9,448,22,-426,B
radicalrichierich 2003.12.01,945,1,1,7,399,14,-385,A
radicalrichierich 2003.12.01,945,1,1,7,418,14,-404,B
dockson 2003.05.14,895,1,0,6,338,17,-321,A
dockson 2003.05.14,895,1,0,6,309,17,-292,B
Charolastra 2003.05.14,1052,1,1,5,214,40,-174,A
Charolastra 2003.05.14,1052,1,1,5,170,40,-130,B
rbb 2005.11.29,837,1,1,7,92,57,-35,A
rbb 2005.11.29,837,1,1,7,64,43,-21,B
forkboy 2005.11.29,1068,1,0,9,371,44,-327,A
forkboy 2005.11.29,1068,1,0,9,382,33,-349,B
augustuscaesar 2006.07.25,917,1,0,17,213,18,-195,A
augustuscaesar 2006.07.25,917,1,0,17,212,12,-200,B
TheCardinal 2006.07.25,1052,1,1,15,162,27,-135,A
TheCardinal 2006.07.25,1052,1,1,15,160,20,-140,B
selectorSimit 2006.12.06,914,1,1,11,67,54,-13,A
selectorSimit 2006.12.06,914,1,1,11,59,46,-13,B
hotwheelb 2006.12.06,899,1,0,12,282,17,-265,A
hotwheelb 2006.12.06,899,1,0,12,270,8,-262,B
GolfBob 2004.03.09,935,1,0,23,273,22,-251,A
GolfBob 2004.03.09,935,1,0,23,302,13,-289,B
shechem 2004.03.09,1006,1,1,23,291,30,-261,A
shechem 2004.03.09,1006,1,1,23,311,30,-281,B
DazedDj 2003.12.16,946,7,1,130,233,27,-206,A
DazedDj 2003.12.16,946,7,1,130,213,28,-185,B
BoardBoy 2003.12.16,1039,7,6,111,139,39,-100,A
BoardBoy 2003.12.16,1039,7,6,111,131,38,-93,B
BRubble 2003.07.05,1044,1,1,10,40,70,30,A
BRubble 2003.07.05,1044,1,1,10,42,70,28,B
dumpyshubby 2003.07.05,920,2,1,15,205,7,-198,A
dumpyshubby 2003.07.05,920,2,1,15,202,7,-195,B
Triplea 2003.03.29,909,3,2.5,48,205,23,-182,A
Triplea 2003.03.29,909,3,2.5,48,182,23,-159,B
pendragonz 2003.03.29,1031,1,0.5,28,172,39,-133,A
pendragonz 2003.03.29,1031,1,0.5,28,151,39,-112,B
supriyasodhi 2006.06.12,922,3,0,42,289,24,-265,A
supriyasodhi 2006.06.12,922,3,0,42,276,17,-259,B
hungerartist 2006.06.12,1076,3,3,40,262,20,-242,A
hungerartist 2006.06.12,1076,3,3,40,264,17,-247,B
iascrazyorioles 2006.12.18,921,1,1,33,68,33,-35,A
iascrazyorioles 2006.12.18,921,1,1,33,65,30,-35,B
hotwheela 2006.12.18,911,1,0,44,140,25,-115,A
hotwheela 2006.12.18,911,1,0,44,195,23,-172,B
dockson 2004.02.11,874,1,0,28,151,25,-126,A
dockson 2004.02.11,874,1,0,28,145,29,-116,B
shechem 2004.02.11,1056,1,1,30,246,27,-219,A
shechem 2004.02.11,1056,1,1,30,247,20,-227,B
Ironmeis 2006.10.28,1002,1,0,6,182,17,-165,A
Ironmeis 2006.10.28,1002,1,0,6,195,0,-195,B
DAarden 2006.10.28,985,1,1,5,169,0,-169,A
DAarden 2006.10.28,985,1,1,5,170,0,-170,B
chelletijn 2004.02.16,958,2,1,23,314,43,-271,A
chelletijn 2004.02.16,958,2,1,23,299,39,-260,B
Melko 2004.02.16,990,1,1,8,104,75,-29,A
Melko 2004.02.16,990,1,1,8,146,75,-71,B
onewords 2004.02.20,883,1,1,6,7,83,76,A
onewords 2004.02.20,883,1,1,6,8,83,75,B
chessshaq 2004.02.20,1030,1,0,6,199,33,-166,A
chessshaq 2004.02.20,1030,1,0,6,205,17,-188,B
jpiscool 2006.12.23,1147,1,0,10,232,20,-212,A
jpiscool 2006.12.23,1147,1,0,10,232,20,-212,B
hotwheela 2006.12.23,784,1,1,9,164,22,-142,A
hotwheela 2006.12.23,784,1,1,9,164,22,-142,B
dockson 2004.03.09,995,1,0,5,344,0,-344,A
dockson 2004.03.09,995,1,0,5,327,0,-327,B
voetbalfan 2004.03.09,929,1,1,4,179,0,-179,A
voetbalfan 2004.03.09,929,1,1,4,154,0,-154,B
DunnMark 2004.01.13,1167,1,1,10,49,50,1,A
DunnMark 2004.01.13,1167,1,1,10,43,50,7,B
CashCow 2004.01.13,831,1,0,10,139,10,-129,A
CashCow 2004.01.13,831,1,0,10,150,10,-140,B
yanto 2004.02.10,995,1,1,23,120,26,-94,A
yanto 2004.02.10,995,1,1,23,113,26,-87,B
yanto 2004.02.10,995,1,1,23,115,26,-89,C
dockson 2004.02.10,874,1,0,25,155,56,-99,A
dockson 2004.02.10,874,1,0,25,155,52,-103,B
dockson 2004.02.10,874,1,0,25,151,44,-107,C
sibil 2004.03.02,1095,1,1,13,116,31,-85,A
sibil 2004.03.02,1095,1,1,13,106,38,-68,B
WhiteSide 2004.03.02,848,2,1,33,208,27,-181,A
WhiteSide 2004.03.02,848,2,1,33,197,39,-158,B
hawklady 2004.01.09,819,1,0,8,279,12,-267,A
hawklady 2004.01.09,819,1,0,8,271,12,-259,B
justacityboy 2004.01.09,1159,1,1,6,100,50,-50,A
justacityboy 2004.01.09,1159,1,1,6,95,50,-45,B
jshumaker 2006.12.28,875,1,0,7,316,14,-302,A
jshumaker 2006.12.28,875,1,0,7,310,29,-281,B
Chessword 2006.12.28,988,1,1,6,120,33,-87,A
Chessword 2006.12.28,988,1,1,6,121,33,-88,B
Sevenkings 2006.10.26,1101,2,2,19,203,21,-182,A
Sevenkings 2006.10.26,1101,2,2,19,201,26,-175,B
sneakypawn 2006.10.26,894,2,0,22,361,9,-352,A
sneakypawn 2006.10.26,894,2,0,22,388,5,-383,B
dockson 2003.05.07,916,1,0,7,184,29,-155,A
dockson 2003.05.07,916,1,0,7,175,43,-132,B
dgreality 2003.05.07,1054,1,1,7,192,29,-163,A
dgreality 2003.05.07,1054,1,1,7,194,14,-180,B
Bryceman 2003.04.13,1165,1,0,88,94,43,-51,A
Bryceman 2003.04.13,1165,1,0,88,99,40,-59,B
Fitzakarle 2003.04.13,742,1,1,86,78,26,-52,A
Fitzakarle 2003.04.13,742,1,1,86,76,30,-46,B
Fitzakarle 2003.04.10,907,1,0,15,162,20,-142,A
Fitzakarle 2003.04.10,907,1,0,15,149,27,-122,B
pendragonz 2003.04.10,1070,1,1,13,65,38,-27,A
pendragonz 2003.04.10,1070,1,1,13,54,38,-16,B
Gamberetto 2006.12.10,1071,1,1,4,38,25,-13,A
Gamberetto 2006.12.10,1071,1,1,4,19,50,31,B
timmyotool 2006.12.10,909,1,0,4,309,0,-309,A
timmyotool 2006.12.10,909,1,0,4,300,0,-300,B
metallicguy 2006.10.05,885,1,1,8,118,62,-56,A
metallicguy 2006.10.05,885,1,1,8,147,62,-85,B
Funditor 2006.10.05,876,1,0,10,307,50,-257,A
Funditor 2006.10.05,876,1,0,10,342,10,-332,B
flinn 2003.05.02,1029,1,0,14,168,43,-125,A
flinn 2003.05.02,1029,1,0,14,141,43,-98,B
abeme 2003.05.02,855,1,1,11,90,27,-63,A
abeme 2003.05.02,855,1,1,11,60,54,-6,B
tujhbq 2006.10.02,933,1,1,11,6,82,76,A
tujhbq 2006.10.02,933,1,1,11,14,82,68,B
Elrocks 2006.10.02,764,1,0,11,153,18,-135,A
Elrocks 2006.10.02,764,1,0,11,157,27,-130,B
jmvbxx 2006.09.06,1004,1,1,12,93,58,-35,A
jmvbxx 2006.09.06,1004,1,1,12,98,58,-40,B
KnightLightning 2006.09.06,956,2,0.5,52,159,31,-128,A
KnightLightning 2006.09.06,956,2,0.5,52,140,33,-107,B
reddawgdead 2006.07.26,936,2,1,35,202,31,-171,A
reddawgdead 2006.07.26,936,2,1,35,195,34,-161,B
TeddySauyet 2006.07.26,978,2,1,46,266,28,-238,A
TeddySauyet 2006.07.26,978,2,1,46,258,28,-230,B
HGBoone 2005.10.10,970,1,1,5,66,40,-26,A
HGBoone 2005.10.10,970,1,1,5,48,60,12,B
smugknave 2005.10.10,989,2,0.5,22,320,27,-293,A
smugknave 2005.10.10,989,2,0.5,22,310,27,-283,B
Folinsbee 2004.03.02,934,1,0,18,173,28,-145,A
Folinsbee 2004.03.02,934,1,0,18,158,28,-130,B
bigouden 2006.12.09,1013,1,0,40,109,43,-66,A
bigouden 2006.12.09,1013,1,0,40,103,45,-58,B
uvrays 2006.12.09,952,1,1,36,87,39,-48,A
uvrays 2006.12.09,952,1,1,36,83,36,-47,B
onewords 2004.02.18,977,1,0,11,149,9,-140,A
onewords 2004.02.18,977,1,0,11,134,18,-116,B
chelletijn 2004.02.18,958,1,1,10,19,60,41,A
chelletijn 2004.02.18,958,1,1,10,15,60,45,B
zukerro 2004.02.16,932,1,0,12,139,42,-97,A
zukerro 2004.02.16,932,1,0,12,148,33,-115,B
encairo 2004.02.26,1034,1,0,15,232,13,-219,A
encairo 2004.02.26,1034,1,0,15,254,13,-241,B
Folinsbee 2004.02.26,941,1,1,11,87,46,-41,A
Folinsbee 2004.02.26,941,1,1,11,86,46,-40,B
pascalwilliams 2006.12.09,1176,1,1,4,393,25,-368,A
pascalwilliams 2006.12.09,1176,1,1,4,400,25,-375,B
hotwheelb 2006.12.02,854,1,0,17,156,24,-132,A
hotwheelb 2006.12.02,854,1,0,17,152,29,-123,B
FEDt 2006.12.02,1054,1,1,15,66,33,-33,A
FEDt 2006.12.02,1054,1,1,15,56,33,-23,B
nuthegoob 2006.10.18,933,1,0,18,239,28,-211,A
nuthegoob 2006.10.18,933,1,0,18,210,22,-188,B
pbanx 2006.10.18,1023,1,1,23,242,35,-207,A
pbanx 2006.10.18,1023,1,1,23,251,35,-216,B
rossx 2006.09.05,974,1,1,19,261,21,-240,A
rossx 2006.09.05,974,1,1,19,225,21,-204,B
Nackler 2006.09.05,1010,1,0,19,223,21,-202,A
Nackler 2006.09.05,1010,1,0,19,203,10,-193,B
LaVigne 2005.12.14,931,1,0,11,287,27,-260,A
LaVigne 2005.12.14,931,1,0,11,163,27,-136,B
pollbellini 2005.12.14,952,1,1,11,142,18,-124,A
pollbellini 2005.12.14,952,1,1,11,85,18,-67,B
wwdotti 2005.11.16,970,1,1,6,69,67,-2,A
wwdotti 2005.11.16,970,1,1,6,96,67,-29,B
americanista 2005.11.16,948,1,0,6,268,33,-235,A
americanista 2005.11.16,948,1,0,6,215,33,-182,B
NRking 2006.12.08,1138,2,1,38,131,39,-92,A
NRking 2006.12.08,1138,2,1,38,127,37,-90,B
voetbalfan 2004.02.15,968,1,1,18,148,33,-115,A
voetbalfan 2004.02.15,968,1,1,18,136,28,-108,B
chelletijn 2004.02.15,998,1,0,18,149,44,-105,A
chelletijn 2004.02.15,998,1,0,18,150,44,-106,B
Truelan 2006.10.28,1004,2,0,55,190,27,-163,A
Truelan 2006.10.28,1004,2,0,55,194,33,-161,B
SamuelJunior 2006.10.28,960,2,2,54,140,33,-107,A
SamuelJunior 2006.10.28,960,2,2,54,147,31,-116,B
subwoofer 2006.11.25,1092,1,1,9,139,44,-95,A
subwoofer 2006.11.25,1092,1,1,9,118,33,-85,B
hotwheelb 2006.11.25,881,1,0,9,310,0,-310,A
hotwheelb 2006.11.25,881,1,0,9,290,0,-290,B
GlennaSarous 2003.11.22,956,1,0,20,222,30,-192,A
GlennaSarous 2003.11.22,956,1,0,20,222,30,-192,B
gough 2003.11.22,971,1,1,19,207,32,-175,A
gough 2003.11.22,971,1,1,19,202,32,-170,B
wwdotti 2005.12.04,970,1,1,11,52,27,-25,A
wwdotti 2005.12.04,970,1,1,11,75,18,-57,B
FarooqBaloch 2005.12.04,997,1,0,12,221,25,-196,A
FarooqBaloch 2005.12.04,997,1,0,12,250,17,-233,B
HEARTLESSWIZARD 2005.11.05,940,1,0,14,292,14,-278,A
HEARTLESSWIZARD 2005.11.05,940,1,0,14,264,14,-250,B
KJett 2005.11.05,1046,1,1,13,191,23,-168,A
KJett 2005.11.05,1046,1,1,13,175,23,-152,B
supriyasodhi 2006.06.21,842,1,0,5,180,40,-140,A
supriyasodhi 2006.06.21,842,1,0,5,199,40,-159,B
unluckythirtyfive 2006.06.21,1110,1,1,5,67,40,-27,A
unluckythirtyfive 2006.06.21,1110,1,1,5,58,60,2,B
loccsta 2004.02.08,915,1,0,23,49,17,-32,A
loccsta 2004.02.08,915,1,0,23,44,13,-31,B
loccsta 2004.02.08,915,1,0,23,62,13,-49,C
PravinMamania 2004.02.08,982,1,1,22,22,50,28,A
PravinMamania 2004.02.08,982,1,1,22,18,41,23,B
PravinMamania 2004.02.08,982,1,1,22,18,41,23,C
feelm 2006.10.25,918,1,1,22,136,41,-95,A
feelm 2006.10.25,918,1,1,22,128,41,-87,B
hatrik 2006.10.25,1032,1,0,28,285,32,-253,A
hatrik 2006.10.25,1032,1,0,28,288,29,-259,B
feelm 2006.11.18,985,1,1,24,162,42,-120,A
feelm 2006.11.18,985,1,1,24,155,42,-113,B
VasTech 2006.11.18,946,1,0,24,253,25,-228,A
VasTech 2006.11.18,946,1,0,24,237,25,-212,B
BoardBoy 2004.01.04,1079,1,0.5,18,265,11,-254,A
BoardBoy 2004.01.04,1079,1,0.5,18,232,11,-221,B
DazedDj 2004.01.04,809,1,0.5,17,176,24,-152,A
DazedDj 2004.01.04,809,1,0.5,17,148,29,-119,B
tunacem 2006.11.12,920,1,1,13,101,46,-55,A
tunacem 2006.11.12,920,1,1,13,113,46,-67,B
DazedDj 2004.01.02,840,1,0,15,202,27,-175,A
DazedDj 2004.01.02,840,1,0,15,212,27,-185,B
BoardBoy 2004.01.02,1071,1,1,12,117,50,-67,A
BoardBoy 2004.01.02,1071,1,1,12,112,58,-54,B
AceDiamond 2003.12.16,990,1,1,21,93,29,-64,A
AceDiamond 2003.12.16,990,1,1,21,86,24,-62,B
churningpigskin 2003.12.16,740,1,0,21,103,52,-51,A
churningpigskin 2003.12.16,740,1,0,21,103,48,-55,B
bsliced 2006.10.21,1161,1,1,4,112,50,-62,A
bsliced 2006.10.21,1161,1,1,4,117,50,-67,B
Johnnyp 2006.10.21,743,1,0,4,340,25,-315,A
Johnnyp 2006.10.21,743,1,0,4,332,25,-307,B
Funditor 2006.10.04,907,2,0,43,161,40,-121,A
Funditor 2006.10.04,907,2,0,43,152,35,-117,B
tujhbq 2006.10.04,994,1,1,41,140,34,-106,A
tujhbq 2006.10.04,994,1,1,41,130,29,-101,B
Triplea 2003.05.01,990,1,0,13,187,46,-141,A
Triplea 2003.05.01,990,1,0,13,204,38,-166,B
DSSagent 2003.05.01,992,1,1,12,191,42,-149,A
DSSagent 2003.05.01,992,1,1,12,217,33,-184,B
uvrays 2006.10.31,831,1,1,18,54,33,-21,A
uvrays 2006.10.31,831,1,1,18,72,28,-44,B
nuthegoob 2006.10.31,936,1,0,20,105,25,-80,A
nuthegoob 2006.10.31,936,1,0,20,124,20,-104,B
ajwillington 2003.11.10,1054,1,1,24,188,38,-150,A
ajwillington 2003.11.10,1054,1,1,24,177,42,-135,B
WhiteSide 2003.11.10,923,1,0,25,275,44,-231,A
WhiteSide 2003.11.10,923,1,0,25,218,44,-174,B
celcius 2006.10.16,1050,1,1,5,198,40,-158,A
celcius 2006.10.16,1050,1,1,5,226,20,-206,B
Funditor 2006.10.16,852,1,0,5,480,20,-460,A
Funditor 2006.10.16,852,1,0,5,405,20,-385,B
nuthegoob 2006.10.17,933,2,1,29,238,10,-228,A
nuthegoob 2006.10.17,933,2,1,29,230,10,-220,B
DAarden 2006.10.17,975,1,1,20,256,25,-231,A
DAarden 2006.10.17,975,1,1,20,250,25,-225,B
mssronald 2003.04.15,807,1,0,5,484,0,-484,A
mssronald 2003.04.15,807,1,0,5,470,0,-470,B
eaglesloft 2003.04.15,1016,1,1,3,147,33,-114,A
eaglesloft 2003.04.15,1016,1,1,3,157,33,-124,B
eaglesloft 2003.03.29,1013,2,2,22,251,27,-224,A
eaglesloft 2003.03.29,1013,2,2,22,246,27,-219,B
mssronald 2003.03.29,874,2,0,28,284,21,-263,A
mssronald 2003.03.29,874,2,0,28,288,21,-267,B
marcuscole 2006.06.30,1003,2,1.5,51,112,41,-71,A
marcuscole 2006.06.30,1003,2,1.5,51,120,37,-83,B
Dkling 2006.06.30,952,2,0.5,47,132,43,-89,A
Dkling 2006.06.30,952,2,0.5,47,108,45,-63,B
BoardBoy 2003.12.12,1024,1,0.5,15,273,20,-253,A
BoardBoy 2003.12.12,1024,1,0.5,15,261,13,-248,B
DazedDj 2003.12.12,921,1,0.5,14,122,57,-65,A
DazedDj 2003.12.12,921,1,0.5,14,123,57,-66,B
uvrays 2006.10.17,878,1,0,8,368,0,-368,A
uvrays 2006.10.17,878,1,0,8,345,0,-345,B
FlatThird 2006.10.04,1095,1,1,4,215,50,-165,A
FlatThird 2006.10.04,1095,1,1,4,219,50,-169,B
Triplea 2003.04.20,1006,2,2,30,111,33,-78,A
Triplea 2003.04.20,1006,2,2,30,102,33,-69,B
KJett 2003.04.20,870,2,0,38,257,18,-239,A
KJett 2003.04.20,870,2,0,38,255,18,-237,B
SergB 2006.09.26,1153,1,1,37,121,49,-72,A
SergB 2006.09.26,1153,1,1,37,124,46,-78,B
uvrays 2006.09.26,806,1,0,35,95,43,-52,A
uvrays 2006.09.26,806,1,0,35,117,34,-83,B
blevente 2006.10.16,958,1,1,7,331,43,-288,A
blevente 2006.10.16,958,1,1,7,267,43,-224,B
nuthegoob 2006.10.16,963,2,0,27,429,15,-414,A
nuthegoob 2006.10.16,963,2,0,27,382,19,-363,B
PureC 2006.10.06,907,1,1,6,200,50,-150,A
PureC 2006.10.06,907,1,1,6,223,50,-173,B
fdh 2006.10.06,1079,1,0,6,275,33,-242,A
fdh 2006.10.06,1079,1,0,6,301,33,-268,B
DSSagent 2003.06.26,980,1,1,13,72,46,-26,A
DSSagent 2003.06.26,980,1,1,13,64,54,-10,B
churningpigskin 2003.06.26,797,1,0,13,169,15,-154,A
churningpigskin 2003.06.26,797,1,0,13,166,15,-151,B
HGBoone 2006.09.22,987,1,1,9,23,78,55,A
HGBoone 2006.09.22,987,1,1,9,45,44,-1,B
Funditor 2006.09.22,876,1,0,11,202,9,-193,A
Funditor 2006.09.22,876,1,0,11,209,18,-191,B
IMPeachyr 2006.08.31,940,1,0,5,308,20,-288,A
IMPeachyr 2006.08.31,940,1,0,5,317,20,-297,B
DaBob 2006.08.31,977,1,1,4,56,50,-6,A
DaBob 2006.08.31,977,1,1,4,48,50,2,B
HEARTLESSWIZARD 2005.12.03,913,1,1,35,164,23,-141,A
HEARTLESSWIZARD 2005.12.03,913,1,1,35,179,26,-153,B
intelinside 2005.12.03,1027,1,0,35,204,43,-161,A
intelinside 2005.12.03,1027,1,0,35,200,40,-160,B
KJett 2003.09.22,894,1,0.5,35,231,34,-197,A
KJett 2003.09.22,894,1,0.5,35,201,34,-167,B
dumpyshubby 2003.09.22,984,1,0.5,38,293,32,-261,A
dumpyshubby 2003.09.22,984,1,0.5,38,252,21,-231,B
metallicguy 2006.09.13,1001,1,0,19,299,26,-273,A
metallicguy 2006.09.13,1001,1,0,19,262,21,-241,B
rossx 2006.09.13,998,1,1,21,296,33,-263,A
rossx 2006.09.13,998,1,1,21,282,24,-258,B
Mikimouse 2003.03.31,1017,1,0,12,299,25,-274,A
Mikimouse 2003.03.31,1017,1,0,12,279,25,-254,B
Giuditta 2003.03.31,980,1,1,7,110,43,-67,A
Giuditta 2003.03.31,980,1,1,7,78,43,-35,B
PawnStarrz 2003.04.04,1128,1,1,22,177,32,-145,A
PawnStarrz 2003.04.04,1128,1,1,22,187,32,-155,B
KJett 2003.04.04,869,1,0,22,327,27,-300,A
KJett 2003.04.04,869,1,0,22,298,14,-284,B
wwdotti 2005.11.28,1024,1,0,22,242,18,-224,A
wwdotti 2005.11.28,1024,1,0,22,200,18,-182,B
HEARTLESSWIZARD 2005.11.28,907,1,1,21,160,38,-122,A
HEARTLESSWIZARD 2005.11.28,907,1,1,21,135,33,-102,B
joelbow 2003.03.29,980,2,0,23,305,17,-288,A
joelbow 2003.03.29,980,2,0,23,302,13,-289,B
forkboy 2005.11.30,977,1,1,10,85,60,-25,A
forkboy 2005.11.30,977,1,1,10,49,60,11,B
HEARTLESSWIZARD 2005.11.30,924,1,0,11,162,36,-126,A
HEARTLESSWIZARD 2005.11.30,924,1,0,11,160,36,-124,B
Lexus 2003.05.10,1035,1,0.5,13,191,15,-176,A
Lexus 2003.05.10,1035,1,0.5,13,190,23,-167,B
KJett 2003.05.10,886,1,0.5,12,85,42,-43,A
KJett 2003.05.10,886,1,0.5,12,86,42,-44,B
Lexus 2003.05.03,1055,1,0,17,293,41,-252,A
Lexus 2003.05.03,1055,1,0,17,271,41,-230,B
KJett 2003.05.03,865,1,1,17,334,24,-310,A
KJett 2003.05.03,865,1,1,17,280,18,-262,B
Thorstein 2006.09.24,957,1,1,5,127,60,-67,A
Thorstein 2006.09.24,957,1,1,5,150,60,-90,B
cuypeji 2006.09.24,968,1,0,5,365,0,-365,A
cuypeji 2006.09.24,968,1,0,5,382,0,-382,B
HerrGott 2006.08.21,1043,1,0,8,276,12,-264,A
HerrGott 2006.08.21,1043,1,0,8,258,12,-246,B
DEDEE 2006.08.21,912,1,1,7,149,29,-120,A
DEDEE 2006.08.21,912,1,1,7,137,43,-94,B
thomasrhymer 2005.10.23,1195,1,1,5,70,60,-10,A
thomasrhymer 2005.10.23,1195,1,1,5,66,60,-6,B
aadeeb 2005.10.23,796,2,0,30,274,17,-257,A
aadeeb 2005.10.23,796,2,0,30,247,23,-224,B
ferking 2006.05.31,1111,4,3,56,204,34,-170,A
ferking 2006.05.31,1111,4,3,56,195,32,-163,B
Memnochblue 2006.05.31,841,4,1,58,235,31,-204,A
Memnochblue 2006.05.31,841,4,1,58,230,28,-202,B
andrewpointone 2003.07.05,1022,1,0,7,552,29,-523,A
andrewpointone 2003.07.05,1022,1,0,7,552,14,-538,B
Tarish 2006.09.13,705,1,0,12,169,50,-119,A
Tarish 2006.09.13,705,1,0,12,174,42,-132,B
jmgamber 2006.09.13,1226,1,1,11,147,18,-129,A
jmgamber 2006.09.13,1226,1,1,11,126,27,-99,B
RandyRoo 2006.10.12,773,1,0,7,273,14,-259,A
RandyRoo 2006.10.12,773,1,0,7,276,14,-262,B
dolphinsfan 2006.10.12,1185,1,1,5,65,60,-5,A
dolphinsfan 2006.10.12,1185,1,1,5,58,60,2,B
Truelan 2006.10.16,932,1,1,18,310,22,-288,A
Truelan 2006.10.16,932,1,1,18,313,28,-285,B
dgreality 2003.04.11,923,1,0.5,13,206,38,-168,A
dgreality 2003.04.11,923,1,0.5,13,216,31,-185,B
ZEFER 2003.04.11,1071,1,0.5,15,290,33,-257,A
ZEFER 2003.04.11,1071,1,0.5,15,280,33,-247,B
KJett 2003.04.05,859,1,1,23,149,43,-106,A
KJett 2003.04.05,859,1,1,23,141,39,-102,B
dardanus 2003.04.05,1134,1,0,20,151,20,-131,A
dardanus 2003.04.05,1134,1,0,20,157,20,-137,B
badantony 2006.10.11,935,1,0,5,518,20,-498,A
badantony 2006.10.11,935,1,0,5,473,20,-453,B
nuthegoob 2006.10.11,1006,1,1,3,205,33,-172,A
nuthegoob 2006.10.11,1006,1,1,3,214,33,-181,B
redistribute 2006.10.03,1096,1,0,18,210,11,-199,A
redistribute 2006.10.03,1096,1,0,18,216,22,-194,B
Funditor 2006.10.03,892,1,1,16,120,31,-89,A
Funditor 2006.10.03,892,1,1,16,118,25,-93,B
Triplea 2003.04.12,1041,1,1,22,83,41,-42,A
Triplea 2003.04.12,1041,1,1,22,85,41,-44,B
Fitzakarle 2003.04.12,787,1,0,23,118,44,-74,A
Fitzakarle 2003.04.12,787,1,0,23,125,44,-81,B
Saldeeznuts 2006.09.28,937,1,1,15,170,27,-143,A
Saldeeznuts 2006.09.28,937,1,1,15,164,20,-144,B
Funditor 2006.09.28,1016,1,0,15,279,33,-246,A
Funditor 2006.09.28,1016,1,0,15,249,40,-209,B
nepvetm 2006.09.09,1053,1,0,24,238,29,-209,A
nepvetm 2006.09.09,1053,1,0,24,242,29,-213,B
shahar 2006.09.09,900,1,1,20,161,25,-136,A
shahar 2006.09.09,900,1,1,20,168,25,-143,B
pddchess 2005.12.14,957,1,0,18,202,28,-174,A
pddchess 2005.12.14,957,1,0,18,205,28,-177,B
azshtrdude 2005.12.14,881,1,1,15,167,33,-134,A
azshtrdude 2005.12.14,881,1,1,15,153,20,-133,B
sirkillalot 2003.04.10,1071,1,1,7,122,43,-79,A
sirkillalot 2003.04.10,1071,1,1,7,135,43,-92,B
joelbow 2003.04.10,924,1,0,7,245,29,-216,A
joelbow 2003.04.10,924,1,0,7,317,14,-303,B
eaglesloft 2003.03.18,1006,1,1,4,199,25,-174,A
eaglesloft 2003.03.18,1006,1,1,4,138,0,-138,B
mssronald 2003.03.18,930,1,0,4,490,25,-465,A
mssronald 2003.03.18,930,1,0,4,428,0,-428,B
hbengts 2006.06.09,973,1,1,22,109,32,-77,A
hbengts 2006.06.09,973,1,1,22,114,32,-82,B
supriyasodhi 2006.06.09,938,1,0,24,192,17,-175,A
supriyasodhi 2006.06.09,938,1,0,24,186,21,-165,B
Triplea 2003.02.01,871,1,0,19,339,32,-307,A
Triplea 2003.02.01,871,1,0,19,218,32,-186,B
brekneck 2003.02.01,1073,1,1,20,216,40,-176,A
brekneck 2003.02.01,1073,1,1,20,219,35,-184,B
SkarryLarry 2005.07.15,792,1,0,14,224,36,-188,A
SkarryLarry 2005.07.15,792,1,0,14,301,21,-280,B
Laddie 2005.07.15,1074,1,1,11,134,36,-98,A
Laddie 2005.07.15,1074,1,1,11,160,36,-124,B
iveyjr 2005.07.02,889,2,1,25,213,32,-181,A
iveyjr 2005.07.02,889,2,1,25,221,32,-189,B
MartyL 2005.07.02,958,2,1,37,211,27,-184,A
MartyL 2005.07.02,958,2,1,37,211,24,-187,B
jashevan 2005.12.09,1088,1,1,19,119,37,-82,A
jashevan 2005.12.09,1088,1,1,19,97,32,-65,B
clickoo 2005.12.09,820,1,0,20,218,35,-183,A
clickoo 2005.12.09,820,1,0,20,192,40,-152,B
bigrig 2005.12.04,1022,1,1,11,126,36,-90,A
bigrig 2005.12.04,1022,1,1,11,126,27,-99,B
clickoo 2005.12.04,862,1,0,11,170,46,-124,A
clickoo 2005.12.04,862,1,0,11,166,36,-130,B
Sunsfan 2006.07.26,1008,1,1,15,263,20,-243,A
Sunsfan 2006.07.26,1008,1,1,15,257,20,-237,B
VasTech 2006.07.26,985,1,0,11,373,9,-364,A
VasTech 2006.07.26,985,1,0,11,389,9,-380,B
eaglesloft 2003.02.15,1035,1,1,17,259,24,-235,A
eaglesloft 2003.02.15,1035,1,1,17,240,29,-211,B
mssronald 2003.02.15,849,1,0,19,384,16,-368,A
mssronald 2003.02.15,849,1,0,19,362,16,-346,B
dolphinsfan 2006.09.06,973,1,0.5,42,107,40,-67,A
dolphinsfan 2006.09.06,973,1,0.5,42,98,40,-58,B
Triplea 2003.03.22,863,1,1,12,117,50,-67,A
Triplea 2003.03.22,863,1,1,12,120,33,-87,B
Mikimouse 2003.03.22,1027,1,0,13,171,31,-140,A
Mikimouse 2003.03.22,1027,1,0,13,176,38,-138,B
darjos 2003.03.03,971,2,0,21,244,19,-225,A
darjos 2003.03.03,971,2,0,21,211,14,-197,B
brisham 2003.03.03,991,2,2,21,214,33,-181,A
brisham 2003.03.03,991,2,2,21,180,33,-147,B
claudiolozea 2003.02.09,1132,1,1,6,60,67,7,A
claudiolozea 2003.02.09,1132,1,1,6,45,67,22,B
Triplea 2003.02.09,837,1,0,7,467,0,-467,A
Triplea 2003.02.09,837,1,0,7,436,0,-436,B
LeFol 2006.06.11,1041,1,1,8,48,62,14,A
LeFol 2006.06.11,1041,1,1,8,33,62,29,B
twilc 2006.06.11,951,1,0,8,245,12,-233,A
twilc 2006.06.11,951,1,0,8,182,12,-170,B
pddchess 2005.12.12,956,1,1,5,127,20,-107,A
pddchess 2005.12.12,956,1,1,5,134,40,-94,B
erta 2005.12.12,979,1,0,5,274,20,-254,A
erta 2005.12.12,979,1,0,5,285,20,-265,B
aBlade 2006.08.19,1078,1,1,4,193,25,-168,A
aBlade 2006.08.19,1078,1,1,4,201,25,-176,B
jbuttler 2006.08.19,878,1,0,4,423,25,-398,A
jbuttler 2006.08.19,878,1,0,4,457,25,-432,B
achimdragos 2006.08.21,844,1,1,9,218,67,-151,A
achimdragos 2006.08.21,844,1,1,9,244,44,-200,B
hungerartist 2006.08.21,1090,1,0,9,367,33,-334,A
hungerartist 2006.08.21,1090,1,0,9,366,22,-344,B
milamores 2005.11.24,922,1,1,25,169,24,-145,A
milamores 2005.11.24,922,1,1,25,177,24,-153,B
uvrays 2005.11.24,908,1,0,24,189,17,-172,A
uvrays 2005.11.24,908,1,0,24,208,12,-196,B
astronomyguy 2005.11.30,1124,1,1,23,129,52,-77,A
astronomyguy 2005.11.30,1124,1,1,23,123,35,-88,B
Johnnyp 2005.11.30,828,1,0,28,234,32,-202,A
Johnnyp 2005.11.30,828,1,0,28,245,32,-213,B
dustbuni 2006.08.30,909,1,0,10,377,0,-377,A
dustbuni 2006.08.30,909,1,0,10,386,0,-386,B
cgorski 2006.08.30,988,1,1,7,61,71,10,A
cgorski 2006.08.30,988,1,1,7,60,71,11,B
americanista 2005.11.17,868,1,1,9,287,22,-265,A
americanista 2005.11.17,868,1,1,9,262,22,-240,B
mascota 2005.11.17,934,1,0,11,453,9,-444,A
mascota 2005.11.17,934,1,0,11,381,18,-363,B
rochon 2005.09.09,909,1,1,43,106,49,-57,A
rochon 2005.09.09,909,1,1,43,105,44,-61,B
unclebaal 2005.09.09,1081,1,0,45,155,31,-124,A
unclebaal 2005.09.09,1081,1,0,45,158,31,-127,B
LaFleurDeLys 2003.01.25,849,1,0,11,676,9,-667,A
LaFleurDeLys 2003.01.25,849,1,0,11,698,9,-689,B
Triplea 2003.01.25,822,3,2,38,217,32,-185,A
Triplea 2003.01.25,822,3,2,38,224,29,-195,B
abcc 2006.08.05,1083,1,0,41,104,37,-67,A
abcc 2006.08.05,1083,1,0,41,86,34,-52,B
Tizko 2006.08.05,887,1,1,41,75,44,-31,A
Tizko 2006.08.05,887,1,1,41,71,44,-27,B
pohlie 2005.11.24,1045,1,1,25,167,36,-131,A
pohlie 2005.11.24,1045,1,1,25,169,36,-133,B
HEARTLESSWIZARD 2005.11.24,928,1,0,27,239,33,-206,A
HEARTLESSWIZARD 2005.11.24,928,1,0,27,255,37,-218,B
TeddySauyet 2006.06.28,1010,1,0,11,343,46,-297,A
TeddySauyet 2006.06.28,1010,1,0,11,340,27,-313,B
SamuelJunior 2006.06.28,978,1,1,8,142,62,-80,A
SamuelJunior 2006.06.28,978,1,1,8,185,50,-135,B
Garzon 2006.07.26,1080,1,1,16,299,19,-280,A
Garzon 2006.07.26,1080,1,1,16,268,31,-237,B
augustuscaesar 2006.07.26,850,1,0,14,380,29,-351,A
augustuscaesar 2006.07.26,850,1,0,14,329,29,-300,B
LazyFIDERook 2006.08.22,922,1,0,33,204,36,-168,A
LazyFIDERook 2006.08.22,922,1,0,33,211,36,-175,B
netbrain 2006.08.22,1043,1,1,26,164,35,-129,A
netbrain 2006.08.22,1043,1,1,26,116,19,-97,B
Unknowner 2005.10.23,1071,1,1,21,195,29,-166,A
Unknowner 2005.10.23,1071,1,1,21,176,29,-147,B
HEARTLESSWIZARD 2005.11.27,918,1,0,11,238,18,-220,A
HEARTLESSWIZARD 2005.11.27,918,1,0,11,198,27,-171,B
DaveFromWazza 2005.11.27,1000,1,1,15,233,40,-193,A
DaveFromWazza 2005.11.27,1000,1,1,15,208,40,-168,B
cuzzer 2005.11.09,1067,1,0,37,291,22,-269,A
cuzzer 2005.11.09,1067,1,0,37,295,24,-271,B
kilkennycat 2005.11.09,904,1,1,36,270,22,-248,A
kilkennycat 2005.11.09,904,1,1,36,259,25,-234,B
BothFeet 2005.11.07,926,1,0,32,232,28,-204,A
BothFeet 2005.11.07,926,1,0,32,237,31,-206,B
BishopDaMan 2005.11.07,866,1,1,31,263,23,-240,A
BishopDaMan 2005.11.07,866,1,1,31,262,26,-236,B
dgreality 2003.03.22,1132,1,0,25,351,12,-339,A
dgreality 2003.03.22,1132,1,0,25,288,16,-272,B
KJett 2003.03.22,842,1,1,20,285,20,-265,A
KJett 2003.03.22,842,1,1,20,237,25,-212,B
KJett 2003.02.21,874,1,0,27,249,22,-227,A
KJett 2003.02.21,874,1,0,27,272,18,-254,B
gswiff 2003.02.21,1088,1,1,25,188,36,-152,A
gswiff 2003.02.21,1088,1,1,25,197,32,-165,B
coloradorover 2003.02.05,1141,1,1,13,194,15,-179,A
coloradorover 2003.02.05,1141,1,1,13,188,8,-180,B
Dusti 2003.02.05,837,1,0,13,326,23,-303,A
Dusti 2003.02.05,837,1,0,13,237,31,-206,B
AFMD 2006.07.19,1153,1,0,11,228,27,-201,A
AFMD 2006.07.19,1153,1,0,11,237,18,-219,B
twilc 2006.07.19,806,1,1,11,250,46,-204,A
twilc 2006.07.19,806,1,1,11,259,36,-223,B
Dkling 2006.06.29,987,2,0,42,186,24,-162,A
Dkling 2006.06.29,987,2,0,42,187,29,-158,B
marcuscole 2006.06.29,994,2,2,39,183,36,-147,A
marcuscole 2006.06.29,994,2,2,39,169,33,-136,B
jornf 2002.12.26,1039,1,1,8,42,50,8,A
jornf 2002.12.26,1039,1,1,8,48,50,2,B
coloradorover 2002.12.26,968,7,0,115,195,31,-164,A
coloradorover 2002.12.26,968,7,0,115,180,34,-146,B
philippeopr 2005.08.14,1135,1,0.5,20,71,35,-36,A
philippeopr 2005.08.14,1135,1,0.5,20,62,40,-22,B
SkarryLarry 2005.08.14,769,1,0.5,21,152,33,-119,A
SkarryLarry 2005.08.14,769,1,0.5,21,150,33,-117,B
Triplea 2003.03.16,826,1,1,10,216,20,-196,A
Triplea 2003.03.16,826,1,1,10,211,20,-191,B
Neeter 2003.03.16,890,1,0,12,366,25,-341,A
Neeter 2003.03.16,890,1,0,12,387,33,-354,B
bigrig 2005.10.10,1001,1,0.5,17,225,35,-190,A
bigrig 2005.10.10,1001,1,0.5,17,248,35,-213,B
coloradorover 2003.01.22,1032,2,1,34,178,21,-157,A
coloradorover 2003.01.22,1032,2,1,34,163,24,-139,B
mrudy 2003.01.22,964,1,1,18,209,28,-181,A
mrudy 2003.01.22,964,1,1,18,209,33,-176,B
puzzledmindLady 2005.08.07,1022,1,1,8,134,25,-109,A
puzzledmindLady 2005.08.07,1022,1,1,8,120,38,-82,B
bonillaice 2005.08.07,830,2,1,13,244,46,-198,A
bonillaice 2005.08.07,830,2,1,13,238,46,-192,B
xxYxxY 2006.05.09,980,1,1,10,59,40,-19,A
xxYxxY 2006.05.09,980,1,1,10,62,40,-22,B
DEDEE 2006.05.09,936,1,0,10,184,10,-174,A
DEDEE 2006.05.09,936,1,0,10,186,20,-166,B
apospap 2006.06.26,972,1,0,24,270,17,-253,A
apospap 2006.06.26,972,1,0,24,283,33,-250,B
TeddySauyet 2006.06.26,999,2,2,42,204,24,-180,A
TeddySauyet 2006.06.26,999,2,2,42,222,26,-196,B
Agee 2003.03.06,1020,1,1,43,208,28,-180,A
Agee 2003.03.06,1020,1,1,43,169,28,-141,B
KJett 2003.03.06,856,1,0,48,265,29,-236,A
KJett 2003.03.06,856,1,0,48,274,27,-247,B
eaglesloft 2003.03.04,1004,1,1,8,160,12,-148,A
eaglesloft 2003.03.04,1004,1,1,8,145,12,-133,B
flinn 2003.03.04,962,1,0,11,360,18,-342,A
flinn 2003.03.04,962,1,0,11,381,18,-363,B
trovillion 2005.09.07,1039,1,1,11,381,18,-363,A
trovillion 2005.09.07,1039,1,1,11,398,18,-380,B
rtgreen 2005.09.07,925,1,0,8,240,50,-190,A
rtgreen 2005.09.07,925,1,0,8,238,50,-188,B
TeddySauyet 2006.06.27,1027,1,0,31,372,36,-336,A
TeddySauyet 2006.06.27,1027,1,0,31,371,36,-335,B
SamuelJunior 2006.06.27,916,1,1,27,182,41,-141,A
SamuelJunior 2006.06.27,916,1,1,27,172,41,-131,B
supriyasodhi 2006.06.20,854,1,0,10,266,10,-256,A
supriyasodhi 2006.06.20,854,1,0,10,277,10,-267,B
ferking 2006.06.20,1118,1,1,9,160,44,-116,A
ferking 2006.06.20,1118,1,1,9,156,44,-112,B
Issaac 2003.02.28,1071,1,0,8,184,12,-172,A
Issaac 2003.02.28,1071,1,0,8,185,12,-173,B
dockson 2003.02.28,922,1,1,7,126,14,-112,A
dockson 2003.02.28,922,1,1,7,131,14,-117,B
nicolaus 2006.06.23,1084,1,1,21,142,29,-113,A
nicolaus 2006.06.23,1084,1,1,21,133,19,-114,B
Panzulo 2006.06.23,844,1,0,21,159,38,-121,A
Panzulo 2006.06.23,844,1,0,21,162,38,-124,B
Memnochblue 2006.05.26,850,4,1,59,227,27,-200,A
Memnochblue 2006.05.26,850,4,1,59,221,24,-197,B
jmlichtman 2006.05.26,961,2,1,14,219,14,-205,A
jmlichtman 2006.05.26,961,2,1,14,229,14,-215,B
FraserChapman 2005.08.28,961,1,0,12,232,8,-224,A
FraserChapman 2005.08.28,961,1,0,12,244,8,-236,B
Silicate 2005.08.28,884,1,1,14,204,21,-183,A
Silicate 2005.08.28,884,1,1,14,170,36,-134,B
LaFleurDeLys 2003.01.07,901,1,0,9,256,11,-245,A
LaFleurDeLys 2003.01.07,901,1,0,9,166,11,-155,B
coloradorover 2003.01.07,1046,2,1,19,145,37,-108,A
coloradorover 2003.01.07,1046,2,1,19,160,37,-123,B
Silicate 2005.08.29,899,1,0,22,146,36,-110,A
Silicate 2005.08.29,899,1,0,22,126,41,-85,B
DHunt 2005.08.29,1091,1,1,26,236,19,-217,A
DHunt 2005.08.29,1091,1,1,26,237,23,-214,B
SamuelJunior 2006.06.26,904,1,0,24,295,29,-266,A
SamuelJunior 2006.06.26,904,1,0,24,341,25,-316,B
paiura 2003.02.23,1141,1,0,7,297,0,-297,A
paiura 2003.02.23,1141,1,0,7,254,14,-240,B
PiNNO 2003.02.23,850,1,1,6,120,33,-87,A
PiNNO 2003.02.23,850,1,1,6,80,33,-47,B
Faydogg 2003.02.18,1053,1,1,4,88,50,-38,A
Faydogg 2003.02.18,1053,1,1,4,118,50,-68,B
KJett 2003.02.18,904,1,0,4,435,25,-410,A
KJett 2003.02.18,904,1,0,4,462,25,-437,B
KJett 2003.02.20,887,1,0,18,298,22,-276,A
KJett 2003.02.20,887,1,0,18,238,28,-210,B
claudiolozea 2003.02.20,1088,1,1,17,167,29,-138,A
claudiolozea 2003.02.20,1088,1,1,17,159,29,-130,B
KnightToRookSix 2003.02.02,1127,1,1,30,71,37,-34,A
KnightToRookSix 2003.02.02,1127,1,1,30,72,37,-35,B
WardBurtonfan 2003.02.02,821,1,0,32,127,31,-96,A
WardBurtonfan 2003.02.02,821,1,0,32,123,31,-92,B
WardBurtonfan 2003.01.24,892,1,0,8,166,38,-128,A
WardBurtonfan 2003.01.24,892,1,0,8,158,50,-108,B
CelticMoon 2003.01.24,1097,2,2,15,300,13,-287,A
CelticMoon 2003.01.24,1097,2,2,15,232,13,-219,B
crazycousins 2006.06.19,1156,1,1,12,266,33,-233,A
crazycousins 2006.06.19,1156,1,1,12,277,33,-244,B
twilc 2006.06.19,832,1,0,9,146,44,-102,A
twilc 2006.06.19,832,1,0,9,156,44,-112,B
WarlordNatick 2005.10.16,1117,1,1,18,136,61,-75,A
WarlordNatick 2005.10.16,1117,1,1,18,140,56,-84,B
rbb 2005.10.16,820,1,0,16,174,25,-149,A
rbb 2005.10.16,820,1,0,16,179,25,-154,B
KJett 2003.01.25,1003,1,0,28,321,32,-289,A
KJett 2003.01.25,1003,1,0,28,248,32,-216,B
Laddie 2002.12.26,1044,2,2,23,94,43,-51,A
Laddie 2002.12.26,1044,2,2,23,102,35,-67,B
skuller 2002.07.20,1073,2,2,18,187,28,-159,A
skuller 2002.07.20,1073,2,2,18,186,33,-153,B
aikloong 2002.07.20,698,2,0,20,303,30,-273,A
aikloong 2002.07.20,698,2,0,20,320,30,-290,B
ferking 2006.04.22,1119,3,2.5,65,97,37,-60,A
ferking 2006.04.22,1119,3,2.5,65,98,38,-60,B
Memnochblue 2006.04.22,873,3,0.5,68,144,34,-110,A
Memnochblue 2006.04.22,873,3,0.5,68,155,35,-120,B
pocheptsoff 2005.04.10,1046,2,2,22,125,32,-93,A
pocheptsoff 2005.04.10,1046,2,2,22,132,32,-100,B
talkymeat 2005.04.10,909,1,0,16,153,56,-97,A
talkymeat 2005.04.10,909,1,0,16,158,62,-96,B
lsilipo 2005.04.07,887,1,0,17,241,47,-194,A
lsilipo 2005.04.07,887,1,0,17,267,35,-232,B
Kyobutungi 2005.04.07,1067,1,1,15,141,33,-108,A
Kyobutungi 2005.04.07,1067,1,1,15,162,33,-129,B
counttell 2005.10.16,1069,1,0.5,5,79,20,-59,A
counttell 2005.10.16,1069,1,0.5,5,66,20,-46,B
TomJr 2005.10.16,823,1,0.5,6,491,33,-458,A
TomJr 2005.10.16,823,1,0.5,6,340,33,-307,B
mssronald 2003.02.13,944,1,0,16,283,25,-258,A
mssronald 2003.02.13,944,1,0,16,236,25,-211,B
eaglesloft 2003.02.13,1027,1,1,13,129,8,-121,A
eaglesloft 2003.02.13,1027,1,1,13,130,15,-115,B
Theodin 2005.10.20,998,1,0,24,198,42,-156,A
Theodin 2005.10.20,998,1,0,24,187,46,-141,B
rbb 2005.10.20,756,1,1,27,304,30,-274,A
rbb 2005.10.20,756,1,1,27,353,30,-323,B
jmlichtman 2006.06.07,903,1,0,4,246,0,-246,A
jmlichtman 2006.06.07,903,1,0,4,287,0,-287,B
fewral 2006.06.07,943,1,1,4,50,50,0,A
fewral 2006.06.07,943,1,1,4,68,25,-43,B
agathea 2006.05.31,988,1,1,15,169,27,-142,A
agathea 2006.05.31,988,1,1,15,184,27,-157,B
powendel 2006.05.31,1002,1,0,14,290,14,-276,A
powendel 2006.05.31,1002,1,0,14,246,14,-232,B
BishopDaMan 2005.10.08,985,1,0,15,233,20,-213,A
BishopDaMan 2005.10.08,985,1,0,15,219,33,-186,B
znode 2005.10.08,1000,1,1,13,180,38,-142,A
znode 2005.10.08,1000,1,1,13,195,38,-157,B
LaFleurDeLys 2003.01.24,862,1,0,9,476,22,-454,A
LaFleurDeLys 2003.01.24,862,1,0,9,499,11,-488,B
shipwrecked 2005.07.04,1057,2,2,48,98,38,-60,A
shipwrecked 2005.07.04,1057,2,2,48,111,37,-74,B
HEARTLESSWIZARD 2005.07.04,897,2,0,52,157,40,-117,A
HEARTLESSWIZARD 2005.07.04,897,2,0,52,178,38,-140,B
TLorD 2005.06.13,1002,2,1,33,185,36,-149,A
TLorD 2005.06.13,1002,2,1,33,194,30,-164,B
Shadax 2005.06.13,969,2,1,30,142,37,-105,A
Shadax 2005.06.13,969,2,1,30,138,43,-95,B
Trasimene 2002.08.11,1106,1,1,5,337,20,-317,A
Trasimene 2002.08.11,1106,1,1,5,302,20,-282,B
CashCow 2002.08.11,891,1,0,8,391,0,-391,A
CashCow 2002.08.11,891,1,0,8,378,0,-378,B
Paestka 2005.05.17,946,1,0,25,130,20,-110,A
Paestka 2005.05.17,946,1,0,25,125,20,-105,B
TEMH 2005.05.17,1041,1,1,21,67,52,-15,A
TEMH 2005.05.17,1041,1,1,21,69,43,-26,B
IvoSt 2006.06.09,905,1,1,9,18,89,71,A
IvoSt 2006.06.09,905,1,1,9,24,89,65,B
hungerartist 2006.06.09,1013,1,0,9,218,33,-185,A
hungerartist 2006.06.09,1013,1,0,9,201,33,-168,B
ModestNihilist 2005.09.28,948,1,1,13,159,23,-136,A
ModestNihilist 2005.09.28,948,1,1,13,181,23,-158,B
loserman 2005.09.28,901,1,0,13,246,38,-208,A
loserman 2005.09.28,901,1,0,13,263,31,-232,B
trovillion 2005.09.05,979,1,1,25,324,32,-292,A
trovillion 2005.09.05,979,1,1,25,302,32,-270,B
jcizotti 2005.09.05,944,1,0,24,358,25,-333,A
jcizotti 2005.09.05,944,1,0,24,370,25,-345,B
jonohelms 2005.09.26,1130,1,1,19,177,21,-156,A
jonohelms 2005.09.26,1130,1,1,19,168,16,-152,B
rtgreen 2005.09.26,861,1,0,19,192,21,-171,A
rtgreen 2005.09.26,861,1,0,19,171,21,-150,B
GolfBob 2006.05.23,892,1,1,35,112,43,-69,A
GolfBob 2006.05.23,892,1,1,35,125,37,-88,B
ferking 2006.05.23,1089,1,0,41,263,24,-239,A
ferking 2006.05.23,1089,1,0,41,273,24,-249,B
BothFeet 2005.08.26,946,1,0,31,286,32,-254,A
BothFeet 2005.08.26,946,1,0,31,287,29,-258,B
HEARTLESSWIZARD 2005.08.26,979,1,1,24,163,29,-134,A
HEARTLESSWIZARD 2005.08.26,979,1,1,24,175,21,-154,B
KirkB 2003.01.25,1174,1,1,11,216,45,-171,A
KirkB 2003.01.25,1174,1,1,11,224,36,-188,B
rochon 2005.09.18,1069,1,0,12,214,33,-181,A
rochon 2005.09.18,1069,1,0,12,199,42,-157,B
jcizotti 2005.09.18,900,1,1,10,281,10,-271,A
jcizotti 2005.09.18,900,1,1,10,259,10,-249,B
MartyL 2005.06.21,932,3,1,38,293,18,-275,A
MartyL 2005.06.21,932,3,1,38,291,16,-275,B
pohlie 2005.06.21,953,1,1,7,138,43,-95,A
pohlie 2005.06.21,953,1,1,7,144,57,-87,B
wreckncrew 2005.06.28,896,1,1,13,99,31,-68,A
wreckncrew 2005.06.28,896,1,1,13,92,31,-61,B
Rohein 2005.06.28,1063,1,0,13,195,8,-187,A
Rohein 2005.06.28,1063,1,0,13,201,8,-193,B
iansss 2006.04.27,895,1,0,13,200,38,-162,A
iansss 2006.04.27,895,1,0,13,218,46,-172,B
Breneric 2006.04.27,1028,1,1,12,223,8,-215,A
Breneric 2006.04.27,1028,1,1,12,229,17,-212,B
bigrig 2005.09.04,985,1,0,43,207,28,-179,A
bigrig 2005.09.04,985,1,0,43,205,30,-175,B
Silicate 2005.09.04,964,1,1,40,132,42,-90,A
Silicate 2005.09.04,964,1,1,40,131,45,-86,B
LaFleurDeLys 2003.01.22,885,1,0,20,231,20,-211,A
LaFleurDeLys 2003.01.22,885,1,0,20,245,15,-230,B
KaleidoscopeEyes 2002.12.30,1019,1,0,11,244,36,-208,A
KaleidoscopeEyes 2002.12.30,1019,1,0,11,221,36,-185,B
coloradorover 2002.12.30,885,1,1,10,120,20,-100,A
coloradorover 2002.12.30,885,1,1,10,95,30,-65,B
Silicate 2005.08.27,891,1,0,17,144,35,-109,A
Silicate 2005.08.27,891,1,0,17,144,35,-109,B
jrico 2005.08.27,1086,1,1,16,96,19,-77,A
jrico 2005.08.27,1086,1,1,16,105,19,-86,B
passports 2005.09.19,1107,1,1,13,272,8,-264,A
passports 2005.09.19,1107,1,1,13,255,15,-240,B
aadeeb 2005.09.19,844,1,0,11,258,18,-240,A
aadeeb 2005.09.19,844,1,0,11,240,18,-222,B
danielp 2006.05.27,1087,1,1,20,104,60,-44,A
danielp 2006.05.27,1087,1,1,20,113,50,-63,B
danielp 2006.05.27,1087,1,1,20,115,45,-70,C
sixer 2006.05.27,829,1,0,21,198,24,-174,A
sixer 2006.05.27,829,1,0,21,202,29,-173,B
sixer 2006.05.27,829,1,0,21,212,29,-183,C
HEARTLESSWIZARD 2005.09.14,942,1,1,17,72,53,-19,A
HEARTLESSWIZARD 2005.09.14,942,1,1,17,53,53,0,B
GolfBob 2005.09.14,1016,1,0,17,153,24,-129,A
GolfBob 2005.09.14,1016,1,0,17,152,18,-134,B
BlackCavy 2003.01.30,1011,1,1,5,95,20,-75,A
BlackCavy 2003.01.30,1011,1,1,5,99,20,-79,B
Inasmuch 2003.01.30,892,1,0,6,436,0,-436,A
Inasmuch 2003.01.30,892,1,0,6,441,0,-441,B
Dehweh 2003.01.13,1066,1,1,7,36,29,-7,A
Dehweh 2003.01.13,1066,1,1,7,38,43,5,B
LaFleurDeLys 2003.01.13,854,1,0,8,270,0,-270,A
LaFleurDeLys 2003.01.13,854,1,0,8,233,0,-233,B
hfarnsworth 2005.10.05,1047,1,0,10,424,10,-414,A
hfarnsworth 2005.10.05,1047,1,0,10,268,20,-248,B
PacManVideoGame 2005.10.05,941,1,1,9,206,44,-162,A
PacManVideoGame 2005.10.05,941,1,1,9,213,22,-191,B
Silicate 2005.09.02,932,1,1,17,202,59,-143,A
Silicate 2005.09.02,932,1,1,17,200,59,-141,B
SChlebowski 2005.09.02,1061,1,0,22,254,32,-222,A
SChlebowski 2005.09.02,1061,1,0,22,258,32,-226,B
TomJr 2005.10.15,873,1,0,21,216,24,-192,A
TomJr 2005.10.15,873,1,0,21,215,24,-191,B
Unknowner 2005.10.15,1088,1,1,20,169,35,-134,A
Unknowner 2005.10.15,1088,1,1,20,165,35,-130,B
newbeeforu 2005.07.01,1013,1,0,23,305,26,-279,A
newbeeforu 2005.07.01,1013,1,0,23,297,39,-258,B
MartyL 2005.07.01,915,1,1,17,233,41,-192,A
MartyL 2005.07.01,915,1,1,17,160,47,-113,B
pinkdragon 2006.04.27,906,1,0,17,512,6,-506,A
pinkdragon 2006.04.27,906,1,0,17,534,0,-534,B
Ccannibal 2006.04.27,1051,1,1,11,303,36,-267,A
Ccannibal 2006.04.27,1051,1,1,11,178,36,-142,B
MischiMaestro 2005.04.20,1045,6,4,76,160,37,-123,A
MischiMaestro 2005.04.20,1045,6,4,76,164,34,-130,B
fboccardo 2005.04.20,935,10,4,118,192,33,-159,A
fboccardo 2005.04.20,935,10,4,118,185,34,-151,B
Silicate 2005.08.25,916,1,0,7,441,0,-441,A
Silicate 2005.08.25,916,1,0,7,403,0,-403,B
yellowbay 2005.08.25,1013,1,1,5,105,60,-45,A
yellowbay 2005.08.25,1013,1,1,5,94,60,-34,B
coloradorover 2003.01.08,1023,1,1,9,257,0,-257,A
coloradorover 2003.01.08,1023,1,1,9,194,0,-194,B
LaFleurDeLys 2003.01.08,876,1,0,12,424,8,-416,A
LaFleurDeLys 2003.01.08,876,1,0,12,435,0,-435,B
finsfan 2006.05.15,883,1,0.5,5,139,40,-99,A
finsfan 2006.05.15,883,1,0.5,5,139,40,-99,B
Tristania 2006.05.15,1019,1,0.5,5,322,20,-302,A
Tristania 2006.05.15,1019,1,0.5,5,283,20,-263,B
ferking 2006.05.26,1074,2,2,40,210,40,-170,A
ferking 2006.05.26,1074,2,2,40,197,35,-162,B
franciscotlima 2005.08.13,993,1,0,16,142,31,-111,A
franciscotlima 2005.08.13,993,1,0,16,137,38,-99,B
HGBoone 2005.08.13,873,1,1,15,82,47,-35,A
HGBoone 2005.08.13,873,1,1,15,79,40,-39,B
BlindRoundTower 2002.12.26,1037,1,1,20,71,30,-41,A
BlindRoundTower 2002.12.26,1037,1,1,20,92,30,-62,B
juwony 2005.08.07,1168,1,0,4,534,0,-534,A
juwony 2005.08.07,1168,1,0,4,528,0,-528,B
HEARTLESSWIZARD 2005.07.24,949,2,2,20,285,5,-280,A
HEARTLESSWIZARD 2005.07.24,949,2,2,20,271,5,-266,B
cjott 2005.07.24,975,2,0,21,292,33,-259,A
cjott 2005.07.24,975,2,0,21,265,38,-227,B
bttfman 2002.11.07,995,2,1.5,22,154,18,-136,A
bttfman 2002.11.07,995,2,1.5,22,151,18,-133,B
AceEvl 2002.11.07,950,2,0.5,24,158,33,-125,A
AceEvl 2002.11.07,950,2,0.5,24,149,25,-124,B
Faeriedragon 2003.01.10,822,1,1,19,172,32,-140,A
Faeriedragon 2003.01.10,822,1,1,19,171,32,-139,B
RDearman 2003.01.10,1082,1,0,19,194,47,-147,A
RDearman 2003.01.10,1082,1,0,19,201,47,-154,B
jbpuffer 2005.07.30,848,5,0,94,293,18,-275,A
jbpuffer 2005.07.30,848,5,0,94,284,18,-266,B
noogit 2005.07.30,1007,3,3,58,175,26,-149,A
noogit 2005.07.30,1007,3,3,58,164,22,-142,B
HEARTLESSWIZARD 2005.07.30,951,2,2,28,139,43,-96,A
HEARTLESSWIZARD 2005.07.30,951,2,2,28,136,36,-100,B
Ziggles 2005.07.30,999,1,0,18,142,28,-114,A
Ziggles 2005.07.30,999,1,0,18,121,33,-88,B
BothFeet 2005.07.13,973,2,2,23,136,43,-93,A
BothFeet 2005.07.13,973,2,2,23,120,43,-77,B
SkarryLarry 2005.07.13,841,2,0,27,296,15,-281,A
SkarryLarry 2005.07.13,841,2,0,27,282,19,-263,B
tuile 2005.07.02,1079,1,1,4,179,25,-154,A
tuile 2005.07.02,1079,1,1,4,255,25,-230,B
MikeRN 2002.11.13,1071,1,1,4,210,25,-185,A
MikeRN 2002.11.13,1071,1,1,4,115,25,-90,B
AceEvl 2002.11.13,923,2,0,31,286,23,-263,A
AceEvl 2002.11.13,923,2,0,31,263,19,-244,B
mrudy 2003.01.07,894,1,1,11,132,36,-96,A
mrudy 2003.01.07,894,1,1,11,129,27,-102,B
jujupieces 2005.09.02,976,1,0,24,318,29,-289,A
jujupieces 2005.09.02,976,1,0,24,342,21,-321,B
dafke 2005.09.02,997,1,1,20,230,15,-215,A
dafke 2005.09.02,997,1,1,20,234,15,-219,B
yihan 2002.12.26,948,2,2,39,108,33,-75,A
yihan 2002.12.26,948,2,2,39,100,33,-67,B
NathanBlair 2005.07.12,1080,3,2,66,231,39,-192,A
NathanBlair 2005.07.12,1080,3,2,66,212,36,-176,B
HEARTLESSWIZARD 2005.07.12,861,2,1,41,170,29,-141,A
HEARTLESSWIZARD 2005.07.12,861,2,1,41,163,24,-139,B
Ziggles 2005.07.27,830,1,1,18,203,22,-181,A
Ziggles 2005.07.27,830,1,1,18,197,22,-175,B
BothFeet 2005.07.27,964,1,0,18,283,28,-255,A
BothFeet 2005.07.27,964,1,0,18,250,33,-217,B
ooohtodd 2005.07.26,951,1,0,13,440,31,-409,A
ooohtodd 2005.07.26,951,1,0,13,411,23,-388,B
tmth 2005.07.26,1043,1,1,11,196,54,-142,A
tmth 2005.07.26,1043,1,1,11,211,54,-157,B
bonillaice 2005.08.15,877,1,1,7,267,29,-238,A
bonillaice 2005.08.15,877,1,1,7,268,29,-239,B
bigrig 2005.08.15,1061,1,0,7,241,57,-184,A
bigrig 2005.08.15,1061,1,0,7,239,57,-182,B
SaltzLynnMa 2006.05.03,1107,1,0.5,49,138,45,-93,A
SaltzLynnMa 2006.05.03,1107,1,0.5,49,133,43,-90,B
marcuscole 2006.05.03,884,1,0.5,45,130,33,-97,A
marcuscole 2006.05.03,884,1,0.5,45,115,36,-79,B
NathanBlair 2005.08.06,929,1,0.5,23,134,30,-104,A
NathanBlair 2005.08.06,929,1,0.5,23,128,35,-93,B
TravisBarker 2005.08.06,1063,1,0.5,24,94,50,-44,A
TravisBarker 2005.08.06,1063,1,0.5,24,100,46,-54,B
bigrig 2005.08.06,866,1,1,28,250,21,-229,A
bigrig 2005.08.06,866,1,1,28,248,21,-227,B
mascota 2005.08.06,984,1,0,27,205,33,-172,A
mascota 2005.08.06,984,1,0,27,194,33,-161,B
pohlie 2006.05.10,986,1,0,13,180,23,-157,A
pohlie 2006.05.10,986,1,0,13,173,15,-158,B
punkat 2006.05.10,1013,1,1,11,84,36,-48,A
punkat 2006.05.10,1013,1,1,11,81,36,-45,B
iansss 2006.05.05,923,1,1,8,231,25,-206,A
iansss 2006.05.05,923,1,1,8,165,25,-140,B
marcuscole 2006.05.05,881,1,0,8,246,50,-196,A
marcuscole 2006.05.05,881,1,0,8,226,50,-176,B
HEARTLESSWIZARD 2005.08.17,975,1,1,22,159,23,-136,A
HEARTLESSWIZARD 2005.08.17,975,1,1,22,172,23,-149,B
pezzissimo 2005.08.17,879,1,0,23,173,44,-129,A
pezzissimo 2005.08.17,879,1,0,23,171,44,-127,B
loserman 2006.04.29,988,1,1,4,37,50,13,A
loserman 2006.04.29,988,1,1,4,83,50,-33,B
Hsquare 2006.04.29,1001,1,0,5,279,0,-279,A
Hsquare 2006.04.29,1001,1,0,5,346,0,-346,B
iveyjr 2005.04.06,854,1,0,12,223,17,-206,A
iveyjr 2005.04.06,854,1,0,12,234,8,-226,B
Homki 2005.04.06,1065,1,1,10,85,10,-75,A
Homki 2005.04.06,1065,1,1,10,93,20,-73,B
tkdman 2005.07.29,1063,1,1,4,178,0,-178,A
tkdman 2005.07.29,1063,1,1,4,194,0,-194,B
jbpuffer 2005.07.29,910,1,0,6,446,0,-446,A
jbpuffer 2005.07.29,910,1,0,6,493,0,-493,B
iascrazyorioles 2006.05.07,976,1,1,5,180,20,-160,A
iascrazyorioles 2006.05.07,976,1,1,5,186,20,-166,B
DEDEE 2006.05.07,963,1,0,7,341,14,-327,A
DEDEE 2006.05.07,963,1,0,7,372,14,-358,B
ooohtodd 2005.07.12,1004,1,0,20,300,40,-260,A
ooohtodd 2005.07.12,1004,1,0,20,274,30,-244,B
LOZO 2005.08.14,987,1,0,48,122,38,-84,A
LOZO 2005.08.14,987,1,0,48,128,40,-88,B
jessmoll 2005.08.14,1009,1,1,49,127,47,-80,A
jessmoll 2005.08.14,1009,1,1,49,124,43,-81,B
pacetaker 2002.12.26,1125,1,1,9,124,44,-80,A
pacetaker 2002.12.26,1125,1,1,9,109,56,-53,B
Tibmag 2005.07.11,1029,1,1,19,70,37,-33,A
Tibmag 2005.07.11,1029,1,1,19,56,37,-19,B
MTSimkus 2005.07.11,969,1,0,20,112,25,-87,A
MTSimkus 2005.07.11,969,1,0,20,93,35,-58,B
Halfman 2006.04.24,1082,1,1,12,78,25,-53,A
Halfman 2006.04.24,1082,1,1,12,82,25,-57,B
wolfla 2006.04.24,874,1,0,12,161,17,-144,A
wolfla 2006.04.24,874,1,0,12,166,17,-149,B
fboccardo 2005.04.19,928,1,1,24,111,42,-69,A
fboccardo 2005.04.19,928,1,1,24,97,38,-59,B
giannhsk 2005.04.19,805,1,0,24,186,42,-144,A
giannhsk 2005.04.19,805,1,0,24,175,33,-142,B
garethcash 2005.04.20,1033,3,1,36,167,33,-134,A
garethcash 2005.04.20,1033,3,1,36,199,33,-166,B
HEARTLESSWIZARD 2005.07.22,879,1,1,14,101,21,-80,A
HEARTLESSWIZARD 2005.07.22,879,1,1,14,171,21,-150,B
iveyjr 2005.07.22,901,1,0,14,204,36,-168,A
iveyjr 2005.07.22,901,1,0,14,216,29,-187,B
artir 2005.06.21,1068,1,0,14,64,50,-14,A
artir 2005.06.21,1068,1,0,14,55,50,-5,B
TLorD 2005.06.08,961,1,1,24,94,54,-40,A
TLorD 2005.06.08,961,1,1,24,60,46,-14,B
HEARTLESSWIZARD 2005.06.08,909,1,0,28,121,25,-96,A
HEARTLESSWIZARD 2005.06.08,909,1,0,28,122,25,-97,B
doomie 2006.04.19,873,1,1,17,110,53,-57,A
doomie 2006.04.19,873,1,1,17,111,47,-64,B
ferking 2006.04.19,1078,1,0,16,135,31,-104,A
ferking 2006.04.19,1078,1,0,16,127,31,-96,B
iveyjr 2005.04.07,864,1,0,13,315,15,-300,A
iveyjr 2005.04.07,864,1,0,13,294,15,-279,B
DKG 2005.04.07,1077,1,1,12,202,42,-160,A
DKG 2005.04.07,1077,1,1,12,179,42,-137,B
BothFeet 2005.07.11,972,1,1,9,150,22,-128,A
BothFeet 2005.07.11,972,1,1,9,133,33,-100,B
bonillaice 2005.07.11,949,1,0,9,250,22,-228,A
bonillaice 2005.07.11,949,1,0,9,235,22,-213,B
Freakyflow 2005.07.30,1161,1,1,7,72,14,-58,A
Freakyflow 2005.07.30,1161,1,1,7,80,14,-66,B
zebrafish 2006.04.29,876,1,1,18,120,17,-103,A
zebrafish 2006.04.29,876,1,1,18,110,28,-82,B
aBlade 2006.04.29,1079,1,0,19,205,37,-168,A
aBlade 2006.04.29,1079,1,0,19,205,37,-168,B
pezzissimo 2005.06.13,910,1,0,19,225,21,-204,A
pezzissimo 2005.06.13,910,1,0,19,249,16,-233,B
johnoleary 2005.06.13,1044,1,1,18,146,50,-96,A
johnoleary 2005.06.13,1044,1,1,18,167,44,-123,B
iansss 2006.05.06,926,1,1,16,151,31,-120,A
iansss 2006.05.06,926,1,1,16,166,25,-141,B
morts 2006.05.06,1070,1,0,19,339,47,-292,A
morts 2006.05.06,1070,1,0,19,350,32,-318,B
Reeco 2005.07.23,1150,1,1,19,320,26,-294,A
Reeco 2005.07.23,1150,1,1,19,343,16,-327,B
bonillaice 2005.07.23,847,1,0,19,363,10,-353,A
bonillaice 2005.07.23,847,1,0,19,363,16,-347,B
doubleo 2005.06.29,962,1,0.5,28,193,25,-168,A
doubleo 2005.06.29,962,1,0.5,28,179,25,-154,B
BothFeet 2005.06.29,958,1,0.5,24,158,33,-125,A
BothFeet 2005.06.29,958,1,0.5,24,136,21,-115,B
bttfman 2002.11.13,1065,1,1,25,217,16,-201,A
bttfman 2002.11.13,1065,1,1,25,215,16,-199,B
undersoft 2005.06.23,928,1,1,11,255,36,-219,A
undersoft 2005.06.23,928,1,1,11,269,27,-242,B
MartyL 2005.06.23,956,1,0,14,456,7,-449,A
MartyL 2005.06.23,956,1,0,14,378,7,-371,B
ooohtodd 2005.07.15,968,1,0,16,224,19,-205,A
ooohtodd 2005.07.15,968,1,0,16,223,19,-204,B
mascota 2005.07.15,965,1,1,14,141,50,-91,A
mascota 2005.07.15,965,1,1,14,142,50,-92,B
ooohtodd 2005.07.18,946,1,1,14,201,29,-172,A
ooohtodd 2005.07.18,946,1,1,14,190,29,-161,B
BothFeet 2005.07.18,967,1,0,15,322,20,-302,A
BothFeet 2005.07.18,967,1,0,15,256,20,-236,B
caleas 2002.09.20,1021,1,1,19,106,37,-69,A
caleas 2002.09.20,1021,1,1,19,114,42,-72,B
younder 2002.09.20,920,1,0,18,114,33,-81,A
younder 2002.09.20,920,1,0,18,124,28,-96,B
wolfla 2006.04.25,846,2,1,28,279,21,-258,A
wolfla 2006.04.25,846,2,1,28,285,14,-271,B
nicolaus 2006.04.25,984,2,1,27,261,33,-228,A
nicolaus 2006.04.25,984,2,1,27,252,33,-219,B
hwm 2005.04.28,933,1,0,8,384,12,-372,A
hwm 2005.04.28,933,1,0,8,329,12,-317,B
Intredcode 2005.04.28,948,1,1,6,121,33,-88,A
Intredcode 2005.04.28,948,1,1,6,68,33,-35,B
iveyjr 2005.03.23,886,8,2,156,257,26,-231,A
iveyjr 2005.03.23,886,8,2,156,248,25,-223,B
FJB 2005.03.23,1011,13,10.5,258,162,31,-131,A
FJB 2005.03.23,1011,13,10.5,258,164,29,-135,B
FJB 2005.03.15,860,1,0,12,223,17,-206,A
FJB 2005.03.15,860,1,0,12,220,8,-212,B
dockson 2005.03.15,951,1,1,13,241,31,-210,A
dockson 2005.03.15,951,1,1,13,240,23,-217,B
Joinedup 2005.02.22,890,1,0,20,208,45,-163,A
Joinedup 2005.02.22,890,1,0,20,212,35,-177,B
ultradude 2005.02.22,885,1,1,20,249,20,-229,A
ultradude 2005.02.22,885,1,1,20,188,25,-163,B
HEARTLESSWIZARD 2005.07.02,931,1,0,18,231,11,-220,A
HEARTLESSWIZARD 2005.07.02,931,1,0,18,227,17,-210,B
ClaesF 2006.04.08,1036,1,0,19,293,5,-288,A
ClaesF 2006.04.08,1036,1,0,19,295,5,-290,B
Yesu 2006.04.08,901,1,1,17,202,29,-173,A
Yesu 2006.04.08,901,1,1,17,168,29,-139,B
nicknator 2006.05.04,1050,1,1,9,155,22,-133,A
nicknator 2006.05.04,1050,1,1,9,196,22,-174,B
Nemobxl 2006.05.04,901,1,0,9,266,22,-244,A
Nemobxl 2006.05.04,901,1,0,9,279,22,-257,B
MartyL 2005.06.26,897,1,1,9,128,44,-84,A
MartyL 2005.06.26,897,1,1,9,137,44,-93,B
Scottrick 2005.06.26,1004,1,0,10,320,30,-290,A
Scottrick 2005.06.26,1004,1,0,10,340,30,-310,B
Caledonian 2006.05.02,877,1,0,8,309,38,-271,A
Caledonian 2006.05.02,877,1,0,8,331,38,-293,B
tuile 2006.05.02,1080,1,1,2,142,150,8,A
tuile 2006.05.02,1080,1,1,2,0,100,100,B
pohlie 2005.06.30,1021,1,1,32,157,34,-123,A
pohlie 2005.06.30,1021,1,1,32,151,34,-117,B
shipwrecked 2005.06.30,954,1,0,29,137,45,-92,A
shipwrecked 2005.06.30,954,1,0,29,140,45,-95,B
matingrituals 2006.05.03,964,1,0,16,204,31,-173,A
matingrituals 2006.05.03,964,1,0,16,169,25,-144,B
Cybersun 2006.05.03,1031,1,1,15,88,40,-48,A
Cybersun 2006.05.03,1031,1,1,15,64,40,-24,B
amajouity 2002.08.02,930,1,0,30,273,33,-240,A
amajouity 2002.08.02,930,1,0,30,282,33,-249,B
Trasimene 2002.08.02,1043,1,1,28,243,29,-214,A
Trasimene 2002.08.02,1043,1,1,28,260,29,-231,B
schachmatze 2006.04.21,920,1,1,14,178,36,-142,A
schachmatze 2006.04.21,920,1,1,14,174,36,-138,B
Nemobxl 2006.04.21,930,1,0,21,367,19,-348,A
Nemobxl 2006.04.21,930,1,0,21,376,19,-357,B
lsilipo 2005.04.22,818,1,1,24,152,38,-114,A
lsilipo 2005.04.22,818,1,1,24,139,42,-97,B
pawnpeddler 2005.04.22,1068,1,0,22,191,32,-159,A
pawnpeddler 2005.04.22,1068,1,0,22,161,41,-120,B
pezzissimo 2005.06.14,862,1,0.5,81,115,32,-83,A
pezzissimo 2005.06.14,862,1,0.5,81,95,32,-63,B
Kyobutungi 2005.06.14,1130,1,0.5,88,150,26,-124,A
Kyobutungi 2005.06.14,1130,1,0.5,88,170,26,-144,B
knightscastle 2002.10.20,1084,1,0,27,314,18,-296,A
knightscastle 2002.10.20,1084,1,0,27,283,18,-265,B
chrisyacoub 2002.10.20,914,1,1,26,215,46,-169,A
chrisyacoub 2002.10.20,914,1,1,26,218,42,-176,B
youngrower 2005.05.06,830,2,2,12,59,50,-9,A
youngrower 2005.05.06,830,2,2,12,44,58,14,B
Paestka 2005.05.06,1000,2,0,13,256,15,-241,A
Paestka 2005.05.06,1000,2,0,13,234,15,-219,B
aafire 2006.04.19,943,1,1,21,55,43,-12,A
aafire 2006.04.19,943,1,1,21,50,48,-2,B
Cybersun 2006.04.19,1043,1,0,24,187,17,-170,A
Cybersun 2006.04.19,1043,1,0,24,193,17,-176,B
vav 2002.11.09,953,1,0,25,294,28,-266,A
vav 2002.11.09,953,1,0,25,290,32,-258,B
cutenuke 2002.11.09,927,1,1,22,226,14,-212,A
cutenuke 2002.11.09,927,1,1,22,242,18,-224,B
Paestka 2005.05.16,982,1,0,21,240,19,-221,A
Paestka 2005.05.16,982,1,0,21,217,24,-193,B
CooperW 2005.05.16,1010,1,1,19,182,32,-150,A
CooperW 2005.05.16,1010,1,1,19,159,32,-127,B
hwm 2005.04.30,912,1,0,17,284,29,-255,A
hwm 2005.04.30,912,1,0,17,276,41,-235,B
LEOUTSAKOS 2005.04.30,1085,1,1,15,270,27,-243,A
LEOUTSAKOS 2005.04.30,1085,1,1,15,238,33,-205,B
Kyobutungi 2005.04.25,1101,1,0,27,178,41,-137,A
Kyobutungi 2005.04.25,1101,1,0,27,192,41,-151,B
lsilipo 2005.04.25,872,1,1,21,96,43,-53,A
lsilipo 2005.04.25,872,1,1,21,92,38,-54,B
entanglement 2005.06.21,994,1,1,13,295,31,-264,A
entanglement 2005.06.21,994,1,1,13,266,31,-235,B
HEARTLESSWIZARD 2005.06.19,875,1,1,59,301,27,-274,A
HEARTLESSWIZARD 2005.06.19,875,1,1,59,302,32,-270,B
Schuerer 2005.06.19,1067,1,0,52,200,27,-173,A
Schuerer 2005.06.19,1067,1,0,52,211,31,-180,B
chrisyacoub 2002.08.09,952,1,0,17,300,35,-265,A
chrisyacoub 2002.08.09,952,1,0,17,286,47,-239,B
MikeRN 2002.08.09,1023,1,1,14,188,29,-159,A
MikeRN 2002.08.09,1023,1,1,14,183,29,-154,B
OboeDeity 2005.05.03,915,1,1,6,196,0,-196,A
OboeDeity 2005.05.03,915,1,1,6,166,0,-166,B
fboccardo 2005.05.03,996,1,0,7,434,0,-434,A
fboccardo 2005.05.03,996,1,0,7,440,0,-440,B
injunt 2005.04.10,926,1,0,5,245,40,-205,A
injunt 2005.04.10,926,1,0,5,260,60,-200,B
dldnjstjq 2005.05.02,939,1,0,12,169,25,-144,A
dldnjstjq 2005.05.02,939,1,0,12,157,33,-124,B
iveyjr 2005.05.02,878,1,1,11,120,18,-102,A
iveyjr 2005.05.02,878,1,1,11,101,27,-74,B
JWest 2002.07.30,916,1,1,8,204,62,-142,A
JWest 2002.07.30,916,1,1,8,194,62,-132,B
Trasimene 2002.07.30,1052,1,0,7,337,14,-323,A
Trasimene 2002.07.30,1052,1,0,7,345,14,-331,B
BlueKeyboard 2005.05.06,1048,1,1,30,240,23,-217,A
BlueKeyboard 2005.05.06,1048,1,1,30,248,23,-225,B
hwm 2005.05.06,912,1,0,34,351,21,-330,A
hwm 2005.05.06,912,1,0,34,383,26,-357,B
muselaers 2005.05.12,1017,1,1,12,24,58,34,A
muselaers 2005.05.12,1017,1,1,12,13,67,54,B
Paestka 2005.05.12,918,1,0,18,101,28,-73,A
Paestka 2005.05.12,918,1,0,18,125,22,-103,B
OboeDeity 2005.04.23,929,2,1,38,127,32,-95,A
OboeDeity 2005.04.23,929,2,1,38,109,37,-72,B
iveyjr 2005.04.23,860,2,1,40,142,35,-107,A
iveyjr 2005.04.23,860,2,1,40,131,30,-101,B
owenbagge 2002.07.24,899,1,1,7,143,14,-129,A
owenbagge 2002.07.24,899,1,1,7,140,29,-111,B
pacetaker 2002.07.24,1091,1,0,7,260,29,-231,A
pacetaker 2002.07.24,1091,1,0,7,256,43,-213,B
exaanil 2006.04.23,1068,1,1,16,214,38,-176,A
exaanil 2006.04.23,1068,1,1,16,219,38,-181,B
zebrafish 2006.04.23,917,1,0,16,285,25,-260,A
zebrafish 2006.04.23,917,1,0,16,289,25,-264,B
mcco 2005.04.20,1018,1,1,6,172,33,-139,A
mcco 2005.04.20,1018,1,1,6,179,33,-146,B
JuliusG 2006.03.30,892,1,1,25,191,36,-155,A
JuliusG 2006.03.30,892,1,1,25,190,24,-166,B
ferking 2006.03.30,1021,1,0,26,254,19,-235,A
ferking 2006.03.30,1021,1,0,26,257,19,-238,B
dustbuni 2006.04.25,966,1,0,8,416,0,-416,A
dustbuni 2006.04.25,966,1,0,8,404,0,-404,B
Cybersun 2006.04.25,1010,1,1,7,236,14,-222,A
Cybersun 2006.04.25,1010,1,1,7,208,29,-179,B
ferking 2006.04.24,1131,1,1,11,132,0,-132,A
ferking 2006.04.24,1131,1,1,11,125,9,-116,B
Memnochblue 2006.04.24,860,1,0,11,192,18,-174,A
Memnochblue 2006.04.24,860,1,0,11,208,18,-190,B
lager 2002.04.16,858,1,0,6,97,67,-30,A
lager 2002.04.16,858,1,0,6,130,50,-80,B
ReiJay 2002.04.16,1064,1,1,6,170,17,-153,A
ReiJay 2002.04.16,1064,1,1,6,154,17,-137,B
iveyjr 2005.03.26,880,1,0,19,276,21,-255,A
iveyjr 2005.03.26,880,1,0,19,270,16,-254,B
debateking 2005.03.26,1031,1,1,16,320,25,-295,A
debateking 2005.03.26,1031,1,1,16,387,19,-368,B
FJB 2005.03.17,859,5,1.5,70,168,27,-141,A
FJB 2005.03.17,859,5,1.5,70,168,20,-148,B
GolfBob 2005.03.17,1108,1,0,20,173,10,-163,A
GolfBob 2005.03.17,1108,1,0,20,178,10,-168,B
Cybersun 2006.04.24,1021,1,0,17,305,18,-287,A
Cybersun 2006.04.24,1021,1,0,17,275,18,-257,B
Bossdog 2006.04.24,907,1,1,19,404,10,-394,A
Bossdog 2006.04.24,907,1,1,19,419,16,-403,B
aikloong 2002.07.03,747,1,0,6,282,17,-265,A
aikloong 2002.07.03,747,1,0,6,258,17,-241,B
skuller 2002.07.03,1065,1,1,5,21,80,59,A
skuller 2002.07.03,1065,1,1,5,30,60,30,B
Memnochblue 2006.04.10,1088,1,0,11,404,9,-395,A
Memnochblue 2006.04.10,1088,1,0,11,408,18,-390,B
Nemobxl 2006.04.10,820,1,1,8,207,38,-169,A
Nemobxl 2006.04.10,820,1,1,8,209,25,-184,B
fboccardo 2005.04.18,976,5,1,124,146,32,-114,A
fboccardo 2005.04.18,976,5,1,124,135,33,-102,B
garethcash 2005.04.18,1003,4,3,116,144,34,-110,A
garethcash 2005.04.18,1003,4,3,116,144,31,-113,B
skuller 2002.07.07,1080,1,1,5,426,0,-426,A
skuller 2002.07.07,1080,1,1,5,467,0,-467,B
aikloong 2002.07.07,719,1,0,8,447,25,-422,A
aikloong 2002.07.07,719,1,0,8,465,38,-427,B
FJB 2005.04.01,1047,1,0,5,430,20,-410,A
FJB 2005.04.01,1047,1,0,5,453,0,-453,B
Mailo 2005.04.01,901,1,1,4,61,75,14,A
Mailo 2005.04.01,901,1,1,4,40,75,35,B
Bossdog 2006.04.10,880,1,1,20,214,30,-184,A
Bossdog 2006.04.10,880,1,1,20,215,30,-185,B
Etka 2006.04.10,1048,1,0,16,274,25,-249,A
Etka 2006.04.10,1048,1,0,16,263,31,-232,B
garethcash 2005.04.22,994,2,2,49,138,27,-111,A
garethcash 2005.04.22,994,2,2,49,131,29,-102,B
fboccardo 2005.04.22,985,2,0,54,216,31,-185,A
fboccardo 2005.04.22,985,2,0,54,220,33,-187,B
MischiMaestro 2005.04.18,999,1,1,8,253,12,-241,A
MischiMaestro 2005.04.18,999,1,1,8,242,12,-230,B
utsutso 2002.05.12,1098,1,0,16,258,12,-246,A
utsutso 2002.05.12,1098,1,0,16,233,19,-214,B
whatbomb 2002.05.12,887,1,1,14,92,50,-42,A
whatbomb 2002.05.12,887,1,1,14,58,50,-8,B
SpacedCadet 2002.01.25,1028,3,2,31,226,23,-203,A
SpacedCadet 2002.01.25,1028,3,2,31,222,23,-199,B
Gaby 2002.01.25,930,3,1,31,275,32,-243,A
Gaby 2002.01.25,930,3,1,31,276,32,-244,B
debateking 2005.03.27,1101,1,1,18,223,50,-173,A
debateking 2005.03.27,1101,1,1,18,161,50,-111,B
iveyjr 2005.03.27,875,2,0,34,240,29,-211,A
iveyjr 2005.03.27,875,2,0,34,241,32,-209,B
debateking 2005.03.24,1039,1,1,12,179,17,-162,A
debateking 2005.03.24,1039,1,1,12,169,17,-152,B
iveyjr 2005.03.24,876,2,1,28,235,25,-210,A
iveyjr 2005.03.24,876,2,1,28,209,36,-173,B
Kyobutungi 2005.03.24,1095,1,0,15,193,13,-180,A
Kyobutungi 2005.03.24,1095,1,0,15,164,20,-144,B
varchata 2002.06.07,971,1,0,23,336,26,-310,A
varchata 2002.06.07,971,1,0,23,277,26,-251,B
amajouity 2002.06.07,907,1,1,14,190,21,-169,A
amajouity 2002.06.07,907,1,1,14,192,29,-163,B
lsilipo 2005.04.10,854,1,0,13,264,23,-241,A
lsilipo 2005.04.10,854,1,0,13,273,23,-250,B
diamonds 2005.04.10,1131,1,1,10,79,60,-19,A
diamonds 2005.04.10,1131,1,1,10,54,60,6,B
Mxkuma 2005.03.23,938,5,0.5,130,227,24,-203,A
Mxkuma 2005.03.23,938,5,0.5,130,217,24,-193,B
danlei 2006.04.09,891,1,0.5,44,173,25,-148,A
danlei 2006.04.09,891,1,0.5,44,164,32,-132,B
Bossdog 2006.04.09,900,1,0.5,44,172,23,-149,A
Bossdog 2006.04.09,900,1,0.5,44,172,20,-152,B
FJB 2005.03.22,951,9,8,94,182,31,-151,A
FJB 2005.03.22,951,9,8,94,168,31,-137,B
Hamhawk 2005.03.22,1006,2,0,19,391,5,-386,A
Hamhawk 2005.03.22,1006,2,0,19,396,11,-385,B
cpinya 2006.03.29,1063,3,2,29,181,31,-150,A
cpinya 2006.03.29,1063,3,2,29,170,41,-129,B
schnootzer 2006.03.29,837,5,3,42,202,31,-171,A
schnootzer 2006.03.29,837,5,3,42,169,36,-133,B
iveyjr 2005.04.03,857,1,0,15,305,27,-278,A
iveyjr 2005.04.03,857,1,0,15,294,27,-267,B
FJB 2005.04.03,1083,1,1,18,325,39,-286,A
FJB 2005.04.03,1083,1,1,18,321,39,-282,B
lager 2002.04.12,882,1,0,17,384,29,-355,A
lager 2002.04.12,882,1,0,17,391,24,-367,B
Endymion 2002.04.12,1046,1,1,15,277,27,-250,A
Endymion 2002.04.12,1046,1,1,15,270,27,-243,B
Devonaster 2000.04.05,1043,1,0,5,347,20,-327,A
Devonaster 2000.04.05,1043,1,0,5,341,20,-321,B
chessmon 2000.04.05,951,1,1,4,268,25,-243,A
chessmon 2000.04.05,951,1,1,4,259,50,-209,B
HEARTLESSWIZARD 2004.10.09,779,1,1,22,173,27,-146,A
HEARTLESSWIZARD 2004.10.09,779,1,1,22,200,32,-168,B
drevilrocks 2004.10.09,1119,1,0,31,407,23,-384,A
drevilrocks 2004.10.09,1119,1,0,31,429,19,-410,B
mcgrail 2006.03.02,818,5,0,50,151,22,-129,A
mcgrail 2006.03.02,818,5,0,50,147,24,-123,B
toha 2006.03.02,1144,1,1,4,19,75,56,A
toha 2006.03.02,1144,1,1,4,8,75,67,B
Halfman 2006.03.01,986,3,3,35,132,43,-89,A
Halfman 2006.03.01,986,3,3,35,141,34,-107,B
mcgrail 2006.03.01,935,3,0.5,60,174,23,-151,A
mcgrail 2006.03.01,935,3,0.5,60,165,23,-142,B
americanista 2006.01.01,1002,1,1,14,190,21,-169,A
americanista 2006.01.01,1002,1,1,14,192,29,-163,B
Halfman 2006.01.01,882,1,0,14,210,43,-167,A
Halfman 2006.01.01,882,1,0,14,220,43,-177,B
medilein 2005.03.28,1108,1,1,16,186,50,-136,A
medilein 2005.03.28,1108,1,1,16,178,44,-134,B
iveyjr 2005.03.28,866,1,0,17,182,35,-147,A
iveyjr 2005.03.28,866,1,0,17,184,35,-149,B
iveyjr 2005.03.22,920,8,1,106,268,14,-254,A
iveyjr 2005.03.22,920,8,1,106,273,15,-258,B
FJB 2005.03.27,1024,1,1,14,354,29,-325,A
FJB 2005.03.27,1024,1,1,14,368,29,-339,B
JuliusG 2006.04.01,927,1,1,25,163,36,-127,A
JuliusG 2006.04.01,927,1,1,25,139,40,-99,B
ninox 2006.04.01,1010,1,0,21,104,38,-66,A
ninox 2006.04.01,1010,1,0,21,109,33,-76,B
LeCrabe 2002.06.07,1056,1,1,29,176,28,-148,A
LeCrabe 2002.06.07,1056,1,1,29,183,28,-155,B
Guuyver 2002.06.07,815,1,0,28,182,43,-139,A
Guuyver 2002.06.07,815,1,0,28,189,43,-146,B
HEARTLESSWIZARD 2005.03.25,947,1,0,17,190,24,-166,A
HEARTLESSWIZARD 2005.03.25,947,1,0,17,179,18,-161,B
GolfBob 2005.03.25,1032,1,1,16,169,6,-163,A
GolfBob 2005.03.25,1032,1,1,16,143,6,-137,B
loserman 2006.03.29,887,1,0,10,204,30,-174,A
loserman 2006.03.29,887,1,0,10,154,20,-134,B
nicolaus 2006.03.29,1024,2,0,13,233,8,-225,A
nicolaus 2006.03.29,1024,2,0,13,220,8,-212,B
Nemobxl 2006.03.30,954,1,0,19,177,32,-145,A
Nemobxl 2006.03.30,954,1,0,19,164,32,-132,B
Nemobxl 2006.03.30,954,1,0,19,184,32,-152,C
hydek 2006.03.30,1033,1,1,20,201,40,-161,A
hydek 2006.03.30,1033,1,1,20,202,50,-152,B
hydek 2006.03.30,1033,1,1,20,210,45,-165,C
amajouity 2002.06.27,922,1,0,15,218,33,-185,A
amajouity 2002.06.27,922,1,0,15,221,33,-188,B
owenbagge 2002.06.27,943,1,1,10,61,60,-1,A
owenbagge 2002.06.27,943,1,1,10,64,50,-14,B
FJB 2005.03.21,870,7,5.5,88,176,26,-150,A
FJB 2005.03.21,870,7,5.5,88,169,25,-144,B
GolfBob 2005.03.21,1067,1,0,7,347,43,-304,A
GolfBob 2005.03.21,1067,1,0,7,365,29,-336,B
iveyjr 2005.03.21,988,6,1.5,87,202,30,-172,A
iveyjr 2005.03.21,988,6,1.5,87,189,30,-159,B
Guuyver 2002.05.17,817,1,0,41,120,24,-96,A
Guuyver 2002.05.17,817,1,0,41,120,22,-98,B
owlman 2002.05.17,1039,1,1,42,112,14,-98,A
owlman 2002.05.17,1039,1,1,42,108,29,-79,B
amajouity 2002.04.02,869,2,1,42,292,19,-273,A
amajouity 2002.04.02,869,2,1,42,263,21,-242,B
kingmicah 2002.04.02,1112,2,1,41,273,27,-246,A
kingmicah 2002.04.02,1112,2,1,41,268,27,-241,B
Kinkajou 2005.03.16,872,1,1,5,81,20,-61,A
Kinkajou 2005.03.16,872,1,1,5,99,20,-79,B
beeyes 2005.03.16,1034,1,0,7,339,0,-339,A
beeyes 2005.03.16,1034,1,0,7,371,0,-371,B
basitian 2005.03.14,1171,2,0,44,214,27,-187,A
basitian 2005.03.14,1171,2,0,44,216,23,-193,B
FJB 2005.03.14,840,4,2,57,222,28,-194,A
FJB 2005.03.14,840,4,2,57,198,26,-172,B
ferking 2006.03.16,1034,1,0,20,281,10,-271,A
ferking 2006.03.16,1034,1,0,20,307,10,-297,B
SUNNYMAN 2006.03.16,950,1,1,17,204,24,-180,A
SUNNYMAN 2006.03.16,950,1,1,17,181,24,-157,B
nosek 2005.03.17,1106,2,1.5,25,88,56,-32,A
nosek 2005.03.17,1106,2,1.5,25,86,48,-38,B
JuliusG 2006.03.26,914,1,0,26,168,27,-141,A
JuliusG 2006.03.26,914,1,0,26,148,23,-125,B
ninox 2006.03.26,985,1,1,25,121,28,-93,A
ninox 2006.03.26,985,1,1,25,106,36,-70,B
Kyobutungi 2005.03.22,1043,1,1,14,196,29,-167,A
Kyobutungi 2005.03.22,1043,1,1,14,188,21,-167,B
HOOT 2002.03.03,860,1,1,12,104,33,-71,A
HOOT 2002.03.03,860,1,1,12,82,50,-32,B
Cahta 2002.03.03,1116,1,0,16,153,12,-141,A
Cahta 2002.03.03,1116,1,0,16,157,25,-132,B
FJB 2005.03.16,836,1,1,30,325,27,-298,A
FJB 2005.03.16,836,1,1,30,318,23,-295,B
basitian 2005.03.16,1005,1,0,27,359,30,-329,A
basitian 2005.03.16,1005,1,0,27,278,33,-245,B
RoKStAR 2006.03.29,995,1,1,16,327,25,-302,A
RoKStAR 2006.03.29,995,1,1,16,325,31,-294,B
petergriffin 2006.03.22,1192,1,1,26,137,35,-102,A
petergriffin 2006.03.22,1192,1,1,26,137,35,-102,B
Tarish 2006.03.22,719,1,0,24,153,38,-115,A
Tarish 2006.03.22,719,1,0,24,163,25,-138,B
alexcardoso 2004.07.22,1086,2,2,28,190,21,-169,A
alexcardoso 2004.07.22,1086,2,2,28,183,25,-158,B
twno 2004.07.22,897,2,0,33,278,15,-263,A
twno 2004.07.22,897,2,0,33,265,15,-250,B
supertintin 2004.07.27,1229,1,0.5,69,108,51,-57,A
supertintin 2004.07.27,1229,1,0.5,69,123,52,-71,B
supertintin 2004.07.27,1229,1,0.5,69,117,49,-68,C
southwestco 2004.07.27,759,1,0.5,52,79,23,-56,A
southwestco 2004.07.27,759,1,0.5,52,86,25,-61,B
southwestco 2004.07.27,759,1,0.5,52,98,25,-73,C
icman 2005.03.04,1086,1,1,11,62,73,11,A
icman 2005.03.04,1086,1,1,11,64,73,9,B
youngrower 2005.03.04,910,1,0,11,152,18,-134,A
youngrower 2005.03.04,910,1,0,11,154,9,-145,B
olzie 2005.03.17,1031,1,1,12,150,25,-125,A
olzie 2005.03.17,1031,1,1,12,141,17,-124,B
AaronH 2002.01.06,835,1,0,7,208,14,-194,A
AaronH 2002.01.06,835,1,0,7,207,14,-193,B
peruzzi 2002.01.06,1078,1,1,6,52,17,-35,A
peruzzi 2002.01.06,1078,1,1,6,50,33,-17,B
FJB 2005.03.11,905,2,0,30,268,10,-258,A
FJB 2005.03.11,905,2,0,30,263,13,-250,B
dockson 2005.03.11,936,1,1,21,118,24,-94,A
dockson 2005.03.11,936,1,1,21,111,24,-87,B
honte 2005.03.14,979,1,1,6,286,0,-286,A
honte 2005.03.14,979,1,1,6,298,0,-298,B
Krandall 2006.03.20,918,1,1,27,156,26,-130,A
Krandall 2006.03.20,918,1,1,27,144,26,-118,B
Halfman 2006.03.20,1069,1,0,25,96,36,-60,A
Halfman 2006.03.20,1069,1,0,25,100,40,-60,B
schnootzer 2006.03.28,1108,2,0,34,192,44,-148,A
schnootzer 2006.03.28,1108,2,0,34,198,35,-163,B
cpinya 2006.03.28,970,1,1,21,179,43,-136,A
cpinya 2006.03.28,970,1,1,21,164,48,-116,B
calibra 2001.12.27,1049,1,1,10,99,40,-59,A
calibra 2001.12.27,1049,1,1,10,67,30,-37,B
Gaby 2001.12.27,945,1,0,12,288,42,-246,A
Gaby 2001.12.27,945,1,0,12,273,42,-231,B
BollNCSU 2001.07.30,953,3,0,34,206,24,-182,A
BollNCSU 2001.07.30,953,3,0,34,235,21,-214,B
Gaby 2001.07.30,1002,3,3,39,258,18,-240,A
Gaby 2001.07.30,1002,3,3,39,246,21,-225,B
prowlerecmo 2001.05.21,1062,1,1,5,50,40,-10,A
prowlerecmo 2001.05.21,1062,1,1,5,42,40,-2,B
schorny 2001.05.21,924,1,0,5,275,0,-275,A
schorny 2001.05.21,924,1,0,5,272,0,-272,B
Damagical 2006.03.26,1103,1,1,9,189,22,-167,A
Damagical 2006.03.26,1103,1,1,9,218,11,-207,B
KoolBreez 2006.03.26,868,1,0,9,292,33,-259,A
KoolBreez 2006.03.26,868,1,0,9,304,22,-282,B
Kenchan 2001.10.06,1069,1,1,6,55,67,12,A
Kenchan 2001.10.06,1069,1,1,6,18,83,65,B
CashCow 2001.10.06,899,1,0,6,310,17,-293,A
CashCow 2001.10.06,899,1,0,6,272,17,-255,B
IIpawnII 2000.02.02,750,4,3,107,133,34,-99,A
IIpawnII 2000.02.02,750,4,3,107,124,32,-92,B
Knighter 2000.02.02,959,9,3,214,152,33,-119,A
Knighter 2000.02.02,959,9,3,214,145,31,-114,B
basitian 2005.03.17,1001,1,1,8,86,38,-48,A
basitian 2005.03.17,1001,1,1,8,66,38,-28,B
johnald 2006.03.28,855,2,1,20,214,10,-204,A
johnald 2006.03.28,855,2,1,20,214,15,-199,B
Breneric 2006.03.28,1060,1,1,5,61,60,-1,A
Breneric 2006.03.28,1060,1,1,5,62,60,-2,B
HEARTLESSWIZARD 2005.02.09,853,1,1,13,96,38,-58,A
HEARTLESSWIZARD 2005.02.09,853,1,1,13,97,31,-66,B
Rhiannontg 2005.02.09,1068,1,0,12,82,58,-24,A
Rhiannontg 2005.02.09,1068,1,0,12,103,33,-70,B
mcgrail 2006.03.05,832,5,0,62,166,32,-134,A
mcgrail 2006.03.05,832,5,0,62,157,37,-120,B
cpinya 2006.03.05,962,3,3,29,222,21,-201,A
cpinya 2006.03.05,962,3,3,29,209,31,-178,B
telaviv 2004.10.10,1000,1,1,27,66,41,-25,A
telaviv 2004.10.10,1000,1,1,27,59,44,-15,B
HEARTLESSWIZARD 2004.10.10,862,1,0,30,199,23,-176,A
HEARTLESSWIZARD 2004.10.10,862,1,0,30,194,17,-177,B
drstoen 2002.01.29,900,1,0,7,395,0,-395,A
drstoen 2002.01.29,900,1,0,7,410,0,-410,B
SpacedCadet 2002.01.29,1099,1,1,5,160,20,-140,A
SpacedCadet 2002.01.29,1099,1,1,5,182,20,-162,B
iascrazyorioles 2006.03.26,954,1,0,19,289,37,-252,A
iascrazyorioles 2006.03.26,954,1,0,19,235,26,-209,B
Lightmonster 2006.03.26,983,1,1,19,214,32,-182,A
Lightmonster 2006.03.26,983,1,1,19,213,32,-181,B
jcizotti 2005.03.14,997,1,1,7,206,14,-192,A
jcizotti 2005.03.14,997,1,1,7,196,29,-167,B
jpresley 2001.10.10,1093,1,1,24,208,25,-183,A
jpresley 2001.10.10,1093,1,1,24,213,25,-188,B
CashCow 2001.10.10,850,2,1,51,388,27,-361,A
CashCow 2001.10.10,850,2,1,51,341,24,-317,B
Gaby 2001.01.07,1005,1,1,31,282,19,-263,A
Gaby 2001.01.07,1005,1,1,31,309,23,-286,B
hitchhiker 2001.01.07,912,1,0,30,253,27,-226,A
hitchhiker 2001.01.07,912,1,0,30,293,13,-280,B
JasperGreene 2006.03.01,1087,1,0.5,44,140,27,-113,A
JasperGreene 2006.03.01,1087,1,0.5,44,138,30,-108,B
Halfman 2006.02.19,918,1,1,7,43,57,14,A
Halfman 2006.02.19,918,1,1,7,28,57,29,B
wiky 2006.02.19,1002,1,0,8,281,25,-256,A
wiky 2006.02.19,1002,1,0,8,249,25,-224,B
alexcardoso 2004.07.12,1042,1,1,3,93,33,-60,A
alexcardoso 2004.07.12,1042,1,1,3,79,33,-46,B
sammyCmtww 2004.07.12,908,3,2,46,141,43,-98,A
sammyCmtww 2004.07.12,908,3,2,46,138,33,-105,B
medilein 2005.03.11,1088,1,1,2,310,50,-260,A
medilein 2005.03.11,1088,1,1,2,400,0,-400,B
StrwberyNBanana 2000.02.16,1002,1,1,9,214,22,-192,A
StrwberyNBanana 2000.02.16,1002,1,1,9,202,22,-180,B
mwcommander 2000.02.16,870,1,0,11,358,9,-349,A
mwcommander 2000.02.16,870,1,0,11,338,18,-320,B
ShawnB 2006.02.14,1126,2,0,65,194,32,-162,A
ShawnB 2006.02.14,1126,2,0,65,192,32,-160,B
spudthedud 2006.02.14,831,2,2,66,193,24,-169,A
spudthedud 2006.02.14,831,2,2,66,182,23,-159,B
honte 2005.02.11,940,1,0,46,224,39,-185,A
honte 2005.02.11,940,1,0,46,210,33,-177,B
rickx 2005.02.11,1054,1,1,42,204,31,-173,A
rickx 2005.02.11,1054,1,1,42,188,31,-157,B
merka 2005.01.18,810,1,0,41,93,20,-73,A
merka 2005.01.18,810,1,0,41,105,20,-85,B
pajac 2005.01.18,1101,1,1,39,57,41,-16,A
pajac 2005.01.18,1101,1,1,39,70,38,-32,B
theonetrueface 2004.12.17,899,1,0,5,128,20,-108,A
theonetrueface 2004.12.17,899,1,0,5,146,20,-126,B
rockchalk 2004.12.17,1082,1,1,4,126,25,-101,A
rockchalk 2004.12.17,1082,1,1,4,144,25,-119,B
newwave 2001.10.10,1005,1,0,30,373,23,-350,A
newwave 2001.10.10,1005,1,0,30,374,20,-354,B
HappyCrap 2000.02.02,885,1,1,34,61,32,-29,A
HappyCrap 2000.02.02,885,1,1,34,63,29,-34,B
medilein 2005.02.21,1032,1,1,8,576,0,-576,A
medilein 2005.02.21,1032,1,1,8,515,0,-515,B
ultradude 2005.02.21,962,1,0,7,585,0,-585,A
ultradude 2005.02.21,962,1,0,7,524,0,-524,B
Joinedup 2005.02.03,925,1,0,8,360,25,-335,A
Joinedup 2005.02.03,925,1,0,8,401,25,-376,B
Proticon 2005.02.03,1066,1,1,7,231,14,-217,A
Proticon 2005.02.03,1066,1,1,7,277,14,-263,B
Xillion 2006.03.20,1049,1,1,17,141,29,-112,A
Xillion 2006.03.20,1049,1,1,17,103,29,-74,B
johnald 2006.03.20,907,1,0,18,263,28,-235,A
johnald 2006.03.20,907,1,0,18,217,28,-189,B
dbalparda 2006.03.02,1165,1,1,18,36,50,14,A
dbalparda 2006.03.02,1165,1,1,18,32,56,24,B
rbb 2006.03.25,900,1,1,20,204,25,-179,A
rbb 2006.03.25,900,1,1,20,200,30,-170,B
Halfman 2006.03.25,1060,1,0,19,120,37,-83,A
Halfman 2006.03.25,1060,1,0,19,133,37,-96,B
EliteHunter 2006.03.18,1006,1,1,12,79,67,-12,A
EliteHunter 2006.03.18,1006,1,1,12,66,58,-8,B
Krandall 2006.03.18,978,1,0,18,138,28,-110,A
Krandall 2006.03.18,978,1,0,18,125,33,-92,B
MassachusettsFats 2006.03.21,1080,1,0,18,229,22,-207,A
MassachusettsFats 2006.03.21,1080,1,0,18,218,17,-201,B
betsys 2006.03.21,850,1,1,15,212,33,-179,A
betsys 2006.03.21,850,1,1,15,248,20,-228,B
HEARTLESSWIZARD 2004.12.23,827,1,0,36,184,28,-156,A
HEARTLESSWIZARD 2004.12.23,827,1,0,36,190,31,-159,B
GolfBob 2004.12.23,1005,1,1,34,137,24,-113,A
GolfBob 2004.12.23,1005,1,1,34,152,24,-128,B
Bulochka 2005.01.05,921,1,0,17,197,24,-173,A
Bulochka 2005.01.05,921,1,0,17,187,29,-158,B
Nett 2005.01.05,1004,1,1,15,76,33,-43,A
Nett 2005.01.05,1004,1,1,15,78,40,-38,B
StrwberyNBanana 2000.04.06,1052,1,0,16,159,38,-121,A
StrwberyNBanana 2000.04.06,1052,1,0,16,157,44,-113,B
mwcommander 2000.04.06,832,1,1,16,96,44,-52,A
mwcommander 2000.04.06,832,1,1,16,97,50,-47,B
allgood 2000.03.27,1015,2,2,18,130,22,-108,A
allgood 2000.03.27,1015,2,2,18,147,17,-130,B
obao 2000.03.27,857,2,0,22,292,9,-283,A
obao 2000.03.27,857,2,0,22,310,9,-301,B
KellBell 2001.07.05,547,1,0,12,236,42,-194,A
KellBell 2001.07.05,547,1,0,12,236,42,-194,B
konovalov 2001.07.05,1313,1,1,10,129,40,-89,A
konovalov 2001.07.05,1313,1,1,10,138,30,-108,B
magicmaster 2000.03.19,770,2,0,12,273,0,-273,A
magicmaster 2000.03.19,770,2,0,12,288,0,-288,B
Buoy 2000.03.19,1220,2,2,9,61,56,-5,A
Buoy 2000.03.19,1220,2,2,9,68,56,-12,B
HEARTLESSWIZARD 2006.01.28,949,1,1,6,170,33,-137,A
HEARTLESSWIZARD 2006.01.28,949,1,1,6,188,33,-155,B
martinho 2006.01.28,992,1,0,6,293,33,-260,A
martinho 2006.01.28,992,1,0,6,321,33,-288,B
MMen 2004.05.11,1070,1,0,13,176,15,-161,A
MMen 2004.05.11,1070,1,0,13,176,15,-161,B
twno 2004.05.11,869,1,1,15,187,33,-154,A
twno 2004.05.11,869,1,1,15,176,33,-143,B
ZZandirt 2006.01.04,977,1,1,7,0,86,86,A
ZZandirt 2006.01.04,977,1,1,7,0,86,86,B
ChessRio 2006.01.04,891,2,1,27,114,30,-84,A
ChessRio 2006.01.04,891,2,1,27,123,30,-93,B
daChodeMan 2006.03.01,883,1,0,26,180,35,-145,A
daChodeMan 2006.03.01,883,1,0,26,179,35,-144,B
Halfman 2006.02.18,925,1,0,21,228,14,-214,A
Halfman 2006.02.18,925,1,0,21,204,14,-190,B
mickeyl 2006.02.18,1008,2,1,29,259,31,-228,A
mickeyl 2006.02.18,1008,2,1,29,237,31,-206,B
voetbalfan 2004.09.25,978,1,0,14,141,43,-98,A
voetbalfan 2004.09.25,978,1,0,14,151,43,-108,B
HEARTLESSWIZARD 2004.09.25,804,2,1,25,221,32,-189,A
HEARTLESSWIZARD 2004.09.25,804,2,1,25,280,28,-252,B
Knighter 2000.01.22,925,1,0,20,136,20,-116,A
Knighter 2000.01.22,925,1,0,20,133,20,-113,B
stefaan 2000.01.22,1024,1,1,19,87,37,-50,A
stefaan 2000.01.22,1024,1,1,19,83,37,-46,B
Knighter 1999.12.28,926,1,1,14,231,14,-217,A
Knighter 1999.12.28,926,1,1,14,216,14,-202,B
Chronoscepter 1999.12.28,799,1,0,12,147,42,-105,A
Chronoscepter 1999.12.28,799,1,0,12,134,50,-84,B
southwestco 2004.07.05,990,4,0,62,277,16,-261,A
southwestco 2004.07.05,990,4,0,62,280,16,-264,B
alexcardoso 2004.07.05,938,4,4,55,200,24,-176,A
alexcardoso 2004.07.05,938,4,4,55,201,20,-181,B
GaryP 2001.06.12,934,1,1,14,95,43,-52,A
GaryP 2001.06.12,934,1,1,14,83,43,-40,B
chessmoker 2001.06.12,946,1,0,14,176,29,-147,A
chessmoker 2001.06.12,946,1,0,14,166,29,-137,B
LuckyG 2006.03.13,1053,1,1,20,137,30,-107,A
LuckyG 2006.03.13,1053,1,1,20,155,35,-120,B
betsys 2006.03.13,942,1,0,20,145,30,-115,A
betsys 2006.03.13,942,1,0,20,175,30,-145,B
marioandluigi 2006.03.05,1130,1,1,14,169,21,-148,A
marioandluigi 2006.03.05,1130,1,1,14,186,14,-172,B
allgood 2000.03.28,1095,1,1,24,300,29,-271,A
allgood 2000.03.28,1095,1,1,24,306,33,-273,B
obao 2000.03.28,785,2,0,78,268,28,-240,A
obao 2000.03.28,785,2,0,78,250,29,-221,B
JuliusG 2006.03.14,831,1,1,6,154,33,-121,A
JuliusG 2006.03.14,831,1,1,6,197,17,-180,B
ferking 2006.03.14,1043,1,0,12,281,50,-231,A
ferking 2006.03.14,1043,1,0,12,284,50,-234,B
Chaemera 2006.03.14,1039,1,1,6,204,0,-204,A
Chaemera 2006.03.14,1039,1,1,6,194,0,-194,B
uvrays 2006.03.14,832,1,0,8,148,38,-110,A
uvrays 2006.03.14,832,1,0,8,165,12,-153,B
returnofcaz 2006.03.02,1003,1,1,10,203,30,-173,A
returnofcaz 2006.03.02,1003,1,1,10,200,20,-180,B
allgood 2000.04.02,1049,1,1,10,48,50,2,A
allgood 2000.04.02,1049,1,1,10,50,30,-20,B
obao 2000.04.02,747,1,0,10,219,10,-209,A
obao 2000.04.02,747,1,0,10,219,10,-209,B
mwcommander 2000.02.26,857,1,0,10,226,0,-226,A
mwcommander 2000.02.26,857,1,0,10,217,0,-217,B
MnM 2000.02.26,1091,1,1,9,74,44,-30,A
MnM 2000.02.26,1091,1,1,9,70,44,-26,B
Playlight 2000.03.28,1142,1,1,55,144,44,-100,A
Playlight 2000.03.28,1142,1,1,55,142,44,-98,B
spudthedud 2006.02.12,874,2,0,37,209,32,-177,A
spudthedud 2006.02.12,874,2,0,37,186,35,-151,B
stdonn 2006.02.12,1097,1,1,12,178,17,-161,A
stdonn 2006.02.12,1097,1,1,12,117,17,-100,B
createwaves 2001.07.02,903,1,0,8,334,12,-322,A
createwaves 2001.07.02,903,1,0,8,301,12,-289,B
gimpgoth 2001.07.02,1054,1,1,7,266,0,-266,A
gimpgoth 2001.07.02,1054,1,1,7,237,0,-237,B
IOMatrix 2001.01.21,1137,1,0,35,166,34,-132,A
IOMatrix 2001.01.21,1137,1,0,35,200,37,-163,B
Auerweck 2001.01.21,850,1,1,35,145,26,-119,A
Auerweck 2001.01.21,850,1,1,35,148,23,-125,B
gerard 2000.10.06,999,1,1,7,170,0,-170,A
gerard 2000.10.06,999,1,1,7,141,0,-141,B
Brooser 2000.10.06,996,1,0,7,314,0,-314,A
Brooser 2000.10.06,996,1,0,7,279,14,-265,B
benoz 2006.03.07,1191,1,1,6,83,33,-50,A
benoz 2006.03.07,1191,1,1,6,76,33,-43,B
mcgrail 2006.03.07,797,1,0,5,121,20,-101,A
mcgrail 2006.03.07,797,1,0,5,113,20,-93,B
HEARTLESSWIZARD 2004.10.22,846,1,0,29,175,17,-158,A
HEARTLESSWIZARD 2004.10.22,846,1,0,29,163,17,-146,B
spiZ 2004.10.22,1047,1,1,26,116,54,-62,A
spiZ 2004.10.22,1047,1,1,26,112,46,-66,B
mrfriday 2000.02.07,758,1,0,18,169,44,-125,A
mrfriday 2000.02.07,758,1,0,18,161,39,-122,B
aet 2000.02.07,1040,1,1,17,95,35,-60,A
aet 2000.02.07,1040,1,1,17,86,35,-51,B
surrencytw 2004.12.20,1035,1,1,6,38,50,12,A
surrencytw 2004.12.20,1035,1,1,6,28,67,39,B
theonetrueface 2004.12.20,858,1,0,6,240,17,-223,A
theonetrueface 2004.12.20,858,1,0,6,256,17,-239,B
ewrosenthal 2006.03.04,1159,1,1,11,156,36,-120,A
ewrosenthal 2006.03.04,1159,1,1,11,172,36,-136,B
mcgrail 2006.03.04,826,1,0,11,233,46,-187,A
mcgrail 2006.03.04,826,1,0,11,249,46,-203,B
ennil 2004.10.05,916,1,1,32,96,41,-55,A
ennil 2004.10.05,916,1,1,32,98,44,-54,B
telaviv 2004.10.05,1035,1,0,33,146,42,-104,A
telaviv 2004.10.05,1035,1,0,33,163,27,-136,B
Tarish 2006.03.01,755,3,0,81,219,28,-191,A
Tarish 2006.03.01,755,3,0,81,193,26,-167,B
gottago 2006.03.01,1136,4,4,92,165,29,-136,A
gottago 2006.03.01,1136,4,4,92,165,24,-141,B
wavewave 2006.03.05,1168,1,1,23,111,30,-81,A
wavewave 2006.03.05,1168,1,1,23,103,30,-73,B
Cortez 2000.02.02,970,1,0,17,48,29,-19,A
Cortez 2000.02.02,970,1,0,17,37,35,-2,B
mrfriday 2000.01.29,724,1,0,20,274,15,-259,A
mrfriday 2000.01.29,724,1,0,20,251,15,-236,B
Knighter 2000.01.29,954,1,1,17,167,35,-132,A
Knighter 2000.01.29,954,1,1,17,147,29,-118,B
SChlebowski 2006.02.13,1152,1,1,18,291,22,-269,A
SChlebowski 2006.02.13,1152,1,1,18,242,28,-214,B
spudthedud 2006.02.13,766,2,1,25,296,28,-268,A
spudthedud 2006.02.13,766,2,1,25,261,24,-237,B
StrwberyNBanana 2000.03.29,1090,1,1,25,154,12,-142,A
StrwberyNBanana 2000.03.29,1090,1,1,25,157,20,-137,B
mwcommander 2000.03.29,844,1,0,25,185,12,-173,A
mwcommander 2000.03.29,844,1,0,25,184,16,-168,B
ewrosenthal 2006.03.02,1115,1,1,4,168,50,-118,A
ewrosenthal 2006.03.02,1115,1,1,4,174,75,-99,B
StrwberyNBanana 2000.02.05,990,1,1,34,228,12,-216,A
StrwberyNBanana 2000.02.05,990,1,1,34,264,6,-258,B
mwcommander 2000.02.05,898,1,0,27,240,15,-225,A
mwcommander 2000.02.05,898,1,0,27,223,15,-208,B
freetraderbeowolf 2006.02.18,961,1,1,6,114,50,-64,A
freetraderbeowolf 2006.02.18,961,1,1,6,73,50,-23,B
twno 2004.07.16,920,2,0,18,229,11,-218,A
twno 2004.07.16,920,2,0,18,251,6,-245,B
alexcardoso 2004.07.16,1055,2,2,18,129,17,-112,A
alexcardoso 2004.07.16,1055,2,2,18,141,28,-113,B
RHankinsJr 2006.02.12,1149,1,1,18,56,44,-12,A
RHankinsJr 2006.02.12,1149,1,1,18,58,50,-8,B
twno 2004.04.04,890,1,1,17,120,41,-79,A
twno 2004.04.04,890,1,1,17,58,41,-17,B
hcube 2004.04.04,1092,1,0,18,164,17,-147,A
hcube 2004.04.04,1092,1,0,18,159,22,-137,B
HEARTLESSWIZARD 2004.08.29,843,2,0,18,206,17,-189,A
HEARTLESSWIZARD 2004.08.29,843,2,0,18,215,17,-198,B
leffub 2004.08.29,901,2,2,23,172,30,-142,A
leffub 2004.08.29,901,2,2,23,182,30,-152,B
ennil 2004.10.02,929,1,1,11,69,46,-23,A
ennil 2004.10.02,929,1,1,11,65,54,-11,B
caracaskid 2004.10.02,895,1,0,12,273,25,-248,A
caracaskid 2004.10.02,895,1,0,12,262,25,-237,B
Vox 2004.11.19,806,1,1,12,145,33,-112,A
Vox 2004.11.19,806,1,1,12,150,33,-117,B
EvilenasThrone 2004.11.19,1033,1,0,14,203,36,-167,A
EvilenasThrone 2004.11.19,1033,1,0,14,204,36,-168,B
vismaior 2006.03.02,936,1,1,14,173,21,-152,A
vismaior 2006.03.02,936,1,1,14,159,21,-138,B
wiky 2006.03.01,947,1,0,7,82,29,-53,A
wiky 2006.03.01,947,1,0,7,132,43,-89,B
surrencytw 2004.11.13,1093,1,0,18,534,11,-523,A
surrencytw 2004.11.13,1093,1,0,18,527,11,-516,B
ConditionZero 2004.11.13,873,1,1,13,350,31,-319,A
ConditionZero 2004.11.13,873,1,1,13,372,31,-341,B
Knighter 2000.01.30,952,2,2,18,126,22,-104,A
Knighter 2000.01.30,952,2,2,18,111,22,-89,B
BOKEN 2000.01.30,826,1,0,5,382,20,-362,A
BOKEN 2000.01.30,826,1,0,5,369,20,-349,B
fuz 2000.02.02,933,2,1,27,178,15,-163,A
fuz 2000.02.02,933,2,1,27,181,15,-166,B
loserman 2006.02.13,811,1,0,8,150,38,-112,A
loserman 2006.02.13,811,1,0,8,168,38,-130,B
knoSpain 2006.02.13,1111,1,1,7,37,57,20,A
knoSpain 2006.02.13,1111,1,1,7,12,71,59,B
ZeroKool 2000.02.06,914,1,0,26,158,23,-135,A
ZeroKool 2000.02.06,914,1,0,26,142,23,-119,B
aet 2000.02.06,993,1,1,25,92,36,-56,A
aet 2000.02.06,993,1,1,25,75,36,-39,B
spudthedud 2006.02.15,965,1,1,24,122,38,-84,A
spudthedud 2006.02.15,965,1,1,24,118,42,-76,B
Cybersun 2006.02.15,992,1,0,26,129,35,-94,A
Cybersun 2006.02.15,992,1,0,26,129,19,-110,B
Shuckey 2000.01.28,916,1,0,26,88,54,-34,A
Shuckey 2000.01.28,916,1,0,26,91,54,-37,B
Shuckey 2000.01.28,916,1,0,26,91,50,-41,C
Knighter 2000.01.28,925,1,1,26,112,38,-74,A
Knighter 2000.01.28,925,1,1,26,107,38,-69,B
Knighter 2000.01.28,925,1,1,26,105,42,-63,C
azshtrdude 2004.09.11,963,1,0,23,312,22,-290,A
azshtrdude 2004.09.11,963,1,0,23,309,17,-292,B
HEARTLESSWIZARD 2004.09.11,764,1,1,21,234,38,-196,A
HEARTLESSWIZARD 2004.09.11,764,1,1,21,235,33,-202,B
laconique 2000.01.15,1019,1,1,36,85,36,-49,A
laconique 2000.01.15,1019,1,1,36,75,31,-44,B
Tarish 2006.02.28,775,1,0,14,224,29,-195,A
Tarish 2006.02.28,775,1,0,14,176,29,-147,B
petergriffin 2006.02.28,1167,1,1,12,84,42,-42,A
petergriffin 2006.02.28,1167,1,1,12,80,42,-38,B
Knighter 2000.01.23,893,1,0,19,240,32,-208,A
Knighter 2000.01.23,893,1,0,19,248,37,-211,B
giles 2000.01.23,888,1,1,15,99,20,-79,A
giles 2000.01.23,888,1,1,15,100,20,-80,B
HEARTLESSWIZARD 2004.07.29,827,1,0,16,201,38,-163,A
HEARTLESSWIZARD 2004.07.29,827,1,0,16,194,44,-150,B
Zumon 2004.07.29,1089,1,1,16,247,31,-216,A
Zumon 2004.07.29,1089,1,1,16,224,31,-193,B
cubcadet 2006.02.13,943,1,0,9,390,11,-379,A
cubcadet 2006.02.13,943,1,0,9,438,11,-427,B
Halfman 2006.02.13,930,1,0,13,349,23,-326,A
Halfman 2006.02.13,930,1,0,13,358,23,-335,B
prodenter 2006.02.13,1041,1,1,8,102,50,-52,A
prodenter 2006.02.13,1041,1,1,8,142,25,-117,B
Knighter 2000.01.26,911,1,0,50,190,22,-168,A
Knighter 2000.01.26,911,1,0,50,188,14,-174,B
gnutz 2000.01.26,855,1,1,48,140,27,-113,A
gnutz 2000.01.26,855,1,1,48,145,23,-122,B
mrcapp 2004.04.17,867,1,0,23,209,26,-183,A
mrcapp 2004.04.17,867,1,0,23,204,26,-178,B
mcavoy 2004.04.17,1064,1,1,20,131,40,-91,A
mcavoy 2004.04.17,1064,1,1,20,122,40,-82,B
andermec 2006.01.07,900,1,1,16,113,38,-75,A
andermec 2006.01.07,900,1,1,16,117,38,-79,B
Halfman 2006.01.07,897,2,0,41,149,24,-125,A
Halfman 2006.01.07,897,2,0,41,157,27,-130,B
hwqa 2004.09.25,1055,1,1,8,132,37,-95,A
hwqa 2004.09.25,1055,1,1,8,131,38,-93,B
mrfriday 2000.01.27,737,1,0,30,140,37,-103,A
mrfriday 2000.01.27,737,1,0,30,133,30,-103,B
Knighter 2000.01.27,903,2,2,34,145,24,-121,A
Knighter 2000.01.27,903,2,2,34,139,21,-118,B
army 2000.01.29,881,1,0,17,172,18,-154,A
army 2000.01.29,881,1,0,17,168,18,-150,B
aet 2000.01.29,994,1,1,15,64,53,-11,A
aet 2000.01.29,994,1,1,15,52,47,-5,B
nspirit 2004.07.12,1021,3,0.5,60,250,40,-210,A
nspirit 2004.07.12,1021,3,0.5,60,243,35,-208,B
ChessProzac 2000.02.02,974,1,1,18,48,39,-9,A
ChessProzac 2000.02.02,974,1,1,18,35,50,15,B
vismaior 2006.02.20,947,1,0.5,22,150,41,-109,A
vismaior 2006.02.20,947,1,0.5,22,145,41,-104,B
kimida 2006.02.20,1041,1,0.5,21,199,24,-175,A
kimida 2006.02.20,1041,1,0.5,21,200,29,-171,B
slingdraw 2000.01.30,899,1,0,13,206,38,-168,A
slingdraw 2000.01.30,899,1,0,13,199,31,-168,B
maxmaz 2004.05.15,1077,1,0,12,198,25,-173,A
maxmaz 2004.05.15,1077,1,0,12,198,25,-173,B
twno 2004.05.15,904,2,2,32,207,31,-176,A
twno 2004.05.15,904,2,2,32,217,34,-183,B
twno 2004.05.04,876,1,0,5,95,60,-35,A
twno 2004.05.04,876,1,0,5,136,60,-76,B
BerntHertz 2004.05.04,1111,1,1,6,485,0,-485,A
BerntHertz 2004.05.04,1111,1,1,6,476,0,-476,B
ChessRio 2005.12.30,912,1,1,14,129,36,-93,A
ChessRio 2005.12.30,912,1,1,14,141,36,-105,B
Halfman 2005.12.30,897,1,0,14,199,36,-163,A
Halfman 2005.12.30,897,1,0,14,200,29,-171,B
HEARTLESSWIZARD 2004.09.02,791,1,0,22,194,9,-185,A
HEARTLESSWIZARD 2004.09.02,791,1,0,22,188,9,-179,B
GolfBob 2004.09.02,999,1,1,24,195,29,-166,A
GolfBob 2004.09.02,999,1,1,24,198,25,-173,B
Cybersun 2006.02.12,1004,1,0,15,295,13,-282,A
Cybersun 2006.02.12,1004,1,0,15,253,13,-240,B
Panzerkampfwagon 2006.02.12,912,1,1,14,187,43,-144,A
Panzerkampfwagon 2006.02.12,912,1,1,14,186,36,-150,B
WesternRed 1999.11.24,1126,1,1,10,135,10,-125,A
WesternRed 1999.11.24,1126,1,1,10,145,20,-125,B
Kimber 1999.11.24,865,1,0,11,289,27,-262,A
Kimber 1999.11.24,865,1,0,11,306,18,-288,B
colpitts 2004.09.05,1064,1,1,8,236,25,-211,A
colpitts 2004.09.05,1064,1,1,8,181,38,-143,B
Foufoutos 2004.09.05,854,1,0,10,406,10,-396,A
Foufoutos 2004.09.05,854,1,0,10,342,30,-312,B
twno 2004.07.15,918,1,0,9,502,0,-502,A
twno 2004.07.15,918,1,0,9,468,0,-468,B
collmemasteur 2004.07.15,1008,1,1,7,307,29,-278,A
collmemasteur 2004.07.15,1008,1,1,7,313,29,-284,B
southwestco 2004.07.14,782,1,0,15,179,13,-166,A
southwestco 2004.07.14,782,1,0,15,182,13,-169,B
alexcardoso 2004.07.14,1066,1,1,12,122,17,-105,A
alexcardoso 2004.07.14,1066,1,1,12,103,25,-78,B
arragorn 1999.12.13,959,1,1,13,215,15,-200,A
arragorn 1999.12.13,959,1,1,13,188,15,-173,B
Agenbite 1999.12.13,1025,1,0,12,88,33,-55,A
Agenbite 1999.12.13,1025,1,0,12,72,33,-39,B
Tarish 2006.02.11,814,1,0,6,359,17,-342,A
Tarish 2006.02.11,814,1,0,6,241,33,-208,B
ewrosenthal 2006.02.11,1133,1,1,5,38,60,22,A
ewrosenthal 2006.02.11,1133,1,1,5,9,80,71,B
southwestco 2004.07.15,770,1,0,22,140,23,-117,A
southwestco 2004.07.15,770,1,0,22,155,23,-132,B
vat 2004.07.15,1217,1,1,20,37,55,18,A
vat 2004.07.15,1217,1,1,20,46,45,-1,B
dbalparda 2006.02.10,991,1,0,7,252,14,-238,A
dbalparda 2006.02.10,991,1,0,7,274,14,-260,B
drekec 2006.02.10,993,1,1,6,117,33,-84,A
drekec 2006.02.10,993,1,1,6,102,33,-69,B
HEARTLESSWIZARD 2004.08.01,804,1,0,20,319,25,-294,A
HEARTLESSWIZARD 2004.08.01,804,1,0,20,341,30,-311,B
Derro 2004.08.01,1151,1,1,21,310,29,-281,A
Derro 2004.08.01,1151,1,1,21,373,24,-349,B
DanielKinney 2006.01.23,888,1,0,5,256,0,-256,A
DanielKinney 2006.01.23,888,1,0,5,259,0,-259,B
Halfman 2006.01.23,876,2,1,16,197,25,-172,A
Halfman 2006.01.23,876,2,1,16,205,19,-186,B
wolfla 2006.02.12,913,1,0,19,122,58,-64,A
wolfla 2006.02.12,913,1,0,19,108,58,-50,B
dbalparda 2006.02.12,966,1,1,20,229,30,-199,A
dbalparda 2006.02.12,966,1,1,20,179,35,-144,B
Guidi 2000.01.27,900,1,0,4,66,25,-41,A
Guidi 2000.01.27,900,1,0,4,64,25,-39,B
cybersmash 2004.06.08,1020,1,1,16,178,12,-166,A
cybersmash 2004.06.08,1020,1,1,16,155,12,-143,B
alexcardoso 2004.06.08,956,1,0,22,434,9,-425,A
alexcardoso 2004.06.08,956,1,0,22,341,18,-323,B
loserman 2006.01.30,752,1,0,5,273,20,-253,A
loserman 2006.01.30,752,1,0,5,276,20,-256,B
zLORDz 2006.01.30,1060,1,1,5,120,20,-100,A
zLORDz 2006.01.30,1060,1,1,5,70,40,-30,B
MMen 2004.05.12,1017,1,0,16,165,6,-159,A
MMen 2004.05.12,1017,1,0,16,195,6,-189,B
twno 2004.05.12,876,2,1,35,159,29,-130,A
twno 2004.05.12,876,2,1,35,163,34,-129,B
Parne 2004.05.15,1075,1,0,13,143,46,-97,A
Parne 2004.05.15,1075,1,0,13,136,46,-90,B
Tarish 2006.01.27,861,1,0,30,227,33,-194,A
Tarish 2006.01.27,861,1,0,30,237,37,-200,B
olinebeefs 2006.01.27,1036,1,1,27,206,33,-173,A
olinebeefs 2006.01.27,1036,1,1,27,221,37,-184,B
pddchess 2005.12.22,882,1,1,29,203,41,-162,A
pddchess 2005.12.22,882,1,1,29,199,34,-165,B
Nassor 2005.12.22,1055,1,0,27,178,44,-134,A
Nassor 2005.12.22,1055,1,0,27,175,41,-134,B
Turtleskies 2004.07.27,891,1,1,14,161,36,-125,A
Turtleskies 2004.07.27,891,1,1,14,154,36,-118,B
Farfarer 2004.07.27,1100,1,0,18,181,33,-148,A
Farfarer 2004.07.27,1100,1,0,18,197,33,-164,B
HEARTLESSWIZARD 2006.01.29,963,1,1,11,309,9,-300,A
HEARTLESSWIZARD 2006.01.29,963,1,1,11,297,9,-288,B
Johnnyp 2006.01.29,802,1,0,11,323,27,-296,A
Johnnyp 2006.01.29,802,1,0,11,308,36,-272,B
Nassor 2005.12.23,950,2,1,55,107,38,-69,A
Nassor 2005.12.23,950,2,1,55,106,40,-66,B
rnajerac 2005.12.23,951,2,1,55,129,49,-80,A
rnajerac 2005.12.23,951,2,1,55,127,45,-82,B
southwestco 2004.07.06,799,1,0,8,324,25,-299,A
southwestco 2004.07.06,799,1,0,8,334,25,-309,B
platyjoe 2004.07.06,1155,1,1,6,123,33,-90,A
platyjoe 2004.07.06,1155,1,1,6,124,33,-91,B
HEARTLESSWIZARD 2004.06.10,963,1,0,22,254,14,-240,A
HEARTLESSWIZARD 2004.06.10,963,1,0,22,241,18,-223,B
OwenDeathstalker 2004.06.10,968,1,1,20,166,45,-121,A
OwenDeathstalker 2004.06.10,968,1,1,20,158,45,-113,B
stalkerVision 2004.07.12,873,1,0.5,6,260,0,-260,A
stalkerVision 2004.07.12,873,1,0.5,6,228,0,-228,B
sammyCmtww 2004.07.09,861,1,1,11,185,18,-167,A
sammyCmtww 2004.07.09,861,1,1,11,175,27,-148,B
alexcardoso 2004.07.09,1042,1,0,12,324,33,-291,A
alexcardoso 2004.07.09,1042,1,0,12,347,25,-322,B
SkyReaper 2006.02.12,834,1,1,10,110,30,-80,A
SkyReaper 2006.02.12,834,1,1,10,85,30,-55,B
aalaptop 2006.02.12,1124,1,0,11,328,27,-301,A
aalaptop 2006.02.12,1124,1,0,11,284,27,-257,B
Armoral 2004.04.17,1029,1,0,15,150,33,-117,A
Armoral 2004.04.17,1029,1,0,15,160,33,-127,B
vibronic 2004.04.17,931,1,1,15,146,20,-126,A
vibronic 2004.04.17,931,1,1,15,143,20,-123,B
Halfman 2006.01.20,887,2,1,46,212,35,-177,A
Halfman 2006.01.20,887,2,1,46,217,28,-189,B
petergriffin 2006.01.20,873,2,1,41,156,22,-134,A
petergriffin 2006.01.20,873,2,1,41,157,24,-133,B
Kimber 1999.12.01,828,1,0,30,289,27,-262,A
Kimber 1999.12.01,828,1,0,30,278,20,-258,B
WesternRed 1999.12.01,1126,1,1,30,237,23,-214,A
WesternRed 1999.12.01,1126,1,1,30,251,17,-234,B
pddchess 2006.01.23,887,2,1,22,262,23,-239,A
pddchess 2006.01.23,887,2,1,22,267,14,-253,B
olinebeefs 2006.01.23,1047,1,1,6,56,33,-23,A
olinebeefs 2006.01.23,1047,1,1,6,30,50,20,B
ChessRio 2005.12.29,925,1,0,18,289,33,-256,A
ChessRio 2005.12.29,925,1,0,18,294,33,-261,B
americanista 2005.12.29,1069,1,1,15,104,33,-71,A
americanista 2005.12.29,1069,1,1,15,120,40,-80,B
Pancetta 2006.01.23,1075,1,0,12,292,25,-267,A
Pancetta 2006.01.23,1075,1,0,12,289,25,-264,B
GolfBob 2004.06.17,950,1,1,37,69,30,-39,A
GolfBob 2004.06.17,950,1,1,37,71,30,-41,B
HEARTLESSWIZARD 2004.06.17,917,1,0,45,160,18,-142,A
HEARTLESSWIZARD 2004.06.17,917,1,0,45,159,13,-146,B
platyjoe 2004.07.03,1051,1,1,11,445,18,-427,A
platyjoe 2004.07.03,1051,1,1,11,393,18,-375,B
sammyCmtww 2004.07.03,809,1,0,6,278,0,-278,A
sammyCmtww 2004.07.03,809,1,0,6,281,0,-281,B
WesternRed 1999.11.30,1123,1,1,8,66,50,-16,A
WesternRed 1999.11.30,1123,1,1,8,94,62,-32,B
Kimber 1999.11.30,838,1,0,11,247,36,-211,A
Kimber 1999.11.30,838,1,0,11,242,46,-196,B
sibil 2004.04.26,1104,1,1,15,148,40,-108,A
sibil 2004.04.26,1104,1,1,15,143,40,-103,B
twno 2004.04.26,890,1,0,17,226,18,-208,A
twno 2004.04.26,890,1,0,17,233,24,-209,B
Halfman 2006.01.03,876,2,2,43,70,37,-33,A
Halfman 2006.01.03,876,2,2,43,75,40,-35,B
olinebeefs 2006.01.03,1089,2,0,48,149,33,-116,A
olinebeefs 2006.01.03,1089,2,0,48,165,29,-136,B
Anoten 2006.02.04,913,1,0,21,437,24,-413,A
Anoten 2006.02.04,913,1,0,21,339,29,-310,B
aalaptop 2006.02.04,1082,1,1,16,328,12,-316,A
aalaptop 2006.02.04,1082,1,1,16,239,12,-227,B
enzito 2006.01.11,1061,1,0,5,357,0,-357,A
enzito 2006.01.11,1061,1,0,5,373,0,-373,B
KingdomRascal 2006.01.11,927,1,1,3,70,33,-37,A
KingdomRascal 2006.01.11,927,1,1,3,71,33,-38,B
pddchess 2006.01.10,926,2,0.5,20,194,25,-169,A
pddchess 2006.01.10,926,2,0.5,20,182,25,-157,B
SChlebowski 2006.01.10,1078,1,1,15,211,27,-184,A
SChlebowski 2006.01.10,1078,1,1,15,199,33,-166,B
smod 2006.01.23,984,1,1,13,82,46,-36,A
smod 2006.01.23,984,1,1,13,94,38,-56,B
PIONPAGO 2006.01.31,985,1,1,28,136,50,-86,A
PIONPAGO 2006.01.31,985,1,1,28,100,57,-43,B
PIONPAGO 2006.01.31,985,1,1,28,100,46,-54,C
Halfman 2006.01.31,915,1,0,28,195,25,-170,A
Halfman 2006.01.31,915,1,0,28,171,25,-146,B
Halfman 2006.01.31,915,1,0,28,156,21,-135,C
Halfman 2006.01.12,867,1,1,11,45,46,1,A
Halfman 2006.01.12,867,1,1,11,39,36,-3,B
aGameofChess 2006.01.12,1111,1,0,14,148,21,-127,A
aGameofChess 2006.01.12,1111,1,0,14,144,21,-123,B
JorgeAdRomero 2006.01.04,1028,1,0,20,164,35,-129,A
JorgeAdRomero 2006.01.04,1028,1,0,20,175,35,-140,B
Ljovusa 2004.05.12,1013,1,1,18,240,28,-212,A
Ljovusa 2004.05.12,1013,1,1,18,224,28,-196,B
twno 2004.04.06,883,1,0,17,412,18,-394,A
twno 2004.04.06,883,1,0,17,478,24,-454,B
dockson 2004.04.06,984,1,1,16,431,19,-412,A
dockson 2004.04.06,984,1,1,16,467,19,-448,B
PIONPAGO 2006.01.13,931,2,2,29,236,24,-212,A
PIONPAGO 2006.01.13,931,2,2,29,159,28,-131,B
KarstenBlom 2006.01.13,1063,1,0,11,150,18,-132,A
KarstenBlom 2006.01.13,1063,1,0,11,143,36,-107,B
Pfistou 2005.12.24,1112,1,1,8,206,38,-168,A
Pfistou 2005.12.24,1112,1,1,8,270,38,-232,B
Spartagus 2005.12.24,1007,1,0,11,559,9,-550,A
Spartagus 2005.12.24,1007,1,0,11,559,9,-550,B
twno 2004.04.21,930,1,0,19,195,32,-163,A
twno 2004.04.21,930,1,0,19,209,26,-183,B
Ureshii 2004.04.21,908,1,1,18,144,11,-133,A
Ureshii 2004.04.21,908,1,1,18,147,17,-130,B
dillondeck 2006.01.13,967,1,0,19,250,10,-240,A
dillondeck 2006.01.13,967,1,0,19,235,10,-225,B
PIONPAGO 2006.01.14,945,2,0.5,34,194,47,-147,A
PIONPAGO 2006.01.14,945,2,0.5,34,173,44,-129,B
BigIrish 2006.01.14,975,1,0.5,9,325,33,-292,A
BigIrish 2006.01.14,975,1,0.5,9,315,44,-271,B
willcarter 2006.01.14,1027,1,1,24,143,33,-110,A
willcarter 2006.01.14,1027,1,1,24,134,38,-96,B
seeall 2006.01.10,1052,1,0.5,6,204,33,-171,A
seeall 2006.01.10,1052,1,0.5,6,197,33,-164,B
ELMC 2006.01.04,1057,1,0,23,116,17,-99,A
ELMC 2006.01.04,1057,1,0,23,120,17,-103,B
Halfman 2006.01.04,912,1,1,22,48,46,-2,A
Halfman 2006.01.04,912,1,1,22,54,46,-8,B
ninox 2006.01.07,999,1,1,20,99,20,-79,A
ninox 2006.01.07,999,1,1,20,84,25,-59,B
